"id","customer_id","order_no","order_type","item_name","quantity","price","profit","cost","created_at"
"1","52","20211108013449","Mobile","AAA01","7","70000","14000","56000","2021-11-08 13:34:49"
"2","38","20211108125754","PC","AAA03","7","119000","21000","98000","2021-11-08 12:57:54"
"3","42","20211108113050","Mobile","AAA05","14","840000","280000","560000","2021-11-08 11:30:50"
"4","21","20211108103553","Mobile","AAA01","12","120000","24000","96000","2021-11-08 10:35:53"
"5","49","20211108093811","Shop","AAA04","6","48000","2400","45600","2021-11-08 09:38:11"
"6","47","20211105111925","Shop","AAA04","10","80000","4000","76000","2021-11-05 11:19:25"
"7","30","20211105091311","PC","AAA04","8","64000","3200","60800","2021-11-05 09:13:11"
"8","33","20211105074034","Mobile","AAA05","2","120000","40000","80000","2021-11-05 07:40:34"
"9","58","20211105020832","PC","AAA02","1","15000","2300","12700","2021-11-05 02:08:32"
"10","90","20211104075616","Mobile","AAA02","5","75000","11500","63500","2021-11-04 19:56:16"
"11","75","20211104045003","Shop","AAA03","5","85000","15000","70000","2021-11-04 16:50:03"
"12","40","20211104035226","PC","AAA04","6","48000","2400","45600","2021-11-04 15:52:26"
"13","76","20211104124011","Shop","AAA05","7","420000","140000","280000","2021-11-04 12:40:11"
"14","57","20211104115015","Mobile","AAA03","7","119000","21000","98000","2021-11-04 11:50:15"
"15","41","20211104103534","PC","AAA04","5","40000","2000","38000","2021-11-04 10:35:34"
"16","16","20211104094257","Mobile","AAA01","15","150000","30000","120000","2021-11-04 09:42:57"
"17","70","20211104075335","Shop","AAA03","31","527000","93000","434000","2021-11-04 07:53:35"
"18","28","20211103052623","Shop","AAA02","3","45000","6900","38100","2021-11-03 17:26:23"
"19","64","20211103043831","Mobile","AAA04","2","16000","800","15200","2021-11-03 16:38:31"
"20","65","20211103034026","PC","AAA03","5","85000","15000","70000","2021-11-03 15:40:26"
"21","74","20211103024739","PC","AAA01","9","90000","18000","72000","2021-11-03 14:47:39"
"22","82","20211103011913","PC","AAA05","5","300000","100000","200000","2021-11-03 13:19:13"
"23","20","20211103111719","PC","AAA01","3","30000","6000","24000","2021-11-03 11:17:19"
"24","13","20211103101913","Mobile","AAA03","5","85000","15000","70000","2021-11-03 10:19:13"
"25","4","20211103095437","Mobile","AAA05","5","300000","100000","200000","2021-11-03 09:54:37"
"26","78","20211103090015","Mobile","AAA02","10","150000","23000","127000","2021-11-03 09:00:15"
"27","19","20211103082847","Shop","AAA05","5","300000","100000","200000","2021-11-03 08:28:47"
"28","55","20211103071937","Mobile","AAA04","15","120000","6000","114000","2021-11-03 07:19:37"
"29","83","20211102102545","PC","AAA03","6","102000","18000","84000","2021-11-02 22:25:45"
"30","30","20211102055426","PC","AAA05","1","60000","20000","40000","2021-11-02 17:54:26"
"31","76","20211102050252","Mobile","AAA03","4","68000","12000","56000","2021-11-02 17:02:52"
"32","45","20211102035036","PC","AAA01","9","90000","18000","72000","2021-11-02 15:50:36"
"33","100","20211102023836","PC","AAA04","4","32000","1600","30400","2021-11-02 14:38:36"
"34","34","20211102012505","Shop","AAA01","1","10000","2000","8000","2021-11-02 13:25:05"
"35","52","20211102122435","Shop","AAA01","2","20000","4000","16000","2021-11-02 12:24:35"
"36","91","20211102112422","Mobile","AAA05","7","420000","140000","280000","2021-11-02 11:24:22"
"37","50","20211102102931","PC","AAA04","2","16000","800","15200","2021-11-02 10:29:31"
"38","96","20211102091341","Mobile","AAA05","19","1140000","380000","760000","2021-11-02 09:13:41"
"39","14","20211102075743","Mobile","AAA02","5","75000","11500","63500","2021-11-02 07:57:43"
"40","31","20211102031120","Shop","AAA02","11","165000","25300","139700","2021-11-02 03:11:20"
"41","48","20211101112722","PC","AAA01","4","40000","8000","32000","2021-11-01 23:27:22"
"42","77","20211101101112","PC","AAA03","4","68000","12000","56000","2021-11-01 22:11:12"
"43","36","20211101065102","Mobile","AAA05","20","1200000","400000","800000","2021-11-01 18:51:02"
"44","64","20211101031021","Shop","AAA04","9","72000","3600","68400","2021-11-01 15:10:21"
"45","17","20211101014514","Shop","AAA03","11","187000","33000","154000","2021-11-01 13:45:14"
"46","83","20211101124634","Mobile","AAA03","18","306000","54000","252000","2021-11-01 12:46:34"
"47","77","20211101110541","Shop","AAA04","4","32000","1600","30400","2021-11-01 11:05:41"
"48","11","20211101094826","Mobile","AAA05","6","360000","120000","240000","2021-11-01 09:48:26"
"49","24","20211030121451","Mobile","AAA04","14","112000","5600","106400","2021-10-30 12:14:51"
"50","7","20211029015903","PC","AAA04","4","32000","1600","30400","2021-10-29 13:59:03"
"51","46","20211029124053","Mobile","AAA02","3","45000","6900","38100","2021-10-29 12:40:53"
"52","54","20211029114618","Mobile","AAA05","8","480000","160000","320000","2021-10-29 11:46:18"
"53","23","20211029094956","Mobile","AAA02","9","135000","20700","114300","2021-10-29 09:49:56"
"54","66","20211029082239","PC","AAA05","6","360000","120000","240000","2021-10-29 08:22:39"
"55","71","20211029065240","PC","AAA03","7","119000","21000","98000","2021-10-29 06:52:40"
"56","87","20211029121618","Mobile","AAA02","5","75000","11500","63500","2021-10-29 00:16:18"
"57","98","20211028022336","Mobile","AAA04","5","40000","2000","38000","2021-10-28 14:23:36"
"58","4","20211028015105","PC","AAA03","5","85000","15000","70000","2021-10-28 13:51:05"
"59","25","20211028115743","PC","AAA04","9","72000","3600","68400","2021-10-28 11:57:43"
"60","70","20211028105451","Mobile","AAA05","10","600000","200000","400000","2021-10-28 10:54:51"
"61","16","20211028091130","Shop","AAA05","6","360000","120000","240000","2021-10-28 09:11:30"
"62","83","20211028082618","Shop","AAA05","8","480000","160000","320000","2021-10-28 08:26:18"
"63","89","20211027090636","Mobile","AAA03","16","272000","48000","224000","2021-10-27 21:06:36"
"64","60","20211027064725","Mobile","AAA01","9","90000","18000","72000","2021-10-27 18:47:25"
"65","29","20211027040844","Shop","AAA02","6","90000","13800","76200","2021-10-27 16:08:44"
"66","71","20211027022305","PC","AAA01","12","120000","24000","96000","2021-10-27 14:23:05"
"67","71","20211027010814","PC","AAA04","5","40000","2000","38000","2021-10-27 13:08:14"
"68","61","20211027120530","PC","AAA01","1","10000","2000","8000","2021-10-27 12:05:30"
"69","7","20211027103542","Shop","AAA02","4","60000","9200","50800","2021-10-27 10:35:42"
"70","59","20211027093255","Mobile","AAA02","6","90000","13800","76200","2021-10-27 09:32:55"
"71","7","20211027084422","Mobile","AAA03","7","119000","21000","98000","2021-10-27 08:44:22"
"72","63","20211027075252","PC","AAA04","1","8000","400","7600","2021-10-27 07:52:52"
"73","78","20211026103418","PC","AAA01","10","100000","20000","80000","2021-10-26 22:34:18"
"74","10","20211026073514","Mobile","AAA02","8","120000","18400","101600","2021-10-26 19:35:14"
"75","95","20211026025808","Shop","AAA01","2","20000","4000","16000","2021-10-26 14:58:08"
"76","31","20211026015001","PC","AAA02","12","180000","27600","152400","2021-10-26 13:50:01"
"77","37","20211026010335","Shop","AAA04","2","16000","800","15200","2021-10-26 13:03:35"
"78","6","20211026121507","Shop","AAA02","3","45000","6900","38100","2021-10-26 12:15:07"
"79","55","20211026112233","Mobile","AAA01","9","90000","18000","72000","2021-10-26 11:22:33"
"80","11","20211026102849","Shop","AAA04","13","104000","5200","98800","2021-10-26 10:28:49"
"81","98","20211026100423","PC","AAA03","4","68000","12000","56000","2021-10-26 10:04:23"
"82","41","20211026090217","Mobile","AAA04","10","80000","4000","76000","2021-10-26 09:02:17"
"83","88","20211026073035","PC","AAA01","4","40000","8000","32000","2021-10-26 07:30:35"
"84","16","20211026124354","PC","AAA04","15","120000","6000","114000","2021-10-26 00:43:54"
"85","91","20211025120947","Mobile","AAA04","7","56000","2800","53200","2021-10-25 12:09:47"
"86","16","20211025105335","Shop","AAA04","15","120000","6000","114000","2021-10-25 10:53:35"
"87","81","20211025094643","Shop","AAA02","3","45000","6900","38100","2021-10-25 09:46:43"
"88","20","20211022060311","PC","AAA01","13","130000","26000","104000","2021-10-22 18:03:11"
"89","80","20211022113833","Mobile","AAA01","11","110000","22000","88000","2021-10-22 11:38:33"
"90","64","20211022102941","Mobile","AAA01","7","70000","14000","56000","2021-10-22 10:29:41"
"91","93","20211022075747","Mobile","AAA02","11","165000","25300","139700","2021-10-22 07:57:47"
"92","74","20211022054710","PC","AAA02","4","60000","9200","50800","2021-10-22 05:47:10"
"93","51","20211021053919","PC","AAA03","6","102000","18000","84000","2021-10-21 17:39:19"
"94","51","20211021042609","Shop","AAA03","6","102000","18000","84000","2021-10-21 16:26:09"
"95","48","20211021035744","Mobile","AAA03","5","85000","15000","70000","2021-10-21 15:57:44"
"96","31","20211021022038","Mobile","AAA01","3","30000","6000","24000","2021-10-21 14:20:38"
"97","96","20211021112750","PC","AAA03","7","119000","21000","98000","2021-10-21 11:27:50"
"98","91","20211021103445","PC","AAA03","7","119000","21000","98000","2021-10-21 10:34:45"
"99","47","20211021092905","Mobile","AAA05","15","900000","300000","600000","2021-10-21 09:29:05"
"100","7","20211021081642","Mobile","AAA05","9","540000","180000","360000","2021-10-21 08:16:42"
"101","39","20211020092147","Shop","AAA05","9","540000","180000","360000","2021-10-20 21:21:47"
"102","89","20211020064929","Mobile","AAA03","5","85000","15000","70000","2021-10-20 18:49:29"
"103","1","20211020040831","Shop","AAA02","10","150000","23000","127000","2021-10-20 16:08:31"
"104","1","20211020025111","Mobile","AAA04","19","152000","7600","144400","2021-10-20 14:51:11"
"105","94","20211020015935","Mobile","AAA04","15","120000","6000","114000","2021-10-20 13:59:35"
"106","80","20211020123134","Mobile","AAA02","2","30000","4600","25400","2021-10-20 12:31:34"
"107","51","20211020113144","PC","AAA02","9","135000","20700","114300","2021-10-20 11:31:44"
"108","54","20211020092142","Shop","AAA05","4","240000","80000","160000","2021-10-20 09:21:42"
"109","46","20211020075830","Mobile","AAA03","11","187000","33000","154000","2021-10-20 07:58:30"
"110","45","20211019081645","PC","AAA04","8","64000","3200","60800","2021-10-19 20:16:45"
"111","95","20211019050701","Shop","AAA05","13","780000","260000","520000","2021-10-19 17:07:01"
"112","80","20211019034417","Mobile","AAA01","3","30000","6000","24000","2021-10-19 15:44:17"
"113","70","20211019022224","Shop","AAA01","15","150000","30000","120000","2021-10-19 14:22:24"
"114","9","20211019014042","Mobile","AAA03","5","85000","15000","70000","2021-10-19 13:40:42"
"115","41","20211019011646","Mobile","AAA01","1","10000","2000","8000","2021-10-19 13:16:46"
"116","8","20211019122346","Shop","AAA01","23","230000","46000","184000","2021-10-19 12:23:46"
"117","17","20211019101030","PC","AAA02","12","180000","27600","152400","2021-10-19 10:10:30"
"118","82","20211019091005","PC","AAA03","7","119000","21000","98000","2021-10-19 09:10:05"
"119","71","20211019080834","Shop","AAA04","13","104000","5200","98800","2021-10-19 08:08:34"
"120","31","20211019072909","PC","AAA05","5","300000","100000","200000","2021-10-19 07:29:09"
"121","42","20211019024950","Shop","AAA04","17","136000","6800","129200","2021-10-19 02:49:50"
"122","38","20211018012420","PC","AAA03","4","68000","12000","56000","2021-10-18 13:24:20"
"123","77","20211018123611","Shop","AAA03","2","34000","6000","28000","2021-10-18 12:36:11"
"124","76","20211018114411","PC","AAA03","8","136000","24000","112000","2021-10-18 11:44:11"
"125","58","20211018102512","Mobile","AAA03","14","238000","42000","196000","2021-10-18 10:25:12"
"126","65","20211018093730","Mobile","AAA05","9","540000","180000","360000","2021-10-18 09:37:30"
"127","84","20211015070340","Mobile","AAA02","2","30000","4600","25400","2021-10-15 07:03:40"
"128","23","20211014045002","PC","AAA03","7","119000","21000","98000","2021-10-14 16:50:02"
"129","85","20211014034249","Mobile","AAA04","1","8000","400","7600","2021-10-14 15:42:49"
"130","48","20211014024330","Shop","AAA05","9","540000","180000","360000","2021-10-14 14:43:30"
"131","9","20211014012402","Shop","AAA01","3","30000","6000","24000","2021-10-14 13:24:02"
"132","64","20211014121823","Shop","AAA02","1","15000","2300","12700","2021-10-14 12:18:23"
"133","5","20211014100633","Mobile","AAA04","17","136000","6800","129200","2021-10-14 10:06:33"
"134","20","20211014090612","PC","AAA04","5","40000","2000","38000","2021-10-14 09:06:12"
"135","12","20211014075521","Mobile","AAA03","3","51000","9000","42000","2021-10-14 07:55:21"
"136","85","20211013072214","Shop","AAA04","12","96000","4800","91200","2021-10-13 19:22:14"
"137","79","20211013043535","Mobile","AAA01","13","130000","26000","104000","2021-10-13 16:35:35"
"138","32","20211013031126","Shop","AAA05","8","480000","160000","320000","2021-10-13 15:11:26"
"139","53","20211013023830","Shop","AAA04","3","24000","1200","22800","2021-10-13 14:38:30"
"140","99","20211013014713","Shop","AAA02","3","45000","6900","38100","2021-10-13 13:47:13"
"141","100","20211013122859","PC","AAA04","2","16000","800","15200","2021-10-13 12:28:59"
"142","96","20211013110755","Shop","AAA05","8","480000","160000","320000","2021-10-13 11:07:55"
"143","21","20211013095929","Shop","AAA05","15","900000","300000","600000","2021-10-13 09:59:29"
"144","74","20211013085259","Shop","AAA02","8","120000","18400","101600","2021-10-13 08:52:59"
"145","43","20211013080436","Mobile","AAA04","9","72000","3600","68400","2021-10-13 08:04:36"
"146","51","20211013065106","Mobile","AAA04","18","144000","7200","136800","2021-10-13 06:51:06"
"147","80","20211012075853","Mobile","AAA01","9","90000","18000","72000","2021-10-12 19:58:53"
"148","86","20211012031656","PC","AAA05","2","120000","40000","80000","2021-10-12 15:16:56"
"149","99","20211012125549","Shop","AAA04","5","40000","2000","38000","2021-10-12 12:55:49"
"150","58","20211012112133","Mobile","AAA02","7","105000","16100","88900","2021-10-12 11:21:33"
"151","26","20211012101756","PC","AAA01","1","10000","2000","8000","2021-10-12 10:17:56"
"152","42","20211012092331","PC","AAA04","12","96000","4800","91200","2021-10-12 09:23:31"
"153","21","20211012084901","Shop","AAA04","10","80000","4000","76000","2021-10-12 08:49:01"
"154","88","20211012072800","Shop","AAA02","6","90000","13800","76200","2021-10-12 07:28:00"
"155","38","20211011081936","PC","AAA05","5","300000","100000","200000","2021-10-11 20:19:36"
"156","46","20211011043707","PC","AAA01","6","60000","12000","48000","2021-10-11 16:37:07"
"157","3","20211011034353","PC","AAA05","26","1560000","520000","1040000","2021-10-11 15:43:53"
"158","77","20211011023753","Mobile","AAA03","3","51000","9000","42000","2021-10-11 14:37:53"
"159","5","20211011020633","PC","AAA02","8","120000","18400","101600","2021-10-11 14:06:33"
"160","92","20211011010125","Shop","AAA05","6","360000","120000","240000","2021-10-11 13:01:25"
"161","46","20211011123837","Shop","AAA03","13","221000","39000","182000","2021-10-11 12:38:37"
"162","74","20211011114449","Mobile","AAA05","7","420000","140000","280000","2021-10-11 11:44:49"
"163","50","20211011104657","Mobile","AAA03","7","119000","21000","98000","2021-10-11 10:46:57"
"164","60","20211007121110","Shop","AAA03","7","119000","21000","98000","2021-10-07 12:11:10"
"165","69","20211007094401","Mobile","AAA01","1","10000","2000","8000","2021-10-07 09:44:01"
"166","42","20211007083634","PC","AAA02","1","15000","2300","12700","2021-10-07 08:36:34"
"167","59","20211007075841","Mobile","AAA02","8","120000","18400","101600","2021-10-07 07:58:41"
"168","44","20211006054550","PC","AAA04","7","56000","2800","53200","2021-10-06 17:45:50"
"169","48","20211006045517","PC","AAA05","6","360000","120000","240000","2021-10-06 16:55:17"
"170","37","20211006032207","PC","AAA03","4","68000","12000","56000","2021-10-06 15:22:07"
"171","26","20211006021840","PC","AAA01","4","40000","8000","32000","2021-10-06 14:18:40"
"172","94","20211006011648","PC","AAA03","19","323000","57000","266000","2021-10-06 13:16:48"
"173","94","20211006114850","Shop","AAA02","18","270000","41400","228600","2021-10-06 11:48:50"
"174","12","20211006104043","PC","AAA01","1","10000","2000","8000","2021-10-06 10:40:43"
"175","42","20211006082823","Shop","AAA01","8","80000","16000","64000","2021-10-06 08:28:23"
"176","8","20211006072627","Shop","AAA03","9","153000","27000","126000","2021-10-06 07:26:27"
"177","70","20211005080642","PC","AAA03","18","306000","54000","252000","2021-10-05 20:06:42"
"178","37","20211005025509","Shop","AAA01","8","80000","16000","64000","2021-10-05 14:55:09"
"179","22","20211005022819","Mobile","AAA03","15","255000","45000","210000","2021-10-05 14:28:19"
"180","4","20211005012751","Mobile","AAA01","6","60000","12000","48000","2021-10-05 13:27:51"
"181","48","20211005124446","PC","AAA05","4","240000","80000","160000","2021-10-05 12:44:46"
"182","96","20211005121906","Shop","AAA05","7","420000","140000","280000","2021-10-05 12:19:06"
"183","32","20211005111742","PC","AAA04","14","112000","5600","106400","2021-10-05 11:17:42"
"184","97","20211005095207","PC","AAA05","5","300000","100000","200000","2021-10-05 09:52:07"
"185","32","20211005090406","Shop","AAA03","18","306000","54000","252000","2021-10-05 09:04:06"
"186","64","20211005073503","Mobile","AAA04","11","88000","4400","83600","2021-10-05 07:35:03"
"187","86","20211004111952","Mobile","AAA02","6","90000","13800","76200","2021-10-04 23:19:52"
"188","14","20211004034510","Mobile","AAA03","3","51000","9000","42000","2021-10-04 15:45:10"
"189","27","20211004030303","PC","AAA02","14","210000","32200","177800","2021-10-04 15:03:03"
"190","80","20211004015956","PC","AAA02","7","105000","16100","88900","2021-10-04 13:59:56"
"191","56","20211004112323","Shop","AAA03","11","187000","33000","154000","2021-10-04 11:23:23"
"192","1","20211004083914","PC","AAA04","8","64000","3200","60800","2021-10-04 08:39:14"
"193","80","20210930070330","PC","AAA04","11","88000","4400","83600","2021-09-30 07:03:30"
"194","24","20210929101039","Shop","AAA05","2","120000","40000","80000","2021-09-29 22:10:39"
"195","6","20210929025259","Shop","AAA03","3","51000","9000","42000","2021-09-29 14:52:59"
"196","90","20210929125050","PC","AAA01","7","70000","14000","56000","2021-09-29 12:50:50"
"197","85","20210929105919","Mobile","AAA03","8","136000","24000","112000","2021-09-29 10:59:19"
"198","90","20210929093521","PC","AAA05","2","120000","40000","80000","2021-09-29 09:35:21"
"199","7","20210929084006","Mobile","AAA02","4","60000","9200","50800","2021-09-29 08:40:06"
"200","2","20210929074153","Shop","AAA03","5","85000","15000","70000","2021-09-29 07:41:53"
"201","16","20210928113605","PC","AAA05","11","660000","220000","440000","2021-09-28 23:36:05"
"202","38","20210928073057","Shop","AAA04","6","48000","2400","45600","2021-09-28 07:30:57"
"203","63","20210927045632","PC","AAA02","8","120000","18400","101600","2021-09-27 16:56:32"
"204","22","20210927040626","Mobile","AAA05","11","660000","220000","440000","2021-09-27 16:06:26"
"205","14","20210927030358","Shop","AAA02","10","150000","23000","127000","2021-09-27 15:03:58"
"206","37","20210927021033","Shop","AAA02","11","165000","25300","139700","2021-09-27 14:10:33"
"207","35","20210927010422","PC","AAA05","7","420000","140000","280000","2021-09-27 13:04:22"
"208","8","20210927121125","Shop","AAA05","8","480000","160000","320000","2021-09-27 12:11:25"
"209","26","20210927105947","Mobile","AAA05","6","360000","120000","240000","2021-09-27 10:59:47"
"210","43","20210927093659","PC","AAA03","8","136000","24000","112000","2021-09-27 09:36:59"
"211","41","20210924053027","Shop","AAA04","7","56000","2800","53200","2021-09-24 17:30:27"
"212","8","20210924041117","PC","AAA01","6","60000","12000","48000","2021-09-24 16:11:17"
"213","62","20210924030414","Mobile","AAA01","4","40000","8000","32000","2021-09-24 15:04:14"
"214","88","20210924123820","Mobile","AAA01","4","40000","8000","32000","2021-09-24 12:38:20"
"215","80","20210923041742","Mobile","AAA05","12","720000","240000","480000","2021-09-23 16:17:42"
"216","46","20210923031250","PC","AAA02","22","330000","50600","279400","2021-09-23 15:12:50"
"217","83","20210923014620","PC","AAA01","8","80000","16000","64000","2021-09-23 13:46:20"
"218","55","20210923115750","PC","AAA03","8","136000","24000","112000","2021-09-23 11:57:50"
"219","86","20210923104036","Mobile","AAA02","5","75000","11500","63500","2021-09-23 10:40:36"
"220","26","20210923092601","PC","AAA02","4","60000","9200","50800","2021-09-23 09:26:01"
"221","20","20210923083857","Mobile","AAA02","1","15000","2300","12700","2021-09-23 08:38:57"
"222","20","20210923070105","Mobile","AAA02","2","30000","4600","25400","2021-09-23 07:01:05"
"223","29","20210922080651","Shop","AAA03","7","119000","21000","98000","2021-09-22 20:06:51"
"224","76","20210922061101","Shop","AAA01","11","110000","22000","88000","2021-09-22 18:11:01"
"225","31","20210922032248","Shop","AAA02","7","105000","16100","88900","2021-09-22 15:22:48"
"226","46","20210922023350","Mobile","AAA03","8","136000","24000","112000","2021-09-22 14:33:50"
"227","77","20210922123958","Shop","AAA04","1","8000","400","7600","2021-09-22 12:39:58"
"228","82","20210922112205","Mobile","AAA02","10","150000","23000","127000","2021-09-22 11:22:05"
"229","98","20210922100435","Shop","AAA05","1","60000","20000","40000","2021-09-22 10:04:35"
"230","3","20210922092755","Shop","AAA01","1","10000","2000","8000","2021-09-22 09:27:55"
"231","40","20210921095532","Shop","AAA02","3","45000","6900","38100","2021-09-21 21:55:32"
"232","6","20210921060725","Mobile","AAA05","4","240000","80000","160000","2021-09-21 18:07:25"
"233","31","20210921023006","Shop","AAA03","4","68000","12000","56000","2021-09-21 14:30:06"
"234","17","20210921012935","PC","AAA01","16","160000","32000","128000","2021-09-21 13:29:35"
"235","24","20210921122013","PC","AAA05","10","600000","200000","400000","2021-09-21 12:20:13"
"236","79","20210921112219","Shop","AAA05","9","540000","180000","360000","2021-09-21 11:22:19"
"237","43","20210921105401","Shop","AAA01","6","60000","12000","48000","2021-09-21 10:54:01"
"238","65","20210921092854","PC","AAA05","11","660000","220000","440000","2021-09-21 09:28:54"
"239","92","20210921080825","Shop","AAA05","9","540000","180000","360000","2021-09-21 08:08:25"
"240","19","20210921063830","Shop","AAA02","1","15000","2300","12700","2021-09-21 06:38:30"
"241","6","20210920110422","PC","AAA03","1","17000","3000","14000","2021-09-20 23:04:22"
"242","78","20210920062449","Mobile","AAA05","6","360000","120000","240000","2021-09-20 06:24:49"
"243","12","20210918091804","Mobile","AAA02","3","45000","6900","38100","2021-09-18 09:18:04"
"244","83","20210917072607","Mobile","AAA03","14","238000","42000","196000","2021-09-17 19:26:07"
"245","3","20210917031610","Mobile","AAA05","7","420000","140000","280000","2021-09-17 15:16:10"
"246","34","20210917020148","Mobile","AAA05","14","840000","280000","560000","2021-09-17 14:01:48"
"247","89","20210917011413","Shop","AAA02","24","360000","55200","304800","2021-09-17 13:14:13"
"248","18","20210917114924","Shop","AAA04","7","56000","2800","53200","2021-09-17 11:49:24"
"249","35","20210917104348","Mobile","AAA01","1","10000","2000","8000","2021-09-17 10:43:48"
"250","3","20210917090727","PC","AAA03","13","221000","39000","182000","2021-09-17 09:07:27"
"251","4","20210917075349","PC","AAA01","2","20000","4000","16000","2021-09-17 07:53:49"
"252","44","20210916023844","Shop","AAA01","10","100000","20000","80000","2021-09-16 14:38:44"
"253","39","20210916125215","Mobile","AAA01","8","80000","16000","64000","2021-09-16 12:52:15"
"254","77","20210916114602","Mobile","AAA01","10","100000","20000","80000","2021-09-16 11:46:02"
"255","35","20210916111148","Shop","AAA03","9","153000","27000","126000","2021-09-16 11:11:48"
"256","68","20210916093514","PC","AAA05","13","780000","260000","520000","2021-09-16 09:35:14"
"257","62","20210916080243","PC","AAA02","9","135000","20700","114300","2021-09-16 08:02:43"
"258","62","20210916121204","PC","AAA01","10","100000","20000","80000","2021-09-16 00:12:04"
"259","16","20210915070739","Shop","AAA04","8","64000","3200","60800","2021-09-15 19:07:39"
"260","83","20210915035641","Mobile","AAA03","17","289000","51000","238000","2021-09-15 15:56:41"
"261","20","20210915032329","PC","AAA04","1","8000","400","7600","2021-09-15 15:23:29"
"262","58","20210915021251","PC","AAA03","8","136000","24000","112000","2021-09-15 14:12:51"
"263","60","20210915010922","PC","AAA05","9","540000","180000","360000","2021-09-15 13:09:22"
"264","70","20210915103936","Shop","AAA01","16","160000","32000","128000","2021-09-15 10:39:36"
"265","57","20210915082547","Mobile","AAA01","7","70000","14000","56000","2021-09-15 08:25:47"
"266","99","20210915075350","Shop","AAA01","3","30000","6000","24000","2021-09-15 07:53:50"
"267","51","20210914065626","Mobile","AAA04","7","56000","2800","53200","2021-09-14 18:56:26"
"268","19","20210914040421","Mobile","AAA03","8","136000","24000","112000","2021-09-14 16:04:21"
"269","2","20210914022230","PC","AAA05","5","300000","100000","200000","2021-09-14 14:22:30"
"270","41","20210914013328","PC","AAA01","17","170000","34000","136000","2021-09-14 13:33:28"
"271","51","20210914120723","Mobile","AAA01","17","170000","34000","136000","2021-09-14 12:07:23"
"272","83","20210914110117","Mobile","AAA04","1","8000","400","7600","2021-09-14 11:01:17"
"273","25","20210914100426","PC","AAA03","9","153000","27000","126000","2021-09-14 10:04:26"
"274","62","20210914082636","Shop","AAA05","10","600000","200000","400000","2021-09-14 08:26:36"
"275","26","20210914070556","PC","AAA03","4","68000","12000","56000","2021-09-14 07:05:56"
"276","30","20210913112046","PC","AAA02","9","135000","20700","114300","2021-09-13 23:20:46"
"277","61","20210913062130","Mobile","AAA03","8","136000","24000","112000","2021-09-13 06:21:30"
"278","66","20210910010523","Mobile","AAA04","10","80000","4000","76000","2021-09-10 13:05:23"
"279","6","20210910082436","PC","AAA02","1","15000","2300","12700","2021-09-10 08:24:36"
"280","51","20210909055808","Mobile","AAA03","2","34000","6000","28000","2021-09-09 17:58:08"
"281","76","20210909043444","PC","AAA04","8","64000","3200","60800","2021-09-09 16:34:44"
"282","25","20210909035442","PC","AAA03","6","102000","18000","84000","2021-09-09 15:54:42"
"283","15","20210909022340","Mobile","AAA03","26","442000","78000","364000","2021-09-09 14:23:40"
"284","45","20210909012136","Mobile","AAA04","4","32000","1600","30400","2021-09-09 13:21:36"
"285","6","20210909114737","PC","AAA01","5","50000","10000","40000","2021-09-09 11:47:37"
"286","19","20210909105914","PC","AAA03","4","68000","12000","56000","2021-09-09 10:59:14"
"287","43","20210909095607","Mobile","AAA02","7","105000","16100","88900","2021-09-09 09:56:07"
"288","58","20210909081930","Mobile","AAA01","1","10000","2000","8000","2021-09-09 08:19:30"
"289","89","20210909073136","Shop","AAA03","2","34000","6000","28000","2021-09-09 07:31:36"
"290","82","20210909122416","Shop","AAA03","5","85000","15000","70000","2021-09-09 00:24:16"
"291","4","20210908034942","Mobile","AAA05","4","240000","80000","160000","2021-09-08 15:49:42"
"292","60","20210908021129","Shop","AAA02","1","15000","2300","12700","2021-09-08 14:11:29"
"293","6","20210908010604","Shop","AAA04","8","64000","3200","60800","2021-09-08 13:06:04"
"294","59","20210908121803","Mobile","AAA01","3","30000","6000","24000","2021-09-08 12:18:03"
"295","15","20210908100129","Mobile","AAA03","13","221000","39000","182000","2021-09-08 10:01:29"
"296","60","20210908091057","Shop","AAA04","12","96000","4800","91200","2021-09-08 09:10:57"
"297","41","20210908074205","Mobile","AAA03","7","119000","21000","98000","2021-09-08 07:42:05"
"298","32","20210907101227","Mobile","AAA01","3","30000","6000","24000","2021-09-07 22:12:27"
"299","64","20210907065109","PC","AAA05","7","420000","140000","280000","2021-09-07 18:51:09"
"300","69","20210907024231","PC","AAA05","1","60000","20000","40000","2021-09-07 14:42:31"
"301","39","20210907020451","Shop","AAA01","5","50000","10000","40000","2021-09-07 14:04:51"
"302","63","20210907125719","PC","AAA03","5","85000","15000","70000","2021-09-07 12:57:19"
"303","66","20210907115704","Mobile","AAA02","6","90000","13800","76200","2021-09-07 11:57:04"
"304","29","20210907100445","PC","AAA01","11","110000","22000","88000","2021-09-07 10:04:45"
"305","87","20210907092333","Shop","AAA01","6","60000","12000","48000","2021-09-07 09:23:33"
"306","47","20210907064302","Mobile","AAA03","6","102000","18000","84000","2021-09-07 06:43:02"
"307","8","20210906112228","Shop","AAA04","1","8000","400","7600","2021-09-06 23:22:28"
"308","10","20210906110912","Mobile","AAA04","11","88000","4400","83600","2021-09-06 11:09:12"
"309","31","20210906100356","Mobile","AAA01","2","20000","4000","16000","2021-09-06 10:03:56"
"310","84","20210906100359","PC","AAA03","2","34000","6000","28000","2021-09-06 10:03:59"
"311","13","20210903073830","PC","AAA02","3","45000","6900","38100","2021-09-03 07:38:30"
"312","77","20210902102234","Shop","AAA03","2","34000","6000","28000","2021-09-02 22:22:34"
"313","26","20210902054540","PC","AAA02","3","45000","6900","38100","2021-09-02 17:45:40"
"314","31","20210902043003","PC","AAA04","5","40000","2000","38000","2021-09-02 16:30:03"
"315","1","20210902040820","Mobile","AAA02","1","15000","2300","12700","2021-09-02 16:08:20"
"316","14","20210902025140","PC","AAA05","3","180000","60000","120000","2021-09-02 14:51:40"
"317","7","20210902011223","Mobile","AAA05","3","180000","60000","120000","2021-09-02 13:12:23"
"318","42","20210902122552","PC","AAA01","5","50000","10000","40000","2021-09-02 12:25:52"
"319","68","20210902115648","PC","AAA03","4","68000","12000","56000","2021-09-02 11:56:48"
"320","65","20210902103545","Mobile","AAA02","8","120000","18400","101600","2021-09-02 10:35:45"
"321","47","20210902093742","Shop","AAA05","2","120000","40000","80000","2021-09-02 09:37:42"
"322","20","20210902085234","Mobile","AAA05","6","360000","120000","240000","2021-09-02 08:52:34"
"323","59","20210902074755","Mobile","AAA04","5","40000","2000","38000","2021-09-02 07:47:55"
"324","70","20210901093233","Shop","AAA01","11","110000","22000","88000","2021-09-01 21:32:33"
"325","26","20210901060126","Shop","AAA03","11","187000","33000","154000","2021-09-01 18:01:26"
"326","22","20210901032127","Shop","AAA01","8","80000","16000","64000","2021-09-01 15:21:27"
"327","31","20210901024027","PC","AAA01","12","120000","24000","96000","2021-09-01 14:40:27"
"328","48","20210901010808","Shop","AAA04","11","88000","4400","83600","2021-09-01 13:08:08"
"329","25","20210901121319","Mobile","AAA05","3","180000","60000","120000","2021-09-01 12:13:19"
"330","97","20210901111545","PC","AAA02","12","180000","27600","152400","2021-09-01 11:15:45"
"331","2","20210901095710","Mobile","AAA01","4","40000","8000","32000","2021-09-01 09:57:10"
"332","81","20210901084541","Mobile","AAA03","8","136000","24000","112000","2021-09-01 08:45:41"
"333","37","20210901072931","Shop","AAA01","9","90000","18000","72000","2021-09-01 07:29:31"
"334","44","20210831010240","Mobile","AAA04","7","56000","2800","53200","2021-08-31 13:02:40"
"335","25","20210831121941","Mobile","AAA03","2","34000","6000","28000","2021-08-31 12:19:41"
"336","36","20210831105517","Shop","AAA03","10","170000","30000","140000","2021-08-31 10:55:17"
"337","71","20210831101005","Mobile","AAA02","16","240000","36800","203200","2021-08-31 10:10:05"
"338","37","20210831091005","Mobile","AAA05","17","1020000","340000","680000","2021-08-31 09:10:05"
"339","79","20210831082923","Mobile","AAA05","5","300000","100000","200000","2021-08-31 08:29:23"
"340","23","20210831071255","Mobile","AAA03","5","85000","15000","70000","2021-08-31 07:12:55"
"341","71","20210830033156","PC","AAA01","10","100000","20000","80000","2021-08-30 15:31:56"
"342","29","20210830012306","Mobile","AAA05","12","720000","240000","480000","2021-08-30 13:23:06"
"343","43","20210830123241","Shop","AAA02","10","150000","23000","127000","2021-08-30 12:32:41"
"344","23","20210830110707","Shop","AAA01","4","40000","8000","32000","2021-08-30 11:07:07"
"345","35","20210830101824","Mobile","AAA01","5","50000","10000","40000","2021-08-30 10:18:24"
"346","32","20210830092737","PC","AAA05","14","840000","280000","560000","2021-08-30 09:27:37"
"347","37","20210826045251","Shop","AAA01","7","70000","14000","56000","2021-08-26 16:52:51"
"348","100","20210826035321","Mobile","AAA01","3","30000","6000","24000","2021-08-26 15:53:21"
"349","68","20210826031012","Mobile","AAA05","7","420000","140000","280000","2021-08-26 15:10:12"
"350","24","20210826020447","Mobile","AAA02","6","90000","13800","76200","2021-08-26 14:04:47"
"351","87","20210826011250","Mobile","AAA04","3","24000","1200","22800","2021-08-26 13:12:50"
"352","64","20210826115529","Shop","AAA05","10","600000","200000","400000","2021-08-26 11:55:29"
"353","74","20210826112639","Mobile","AAA03","6","102000","18000","84000","2021-08-26 11:26:39"
"354","67","20210826095727","Shop","AAA03","6","102000","18000","84000","2021-08-26 09:57:27"
"355","10","20210826090720","PC","AAA04","6","48000","2400","45600","2021-08-26 09:07:20"
"356","29","20210826075707","Shop","AAA01","3","30000","6000","24000","2021-08-26 07:57:07"
"357","40","20210825092614","PC","AAA04","9","72000","3600","68400","2021-08-25 21:26:14"
"358","96","20210825054500","Mobile","AAA03","13","221000","39000","182000","2021-08-25 17:45:00"
"359","38","20210825053907","Shop","AAA02","5","75000","11500","63500","2021-08-25 17:39:07"
"360","3","20210825040302","Mobile","AAA03","7","119000","21000","98000","2021-08-25 16:03:02"
"361","82","20210825032455","PC","AAA03","8","136000","24000","112000","2021-08-25 15:24:55"
"362","53","20210825025330","Mobile","AAA05","3","180000","60000","120000","2021-08-25 14:53:30"
"363","60","20210825021825","Mobile","AAA03","6","102000","18000","84000","2021-08-25 14:18:25"
"364","27","20210825011943","Shop","AAA04","1","8000","400","7600","2021-08-25 13:19:43"
"365","76","20210825110108","Mobile","AAA04","9","72000","3600","68400","2021-08-25 11:01:08"
"366","80","20210825100900","PC","AAA05","10","600000","200000","400000","2021-08-25 10:09:00"
"367","44","20210825085826","Mobile","AAA04","4","32000","1600","30400","2021-08-25 08:58:26"
"368","1","20210825065557","Shop","AAA03","8","136000","24000","112000","2021-08-25 06:55:57"
"369","70","20210824051058","Mobile","AAA01","6","60000","12000","48000","2021-08-24 17:10:58"
"370","58","20210824031753","Mobile","AAA01","3","30000","6000","24000","2021-08-24 15:17:53"
"371","28","20210824014846","Mobile","AAA01","3","30000","6000","24000","2021-08-24 13:48:46"
"372","36","20210824120026","PC","AAA03","23","391000","69000","322000","2021-08-24 12:00:26"
"373","37","20210824105228","Shop","AAA02","2","30000","4600","25400","2021-08-24 10:52:28"
"374","83","20210824102012","PC","AAA03","13","221000","39000","182000","2021-08-24 10:20:12"
"375","51","20210824094651","Mobile","AAA02","1","15000","2300","12700","2021-08-24 09:46:51"
"376","34","20210824082952","Mobile","AAA04","5","40000","2000","38000","2021-08-24 08:29:52"
"377","89","20210824072742","Shop","AAA03","15","255000","45000","210000","2021-08-24 07:27:42"
"378","95","20210823023917","Mobile","AAA04","3","24000","1200","22800","2021-08-23 14:39:17"
"379","70","20210823011725","PC","AAA01","18","180000","36000","144000","2021-08-23 13:17:25"
"380","8","20210823121502","PC","AAA04","3","24000","1200","22800","2021-08-23 12:15:02"
"381","38","20210823104836","Shop","AAA03","7","119000","21000","98000","2021-08-23 10:48:36"
"382","1","20210823102313","PC","AAA04","11","88000","4400","83600","2021-08-23 10:23:13"
"383","64","20210823090819","PC","AAA05","5","300000","100000","200000","2021-08-23 09:08:19"
"384","31","20210821041026","Mobile","AAA01","4","40000","8000","32000","2021-08-21 16:10:26"
"385","23","20210821055222","Mobile","AAA02","8","120000","18400","101600","2021-08-21 05:52:22"
"386","50","20210820092415","Shop","AAA03","10","170000","30000","140000","2021-08-20 09:24:15"
"387","95","20210820081456","PC","AAA01","3","30000","6000","24000","2021-08-20 08:14:56"
"388","28","20210820071035","Mobile","AAA01","5","50000","10000","40000","2021-08-20 07:10:35"
"389","28","20210819092319","Shop","AAA01","8","80000","16000","64000","2021-08-19 21:23:19"
"390","21","20210819074825","Shop","AAA02","21","315000","48300","266700","2021-08-19 19:48:25"
"391","22","20210819034011","Mobile","AAA04","1","8000","400","7600","2021-08-19 15:40:11"
"392","45","20210819022307","PC","AAA02","5","75000","11500","63500","2021-08-19 14:23:07"
"393","45","20210819014201","PC","AAA04","6","48000","2400","45600","2021-08-19 13:42:01"
"394","47","20210819122557","PC","AAA01","3","30000","6000","24000","2021-08-19 12:25:57"
"395","86","20210819113659","PC","AAA05","7","420000","140000","280000","2021-08-19 11:36:59"
"396","4","20210819102605","PC","AAA05","6","360000","120000","240000","2021-08-19 10:26:05"
"397","88","20210819082850","Shop","AAA04","13","104000","5200","98800","2021-08-19 08:28:50"
"398","21","20210819071932","Shop","AAA04","2","16000","800","15200","2021-08-19 07:19:32"
"399","23","20210818110849","Shop","AAA02","1","15000","2300","12700","2021-08-18 23:08:49"
"400","81","20210818011745","Shop","AAA04","3","24000","1200","22800","2021-08-18 13:17:45"
"401","88","20210818120053","PC","AAA02","3","45000","6900","38100","2021-08-18 12:00:53"
"402","70","20210818102007","PC","AAA04","25","200000","10000","190000","2021-08-18 10:20:07"
"403","22","20210818085809","Shop","AAA01","3","30000","6000","24000","2021-08-18 08:58:09"
"404","36","20210818080429","Shop","AAA04","12","96000","4800","91200","2021-08-18 08:04:29"
"405","79","20210817043225","Mobile","AAA03","8","136000","24000","112000","2021-08-17 16:32:25"
"406","12","20210817035707","Shop","AAA02","6","90000","13800","76200","2021-08-17 15:57:07"
"407","29","20210817020525","Mobile","AAA05","12","720000","240000","480000","2021-08-17 14:05:25"
"408","5","20210817113810","PC","AAA04","13","104000","5200","98800","2021-08-17 11:38:10"
"409","100","20210817110902","Mobile","AAA03","2","34000","6000","28000","2021-08-17 11:09:02"
"410","64","20210817100757","PC","AAA03","11","187000","33000","154000","2021-08-17 10:07:57"
"411","1","20210817092859","PC","AAA03","3","51000","9000","42000","2021-08-17 09:28:59"
"412","50","20210817082011","PC","AAA03","11","187000","33000","154000","2021-08-17 08:20:11"
"413","29","20210817075129","Mobile","AAA02","8","120000","18400","101600","2021-08-17 07:51:29"
"414","21","20210816053500","Shop","AAA03","8","136000","24000","112000","2021-08-16 17:35:00"
"415","78","20210816021333","Mobile","AAA01","3","30000","6000","24000","2021-08-16 14:13:33"
"416","36","20210816123945","PC","AAA02","9","135000","20700","114300","2021-08-16 12:39:45"
"417","49","20210816112019","PC","AAA01","10","100000","20000","80000","2021-08-16 11:20:19"
"418","35","20210816101842","PC","AAA05","6","360000","120000","240000","2021-08-16 10:18:42"
"419","10","20210816090612","Mobile","AAA03","16","272000","48000","224000","2021-08-16 09:06:12"
"420","99","20210813110704","Shop","AAA02","4","60000","9200","50800","2021-08-13 11:07:04"
"421","78","20210813091055","Shop","AAA04","13","104000","5200","98800","2021-08-13 09:10:55"
"422","84","20210813081609","Shop","AAA04","3","24000","1200","22800","2021-08-13 08:16:09"
"423","68","20210813074200","Mobile","AAA03","13","221000","39000","182000","2021-08-13 07:42:00"
"424","83","20210813123108","Shop","AAA04","10","80000","4000","76000","2021-08-13 00:31:08"
"425","100","20210812012827","Mobile","AAA01","4","40000","8000","32000","2021-08-12 13:28:27"
"426","3","20210812121405","Shop","AAA02","9","135000","20700","114300","2021-08-12 12:14:05"
"427","47","20210812110817","PC","AAA03","9","153000","27000","126000","2021-08-12 11:08:17"
"428","75","20210812085628","Shop","AAA02","1","15000","2300","12700","2021-08-12 08:56:28"
"429","78","20210812073836","Shop","AAA03","12","204000","36000","168000","2021-08-12 07:38:36"
"430","79","20210811101957","Shop","AAA03","2","34000","6000","28000","2021-08-11 22:19:57"
"431","84","20210811043234","Mobile","AAA05","6","360000","120000","240000","2021-08-11 16:32:34"
"432","48","20210811024630","Mobile","AAA01","7","70000","14000","56000","2021-08-11 14:46:30"
"433","64","20210811010901","Mobile","AAA03","12","204000","36000","168000","2021-08-11 13:09:01"
"434","96","20210811120302","Shop","AAA01","19","190000","38000","152000","2021-08-11 12:03:02"
"435","20","20210811111508","PC","AAA04","10","80000","4000","76000","2021-08-11 11:15:08"
"436","55","20210811101855","PC","AAA01","1","10000","2000","8000","2021-08-11 10:18:55"
"437","64","20210811083837","Mobile","AAA03","7","119000","21000","98000","2021-08-11 08:38:37"
"438","88","20210811074820","Shop","AAA04","8","64000","3200","60800","2021-08-11 07:48:20"
"439","8","20210810091405","PC","AAA02","14","210000","32200","177800","2021-08-10 21:14:05"
"440","31","20210810042048","PC","AAA05","2","120000","40000","80000","2021-08-10 16:20:48"
"441","5","20210810032906","Shop","AAA05","11","660000","220000","440000","2021-08-10 15:29:06"
"442","12","20210810125025","PC","AAA04","4","32000","1600","30400","2021-08-10 12:50:25"
"443","26","20210810100908","Mobile","AAA01","1","10000","2000","8000","2021-08-10 10:09:08"
"444","22","20210810083634","Shop","AAA04","12","96000","4800","91200","2021-08-10 08:36:34"
"445","15","20210810074839","Mobile","AAA03","4","68000","12000","56000","2021-08-10 07:48:39"
"446","36","20210809032045","Mobile","AAA01","2","20000","4000","16000","2021-08-09 15:20:45"
"447","36","20210809015759","Mobile","AAA05","9","540000","180000","360000","2021-08-09 13:57:59"
"448","35","20210809012738","Shop","AAA03","7","119000","21000","98000","2021-08-09 13:27:38"
"449","51","20210809125438","Shop","AAA02","4","60000","9200","50800","2021-08-09 12:54:38"
"450","37","20210809113653","Mobile","AAA04","13","104000","5200","98800","2021-08-09 11:36:53"
"451","33","20210809104509","Shop","AAA02","5","75000","11500","63500","2021-08-09 10:45:09"
"452","65","20210809100412","PC","AAA04","5","40000","2000","38000","2021-08-09 10:04:12"
"453","32","20210809085501","Shop","AAA02","2","30000","4600","25400","2021-08-09 08:55:01"
"454","45","20210806065059","Shop","AAA04","2","16000","800","15200","2021-08-06 18:50:59"
"455","67","20210806030626","Mobile","AAA04","5","40000","2000","38000","2021-08-06 15:06:26"
"456","5","20210806015156","Shop","AAA01","11","110000","22000","88000","2021-08-06 13:51:56"
"457","51","20210806124948","Mobile","AAA04","5","40000","2000","38000","2021-08-06 12:49:48"
"458","47","20210806114617","PC","AAA03","7","119000","21000","98000","2021-08-06 11:46:17"
"459","7","20210806111344","Mobile","AAA03","6","102000","18000","84000","2021-08-06 11:13:44"
"460","52","20210806093431","Mobile","AAA02","5","75000","11500","63500","2021-08-06 09:34:31"
"461","50","20210806080249","Mobile","AAA03","9","153000","27000","126000","2021-08-06 08:02:49"
"462","49","20210806071537","PC","AAA03","4","68000","12000","56000","2021-08-06 07:15:37"
"463","45","20210805063214","Mobile","AAA03","1","17000","3000","14000","2021-08-05 18:32:14"
"464","1","20210805035209","Shop","AAA04","6","48000","2400","45600","2021-08-05 15:52:09"
"465","71","20210805030121","Shop","AAA05","3","180000","60000","120000","2021-08-05 15:01:21"
"466","36","20210805012404","PC","AAA03","21","357000","63000","294000","2021-08-05 13:24:04"
"467","69","20210805121930","Mobile","AAA05","6","360000","120000","240000","2021-08-05 12:19:30"
"468","42","20210805112115","Shop","AAA01","6","60000","12000","48000","2021-08-05 11:21:15"
"469","95","20210805105554","Shop","AAA04","1","8000","400","7600","2021-08-05 10:55:54"
"470","37","20210805084622","Mobile","AAA01","18","180000","36000","144000","2021-08-05 08:46:22"
"471","43","20210805073026","PC","AAA05","6","360000","120000","240000","2021-08-05 07:30:26"
"472","3","20210804093232","Mobile","AAA02","23","345000","52900","292100","2021-08-04 21:32:32"
"473","91","20210804055840","Shop","AAA02","7","105000","16100","88900","2021-08-04 17:58:40"
"474","8","20210804031400","Mobile","AAA02","9","135000","20700","114300","2021-08-04 15:14:00"
"475","20","20210804021644","Shop","AAA05","6","360000","120000","240000","2021-08-04 14:16:44"
"476","75","20210804124343","Mobile","AAA05","5","300000","100000","200000","2021-08-04 12:43:43"
"477","1","20210804115918","Mobile","AAA02","15","225000","34500","190500","2021-08-04 11:59:18"
"478","31","20210804111348","Mobile","AAA02","3","45000","6900","38100","2021-08-04 11:13:48"
"479","47","20210804101739","Mobile","AAA04","18","144000","7200","136800","2021-08-04 10:17:39"
"480","90","20210804094802","Shop","AAA04","6","48000","2400","45600","2021-08-04 09:48:02"
"481","38","20210804082650","Shop","AAA02","11","165000","25300","139700","2021-08-04 08:26:50"
"482","60","20210804072441","Shop","AAA05","3","180000","60000","120000","2021-08-04 07:24:41"
"483","74","20210803062652","Shop","AAA05","3","180000","60000","120000","2021-08-03 18:26:52"
"484","36","20210803040835","Shop","AAA05","7","420000","140000","280000","2021-08-03 16:08:35"
"485","55","20210803025029","PC","AAA04","10","80000","4000","76000","2021-08-03 14:50:29"
"486","38","20210803015727","Shop","AAA01","7","70000","14000","56000","2021-08-03 13:57:27"
"487","66","20210803123958","Mobile","AAA03","10","170000","30000","140000","2021-08-03 12:39:58"
"488","51","20210803101537","Shop","AAA05","9","540000","180000","360000","2021-08-03 10:15:37"
"489","86","20210803092417","Mobile","AAA03","8","136000","24000","112000","2021-08-03 09:24:17"
"490","94","20210803084406","PC","AAA02","10","150000","23000","127000","2021-08-03 08:44:06"
"491","16","20210803072442","Shop","AAA04","34","272000","13600","258400","2021-08-03 07:24:42"
"492","68","20210802052728","Shop","AAA02","2","30000","4600","25400","2021-08-02 17:27:28"
"493","38","20210802031205","Mobile","AAA03","9","153000","27000","126000","2021-08-02 15:12:05"
"494","46","20210802012636","Mobile","AAA05","3","180000","60000","120000","2021-08-02 13:26:36"
"495","90","20210802115837","PC","AAA02","5","75000","11500","63500","2021-08-02 11:58:37"
"496","58","20210802110108","PC","AAA02","1","15000","2300","12700","2021-08-02 11:01:08"
"497","65","20210802102754","Shop","AAA05","10","600000","200000","400000","2021-08-02 10:27:54"
"498","3","20210802093642","PC","AAA04","16","128000","6400","121600","2021-08-02 09:36:42"
"499","46","20210731073054","PC","AAA03","5","85000","15000","70000","2021-07-31 19:30:54"
"500","3","20210730080451","Shop","AAA05","9","540000","180000","360000","2021-07-30 20:04:51"
"501","81","20210730034153","Shop","AAA04","6","48000","2400","45600","2021-07-30 15:41:53"
"502","14","20210730023237","Shop","AAA05","7","420000","140000","280000","2021-07-30 14:32:37"
"503","25","20210730015659","Mobile","AAA05","9","540000","180000","360000","2021-07-30 13:56:59"
"504","29","20210730124659","PC","AAA01","3","30000","6000","24000","2021-07-30 12:46:59"
"505","44","20210730120331","Mobile","AAA03","4","68000","12000","56000","2021-07-30 12:03:31"
"506","46","20210730110013","Shop","AAA02","2","30000","4600","25400","2021-07-30 11:00:13"
"507","17","20210730093748","PC","AAA05","6","360000","120000","240000","2021-07-30 09:37:48"
"508","90","20210730082142","PC","AAA04","3","24000","1200","22800","2021-07-30 08:21:42"
"509","84","20210729111546","PC","AAA05","1","60000","20000","40000","2021-07-29 23:15:46"
"510","2","20210729114538","PC","AAA05","10","600000","200000","400000","2021-07-29 11:45:38"
"511","55","20210729102921","Shop","AAA04","11","88000","4400","83600","2021-07-29 10:29:21"
"512","51","20210729091023","PC","AAA04","16","128000","6400","121600","2021-07-29 09:10:23"
"513","56","20210729074501","Mobile","AAA01","10","100000","20000","80000","2021-07-29 07:45:01"
"514","21","20210728103929","PC","AAA05","3","180000","60000","120000","2021-07-28 22:39:29"
"515","8","20210728083037","PC","AAA05","8","480000","160000","320000","2021-07-28 20:30:37"
"516","59","20210728054919","Mobile","AAA01","5","50000","10000","40000","2021-07-28 17:49:19"
"517","72","20210728051417","Mobile","AAA02","1","15000","2300","12700","2021-07-28 17:14:17"
"518","90","20210728024755","PC","AAA05","6","360000","120000","240000","2021-07-28 14:47:55"
"519","28","20210728020326","Shop","AAA04","10","80000","4000","76000","2021-07-28 14:03:26"
"520","41","20210728122747","Mobile","AAA02","6","90000","13800","76200","2021-07-28 12:27:47"
"521","20","20210728112631","Mobile","AAA02","3","45000","6900","38100","2021-07-28 11:26:31"
"522","11","20210728101333","PC","AAA05","1","60000","20000","40000","2021-07-28 10:13:33"
"523","83","20210728091910","PC","AAA03","17","289000","51000","238000","2021-07-28 09:19:10"
"524","49","20210728083007","PC","AAA03","6","102000","18000","84000","2021-07-28 08:30:07"
"525","41","20210727062444","Shop","AAA03","8","136000","24000","112000","2021-07-27 18:24:44"
"526","58","20210727040242","Shop","AAA01","5","50000","10000","40000","2021-07-27 16:02:42"
"527","49","20210727021759","Mobile","AAA04","8","64000","3200","60800","2021-07-27 14:17:59"
"528","84","20210727125927","Shop","AAA02","1","15000","2300","12700","2021-07-27 12:59:27"
"529","76","20210727102848","Mobile","AAA02","6","90000","13800","76200","2021-07-27 10:28:48"
"530","41","20210727094449","PC","AAA02","8","120000","18400","101600","2021-07-27 09:44:49"
"531","43","20210727085939","PC","AAA03","8","136000","24000","112000","2021-07-27 08:59:39"
"532","29","20210727072326","Shop","AAA02","23","345000","52900","292100","2021-07-27 07:23:26"
"533","51","20210726085848","PC","AAA03","7","119000","21000","98000","2021-07-26 20:58:48"
"534","89","20210726075918","Shop","AAA01","23","230000","46000","184000","2021-07-26 19:59:18"
"535","22","20210726050335","Shop","AAA04","6","48000","2400","45600","2021-07-26 17:03:35"
"536","17","20210726042826","Mobile","AAA05","5","300000","100000","200000","2021-07-26 16:28:26"
"537","26","20210726033355","Shop","AAA03","7","119000","21000","98000","2021-07-26 15:33:55"
"538","20","20210726012503","Shop","AAA02","8","120000","18400","101600","2021-07-26 13:25:03"
"539","63","20210726120734","Mobile","AAA03","2","34000","6000","28000","2021-07-26 12:07:34"
"540","86","20210726113454","Shop","AAA04","9","72000","3600","68400","2021-07-26 11:34:54"
"541","70","20210726105349","Shop","AAA02","22","330000","50600","279400","2021-07-26 10:53:49"
"542","50","20210726102041","PC","AAA05","10","600000","200000","400000","2021-07-26 10:20:41"
"543","26","20210726091710","Shop","AAA04","3","24000","1200","22800","2021-07-26 09:17:10"
"544","18","20210723121827","Mobile","AAA05","6","360000","120000","240000","2021-07-23 12:18:27"
"545","28","20210723105348","PC","AAA03","4","68000","12000","56000","2021-07-23 10:53:48"
"546","65","20210723100148","Mobile","AAA01","16","160000","32000","128000","2021-07-23 10:01:48"
"547","27","20210723095605","Shop","AAA03","13","221000","39000","182000","2021-07-23 09:56:05"
"548","83","20210723083234","Mobile","AAA05","16","960000","320000","640000","2021-07-23 08:32:34"
"549","9","20210723071920","Shop","AAA01","5","50000","10000","40000","2021-07-23 07:19:20"
"550","58","20210722095541","Shop","AAA02","1","15000","2300","12700","2021-07-22 21:55:41"
"551","61","20210722054522","Shop","AAA02","6","90000","13800","76200","2021-07-22 17:45:22"
"552","14","20210722050943","Mobile","AAA02","4","60000","9200","50800","2021-07-22 17:09:43"
"553","4","20210722013330","Mobile","AAA03","1","17000","3000","14000","2021-07-22 13:33:30"
"554","97","20210722121417","Shop","AAA03","4","68000","12000","56000","2021-07-22 12:14:17"
"555","15","20210722112549","Shop","AAA04","9","72000","3600","68400","2021-07-22 11:25:49"
"556","81","20210722100423","PC","AAA02","9","135000","20700","114300","2021-07-22 10:04:23"
"557","56","20210722085718","Shop","AAA02","5","75000","11500","63500","2021-07-22 08:57:18"
"558","69","20210722072948","PC","AAA03","3","51000","9000","42000","2021-07-22 07:29:48"
"559","44","20210722014958","Mobile","AAA05","2","120000","40000","80000","2021-07-22 01:49:58"
"560","45","20210721084022","Mobile","AAA01","2","20000","4000","16000","2021-07-21 08:40:22"
"561","28","20210721070409","Shop","AAA01","12","120000","24000","96000","2021-07-21 07:04:09"
"562","27","20210720073011","Mobile","AAA05","7","420000","140000","280000","2021-07-20 19:30:11"
"563","76","20210720034754","Mobile","AAA03","7","119000","21000","98000","2021-07-20 15:47:54"
"564","97","20210720032221","Shop","AAA04","1","8000","400","7600","2021-07-20 15:22:21"
"565","26","20210720021203","PC","AAA05","1","60000","20000","40000","2021-07-20 14:12:03"
"566","16","20210720124705","Shop","AAA01","11","110000","22000","88000","2021-07-20 12:47:05"
"567","3","20210720120132","PC","AAA01","9","90000","18000","72000","2021-07-20 12:01:32"
"568","43","20210720111200","Shop","AAA01","7","70000","14000","56000","2021-07-20 11:12:00"
"569","50","20210720102058","Shop","AAA03","8","136000","24000","112000","2021-07-20 10:20:58"
"570","31","20210720071857","Mobile","AAA04","7","56000","2800","53200","2021-07-20 07:18:57"
"571","53","20210719102254","PC","AAA04","3","24000","1200","22800","2021-07-19 22:22:54"
"572","97","20210719074327","Mobile","AAA01","6","60000","12000","48000","2021-07-19 19:43:27"
"573","71","20210719061758","PC","AAA01","5","50000","10000","40000","2021-07-19 18:17:58"
"574","46","20210719022915","Mobile","AAA03","10","170000","30000","140000","2021-07-19 14:29:15"
"575","34","20210719011153","PC","AAA01","13","130000","26000","104000","2021-07-19 13:11:53"
"576","53","20210719121909","Shop","AAA05","2","120000","40000","80000","2021-07-19 12:19:09"
"577","52","20210719114109","Mobile","AAA02","5","75000","11500","63500","2021-07-19 11:41:09"
"578","48","20210719095559","Mobile","AAA05","14","840000","280000","560000","2021-07-19 09:55:59"
"579","18","20210717080639","Mobile","AAA02","4","60000","9200","50800","2021-07-17 08:06:39"
"580","62","20210716030752","PC","AAA05","1","60000","20000","40000","2021-07-16 15:07:52"
"581","4","20210716013536","Shop","AAA04","9","72000","3600","68400","2021-07-16 13:35:36"
"582","41","20210716121410","Shop","AAA02","1","15000","2300","12700","2021-07-16 12:14:10"
"583","32","20210716111018","Shop","AAA02","10","150000","23000","127000","2021-07-16 11:10:18"
"584","62","20210716102959","Shop","AAA03","4","68000","12000","56000","2021-07-16 10:29:59"
"585","3","20210716091955","Shop","AAA02","23","345000","52900","292100","2021-07-16 09:19:55"
"586","42","20210716080904","PC","AAA02","15","225000","34500","190500","2021-07-16 08:09:04"
"587","14","20210716071858","PC","AAA03","5","85000","15000","70000","2021-07-16 07:18:58"
"588","69","20210716063051","Mobile","AAA05","13","780000","260000","520000","2021-07-16 06:30:51"
"589","27","20210715074944","PC","AAA04","15","120000","6000","114000","2021-07-15 19:49:44"
"590","42","20210715053211","PC","AAA01","5","50000","10000","40000","2021-07-15 17:32:11"
"591","23","20210715031800","PC","AAA04","1","8000","400","7600","2021-07-15 15:18:00"
"592","42","20210715021109","Mobile","AAA03","9","153000","27000","126000","2021-07-15 14:11:09"
"593","93","20210715011957","Shop","AAA05","4","240000","80000","160000","2021-07-15 13:19:57"
"594","49","20210715120844","Shop","AAA04","4","32000","1600","30400","2021-07-15 12:08:44"
"595","3","20210715111229","Shop","AAA05","5","300000","100000","200000","2021-07-15 11:12:29"
"596","4","20210715101541","Shop","AAA03","5","85000","15000","70000","2021-07-15 10:15:41"
"597","14","20210715085822","Mobile","AAA02","4","60000","9200","50800","2021-07-15 08:58:22"
"598","82","20210715075732","PC","AAA05","7","420000","140000","280000","2021-07-15 07:57:32"
"599","73","20210714090047","PC","AAA04","16","128000","6400","121600","2021-07-14 21:00:47"
"600","99","20210714060405","PC","AAA05","2","120000","40000","80000","2021-07-14 18:04:05"
"601","55","20210714033451","Shop","AAA04","4","32000","1600","30400","2021-07-14 15:34:51"
"602","62","20210714025831","PC","AAA03","1","17000","3000","14000","2021-07-14 14:58:31"
"603","56","20210714020646","Mobile","AAA01","2","20000","4000","16000","2021-07-14 14:06:46"
"604","78","20210714011807","Shop","AAA05","12","720000","240000","480000","2021-07-14 13:18:07"
"605","16","20210714115055","Shop","AAA03","12","204000","36000","168000","2021-07-14 11:50:55"
"606","18","20210714112211","PC","AAA03","7","119000","21000","98000","2021-07-14 11:22:11"
"607","21","20210714104839","Shop","AAA05","4","240000","80000","160000","2021-07-14 10:48:39"
"608","22","20210713112742","Mobile","AAA05","2","120000","40000","80000","2021-07-13 23:27:42"
"609","44","20210713041136","Mobile","AAA02","1","15000","2300","12700","2021-07-13 16:11:36"
"610","67","20210713023620","Mobile","AAA04","19","152000","7600","144400","2021-07-13 14:36:20"
"611","67","20210713010923","PC","AAA01","7","70000","14000","56000","2021-07-13 13:09:23"
"612","54","20210713113540","PC","AAA05","8","480000","160000","320000","2021-07-13 11:35:40"
"613","64","20210713102852","PC","AAA01","3","30000","6000","24000","2021-07-13 10:28:52"
"614","80","20210713095810","Shop","AAA03","7","119000","21000","98000","2021-07-13 09:58:10"
"615","24","20210713084349","PC","AAA05","8","480000","160000","320000","2021-07-13 08:43:49"
"616","77","20210713074331","PC","AAA01","2","20000","4000","16000","2021-07-13 07:43:31"
"617","68","20210712072551","Mobile","AAA03","1","17000","3000","14000","2021-07-12 19:25:51"
"618","94","20210712045139","Mobile","AAA05","21","1260000","420000","840000","2021-07-12 16:51:39"
"619","38","20210712041049","PC","AAA02","8","120000","18400","101600","2021-07-12 16:10:49"
"620","1","20210712030455","Shop","AAA04","14","112000","5600","106400","2021-07-12 15:04:55"
"621","89","20210712010344","Mobile","AAA05","26","1560000","520000","1040000","2021-07-12 13:03:44"
"622","9","20210712120000","PC","AAA03","1","17000","3000","14000","2021-07-12 12:00:00"
"623","95","20210712093430","Mobile","AAA01","8","80000","16000","64000","2021-07-12 09:34:30"
"624","46","20210709043018","PC","AAA04","1","8000","400","7600","2021-07-09 16:30:18"
"625","52","20210709024853","Shop","AAA01","3","30000","6000","24000","2021-07-09 14:48:53"
"626","42","20210709123541","PC","AAA03","21","357000","63000","294000","2021-07-09 12:35:41"
"627","12","20210709111621","PC","AAA03","7","119000","21000","98000","2021-07-09 11:16:21"
"628","39","20210709102521","Mobile","AAA03","11","187000","33000","154000","2021-07-09 10:25:21"
"629","47","20210709090239","Shop","AAA01","7","70000","14000","56000","2021-07-09 09:02:39"
"630","3","20210709075619","Shop","AAA04","15","120000","6000","114000","2021-07-09 07:56:19"
"631","98","20210709025011","Shop","AAA05","6","360000","120000","240000","2021-07-09 02:50:11"
"632","18","20210708044444","Mobile","AAA03","4","68000","12000","56000","2021-07-08 16:44:44"
"633","40","20210708033924","Shop","AAA02","7","105000","16100","88900","2021-07-08 15:39:24"
"634","89","20210708024704","Mobile","AAA04","23","184000","9200","174800","2021-07-08 14:47:04"
"635","70","20210708032010","PC","AAA02","7","105000","16100","88900","2021-07-08 15:20:10"
"636","27","20210708031642","Mobile","AAA02","18","270000","41400","228600","2021-07-08 15:16:42"
"637","1","20210708123553","Mobile","AAA02","13","195000","29900","165100","2021-07-08 12:35:53"
"638","13","20210708114034","PC","AAA04","8","64000","3200","60800","2021-07-08 11:40:34"
"639","43","20210708105656","Shop","AAA02","18","270000","41400","228600","2021-07-08 10:56:56"
"640","57","20210708102431","Shop","AAA02","3","45000","6900","38100","2021-07-08 10:24:31"
"641","62","20210708093007","Mobile","AAA03","14","238000","42000","196000","2021-07-08 09:30:07"
"642","56","20210708082407","Shop","AAA02","13","195000","29900","165100","2021-07-08 08:24:07"
"643","5","20210708071100","Mobile","AAA03","14","238000","42000","196000","2021-07-08 07:11:00"
"644","9","20210707034815","Shop","AAA01","1","10000","2000","8000","2021-07-07 15:48:15"
"645","2","20210707015406","PC","AAA04","1","8000","400","7600","2021-07-07 13:54:06"
"646","11","20210707103947","PC","AAA01","14","140000","28000","112000","2021-07-07 10:39:47"
"647","30","20210707082332","Shop","AAA04","11","88000","4400","83600","2021-07-07 08:23:32"
"648","77","20210707065032","Mobile","AAA01","2","20000","4000","16000","2021-07-07 06:50:32"
"649","46","20210706094309","Mobile","AAA04","12","96000","4800","91200","2021-07-06 21:43:09"
"650","52","20210706024155","PC","AAA03","11","187000","33000","154000","2021-07-06 14:41:55"
"651","65","20210706014550","Mobile","AAA02","2","30000","4600","25400","2021-07-06 13:45:50"
"652","86","20210706123527","Shop","AAA04","5","40000","2000","38000","2021-07-06 12:35:27"
"653","84","20210706103439","Shop","AAA03","1","17000","3000","14000","2021-07-06 10:34:39"
"654","73","20210706091514","Mobile","AAA03","5","85000","15000","70000","2021-07-06 09:15:14"
"655","14","20210706082901","Mobile","AAA05","9","540000","180000","360000","2021-07-06 08:29:01"
"656","77","20210706072555","Shop","AAA01","2","20000","4000","16000","2021-07-06 07:25:55"
"657","17","20210705065312","Mobile","AAA03","8","136000","24000","112000","2021-07-05 18:53:12"
"658","53","20210705124427","Shop","AAA03","9","153000","27000","126000","2021-07-05 12:44:27"
"659","42","20210705114755","Shop","AAA04","1","8000","400","7600","2021-07-05 11:47:55"
"660","90","20210705104845","Shop","AAA03","5","85000","15000","70000","2021-07-05 10:48:45"
"661","97","20210701110801","PC","AAA04","5","40000","2000","38000","2021-07-01 11:08:01"
"662","71","20210701094322","PC","AAA03","10","170000","30000","140000","2021-07-01 09:43:22"
"663","3","20210701075100","PC","AAA05","23","1380000","460000","920000","2021-07-01 07:51:00"
"664","99","20210630063750","Mobile","AAA04","1","8000","400","7600","2021-06-30 18:37:50"
"665","16","20210630034111","Shop","AAA03","8","136000","24000","112000","2021-06-30 15:41:11"
"666","24","20210630024337","Mobile","AAA02","5","75000","11500","63500","2021-06-30 14:43:37"
"667","85","20210630023016","Mobile","AAA01","9","90000","18000","72000","2021-06-30 14:30:16"
"668","7","20210630114308","Shop","AAA03","1","17000","3000","14000","2021-06-30 11:43:08"
"669","61","20210630105604","Shop","AAA02","2","30000","4600","25400","2021-06-30 10:56:04"
"670","46","20210630100126","Mobile","AAA04","2","16000","800","15200","2021-06-30 10:01:26"
"671","84","20210630084918","Shop","AAA05","6","360000","120000","240000","2021-06-30 08:49:18"
"672","86","20210630081417","PC","AAA03","1","17000","3000","14000","2021-06-30 08:14:17"
"673","17","20210630080010","Shop","AAA01","7","70000","14000","56000","2021-06-30 08:00:10"
"674","15","20210630073919","Mobile","AAA05","9","540000","180000","360000","2021-06-30 07:39:19"
"675","24","20210630014501","PC","AAA05","2","120000","40000","80000","2021-06-30 01:45:01"
"676","66","20210629110354","Mobile","AAA02","2","30000","4600","25400","2021-06-29 23:03:54"
"677","44","20210629024930","PC","AAA03","8","136000","24000","112000","2021-06-29 14:49:30"
"678","13","20210629021253","Shop","AAA05","2","120000","40000","80000","2021-06-29 14:12:53"
"679","43","20210629012201","PC","AAA05","4","240000","80000","160000","2021-06-29 13:22:01"
"680","1","20210629122551","Shop","AAA02","9","135000","20700","114300","2021-06-29 12:25:51"
"681","27","20210629104851","Mobile","AAA02","16","240000","36800","203200","2021-06-29 10:48:51"
"682","77","20210629093630","Shop","AAA05","7","420000","140000","280000","2021-06-29 09:36:30"
"683","82","20210629082736","Shop","AAA03","9","153000","27000","126000","2021-06-29 08:27:36"
"684","61","20210628051612","Mobile","AAA02","7","105000","16100","88900","2021-06-28 17:16:12"
"685","59","20210628041315","Shop","AAA05","4","240000","80000","160000","2021-06-28 16:13:15"
"686","74","20210628033546","PC","AAA03","3","51000","9000","42000","2021-06-28 15:35:46"
"687","21","20210628024650","Shop","AAA04","23","184000","9200","174800","2021-06-28 14:46:50"
"688","49","20210628023024","PC","AAA05","12","720000","240000","480000","2021-06-28 14:30:24"
"689","84","20210628014650","PC","AAA03","4","68000","12000","56000","2021-06-28 13:46:50"
"690","66","20210628120231","Shop","AAA01","13","130000","26000","104000","2021-06-28 12:02:31"
"691","71","20210628105158","PC","AAA04","1","8000","400","7600","2021-06-28 10:51:58"
"692","47","20210628103602","Shop","AAA05","10","600000","200000","400000","2021-06-28 10:36:02"
"693","68","20210625063047","PC","AAA05","5","300000","100000","200000","2021-06-25 06:30:47"
"694","32","20210624100433","PC","AAA01","13","130000","26000","104000","2021-06-24 22:04:33"
"695","36","20210624061638","Mobile","AAA02","8","120000","18400","101600","2021-06-24 18:16:38"
"696","43","20210624033528","Mobile","AAA04","6","48000","2400","45600","2021-06-24 15:35:28"
"697","64","20210624022216","Shop","AAA04","9","72000","3600","68400","2021-06-24 14:22:16"
"698","1","20210624012557","Shop","AAA05","11","660000","220000","440000","2021-06-24 13:25:57"
"699","20","20210624120452","PC","AAA03","4","68000","12000","56000","2021-06-24 12:04:52"
"700","46","20210624104751","Mobile","AAA03","5","85000","15000","70000","2021-06-24 10:47:51"
"701","19","20210624083028","Mobile","AAA02","4","60000","9200","50800","2021-06-24 08:30:28"
"702","12","20210624070517","Shop","AAA01","7","70000","14000","56000","2021-06-24 07:05:17"
"703","8","20210623085413","Shop","AAA04","4","32000","1600","30400","2021-06-23 20:54:13"
"704","81","20210623051544","Mobile","AAA03","1","17000","3000","14000","2021-06-23 17:15:44"
"705","70","20210623041325","Shop","AAA03","19","323000","57000","266000","2021-06-23 16:13:25"
"706","100","20210623021857","PC","AAA02","6","90000","13800","76200","2021-06-23 14:18:57"
"707","40","20210623012416","Mobile","AAA01","2","20000","4000","16000","2021-06-23 13:24:16"
"708","50","20210623122521","Shop","AAA01","17","170000","34000","136000","2021-06-23 12:25:21"
"709","89","20210623114114","Shop","AAA05","25","1500000","500000","1000000","2021-06-23 11:41:14"
"710","9","20210623105220","Mobile","AAA01","3","30000","6000","24000","2021-06-23 10:52:20"
"711","99","20210623094915","Mobile","AAA02","5","75000","11500","63500","2021-06-23 09:49:15"
"712","38","20210623092651","PC","AAA01","6","60000","12000","48000","2021-06-23 09:26:51"
"713","7","20210623080940","Shop","AAA04","10","80000","4000","76000","2021-06-23 08:09:40"
"714","1","20210623073112","Shop","AAA02","6","90000","13800","76200","2021-06-23 07:31:12"
"715","60","20210622023837","PC","AAA03","11","187000","33000","154000","2021-06-22 14:38:37"
"716","98","20210622012500","Mobile","AAA01","9","90000","18000","72000","2021-06-22 13:25:00"
"717","51","20210622123912","PC","AAA05","10","600000","200000","400000","2021-06-22 12:39:12"
"718","45","20210622115010","Mobile","AAA03","8","136000","24000","112000","2021-06-22 11:50:10"
"719","81","20210622101744","PC","AAA03","1","17000","3000","14000","2021-06-22 10:17:44"
"720","61","20210622085150","PC","AAA01","5","50000","10000","40000","2021-06-22 08:51:50"
"721","74","20210622073604","Shop","AAA05","15","900000","300000","600000","2021-06-22 07:36:04"
"722","77","20210621070731","Mobile","AAA05","7","420000","140000","280000","2021-06-21 19:07:31"
"723","25","20210621025528","Shop","AAA01","6","60000","12000","48000","2021-06-21 14:55:28"
"724","89","20210621022941","PC","AAA02","5","75000","11500","63500","2021-06-21 14:29:41"
"725","7","20210621015812","PC","AAA04","8","64000","3200","60800","2021-06-21 13:58:12"
"726","23","20210621123133","Mobile","AAA04","4","32000","1600","30400","2021-06-21 12:31:33"
"727","70","20210621111903","Shop","AAA04","4","32000","1600","30400","2021-06-21 11:19:03"
"728","4","20210621083837","Shop","AAA04","5","40000","2000","38000","2021-06-21 08:38:37"
"729","47","20210619013740","Mobile","AAA05","9","540000","180000","360000","2021-06-19 01:37:40"
"730","78","20210618085352","Mobile","AAA05","14","840000","280000","560000","2021-06-18 08:53:52"
"731","2","20210618074831","Shop","AAA04","5","40000","2000","38000","2021-06-18 07:48:31"
"732","49","20210617115810","PC","AAA03","5","85000","15000","70000","2021-06-17 23:58:10"
"733","80","20210617015324","PC","AAA03","1","17000","3000","14000","2021-06-17 13:53:24"
"734","59","20210617122245","Shop","AAA05","6","360000","120000","240000","2021-06-17 12:22:45"
"735","74","20210617112445","PC","AAA05","3","180000","60000","120000","2021-06-17 11:24:45"
"736","80","20210617100956","Shop","AAA04","3","24000","1200","22800","2021-06-17 10:09:56"
"737","6","20210617093143","PC","AAA02","1","15000","2300","12700","2021-06-17 09:31:43"
"738","16","20210617085059","Shop","AAA04","12","96000","4800","91200","2021-06-17 08:50:59"
"739","48","20210617080309","Mobile","AAA03","6","102000","18000","84000","2021-06-17 08:03:09"
"740","99","20210617072722","Shop","AAA02","7","105000","16100","88900","2021-06-17 07:27:22"
"741","42","20210616095611","PC","AAA02","5","75000","11500","63500","2021-06-16 21:56:11"
"742","73","20210616063437","Shop","AAA02","17","255000","39100","215900","2021-06-16 18:34:37"
"743","84","20210616022157","Shop","AAA01","1","10000","2000","8000","2021-06-16 14:21:57"
"744","32","20210616015143","Shop","AAA03","25","425000","75000","350000","2021-06-16 13:51:43"
"745","28","20210616112845","Shop","AAA05","12","720000","240000","480000","2021-06-16 11:28:45"
"746","52","20210616103236","Shop","AAA04","2","16000","800","15200","2021-06-16 10:32:36"
"747","96","20210616092721","Shop","AAA03","7","119000","21000","98000","2021-06-16 09:27:21"
"748","17","20210616082650","PC","AAA03","1","17000","3000","14000","2021-06-16 08:26:50"
"749","100","20210616072327","Mobile","AAA03","4","68000","12000","56000","2021-06-16 07:23:27"
"750","90","20210615065833","Mobile","AAA05","5","300000","100000","200000","2021-06-15 18:58:33"
"751","27","20210615022715","Shop","AAA02","29","435000","66700","368300","2021-06-15 14:27:15"
"752","88","20210615011313","Shop","AAA03","2","34000","6000","28000","2021-06-15 13:13:13"
"753","66","20210615114623","Shop","AAA05","10","600000","200000","400000","2021-06-15 11:46:23"
"754","37","20210615103156","PC","AAA03","19","323000","57000","266000","2021-06-15 10:31:56"
"755","93","20210615093125","Mobile","AAA04","3","24000","1200","22800","2021-06-15 09:31:25"
"756","46","20210615091642","PC","AAA03","3","51000","9000","42000","2021-06-15 09:16:42"
"757","16","20210615063714","Mobile","AAA02","10","150000","23000","127000","2021-06-15 06:37:14"
"758","8","20210614043318","Mobile","AAA02","6","90000","13800","76200","2021-06-14 16:33:18"
"759","11","20210614034123","Shop","AAA04","16","128000","6400","121600","2021-06-14 15:41:23"
"760","87","20210614023624","Shop","AAA05","3","180000","60000","120000","2021-06-14 14:36:24"
"761","58","20210614011306","PC","AAA01","2","20000","4000","16000","2021-06-14 13:13:06"
"762","64","20210614123542","Mobile","AAA02","1","15000","2300","12700","2021-06-14 12:35:42"
"763","94","20210614113545","Shop","AAA01","6","60000","12000","48000","2021-06-14 11:35:45"
"764","52","20210614101344","PC","AAA05","1","60000","20000","40000","2021-06-14 10:13:44"
"765","33","20210614090825","Shop","AAA01","5","50000","10000","40000","2021-06-14 09:08:25"
"766","30","20210611122435","Mobile","AAA02","7","105000","16100","88900","2021-06-11 12:24:35"
"767","49","20210611110913","Mobile","AAA03","2","34000","6000","28000","2021-06-11 11:09:13"
"768","63","20210611094123","PC","AAA05","6","360000","120000","240000","2021-06-11 09:41:23"
"769","21","20210611084019","PC","AAA02","11","165000","25300","139700","2021-06-11 08:40:19"
"770","83","20210610010410","Mobile","AAA02","16","240000","36800","203200","2021-06-10 13:04:10"
"771","50","20210610115343","Shop","AAA02","13","195000","29900","165100","2021-06-10 11:53:43"
"772","47","20210610110617","PC","AAA03","10","170000","30000","140000","2021-06-10 11:06:17"
"773","89","20210610101403","Mobile","AAA03","9","153000","27000","126000","2021-06-10 10:14:03"
"774","17","20210610093950","Shop","AAA04","4","32000","1600","30400","2021-06-10 09:39:50"
"775","60","20210610084616","PC","AAA01","12","120000","24000","96000","2021-06-10 08:46:16"
"776","55","20210610071052","PC","AAA05","4","240000","80000","160000","2021-06-10 07:10:52"
"777","43","20210609104732","PC","AAA04","9","72000","3600","68400","2021-06-09 22:47:32"
"778","36","20210609085034","PC","AAA01","11","110000","22000","88000","2021-06-09 20:50:34"
"779","49","20210609060424","Shop","AAA03","9","153000","27000","126000","2021-06-09 18:04:24"
"780","31","20210609040058","PC","AAA03","8","136000","24000","112000","2021-06-09 16:00:58"
"781","95","20210609033559","Mobile","AAA02","8","120000","18400","101600","2021-06-09 15:35:59"
"782","91","20210609013541","Mobile","AAA01","6","60000","12000","48000","2021-06-09 13:35:41"
"783","99","20210609121153","Shop","AAA04","7","56000","2800","53200","2021-06-09 12:11:53"
"784","54","20210609110242","Mobile","AAA04","13","104000","5200","98800","2021-06-09 11:02:42"
"785","8","20210609081708","Mobile","AAA05","16","960000","320000","640000","2021-06-09 08:17:08"
"786","32","20210609064505","PC","AAA04","7","56000","2800","53200","2021-06-09 06:45:05"
"787","75","20210608084639","Mobile","AAA05","7","420000","140000","280000","2021-06-08 20:46:39"
"788","18","20210608063734","Shop","AAA03","5","85000","15000","70000","2021-06-08 18:37:34"
"789","83","20210608051037","Shop","AAA01","19","190000","38000","152000","2021-06-08 17:10:37"
"790","79","20210608040954","Shop","AAA05","4","240000","80000","160000","2021-06-08 16:09:54"
"791","36","20210608031442","Mobile","AAA02","9","135000","20700","114300","2021-06-08 15:14:42"
"792","58","20210608014735","PC","AAA02","4","60000","9200","50800","2021-06-08 13:47:35"
"793","4","20210608113309","Shop","AAA03","5","85000","15000","70000","2021-06-08 11:33:09"
"794","95","20210608102250","Mobile","AAA01","3","30000","6000","24000","2021-06-08 10:22:50"
"795","44","20210608092132","Mobile","AAA02","6","90000","13800","76200","2021-06-08 09:21:32"
"796","9","20210608080431","PC","AAA01","2","20000","4000","16000","2021-06-08 08:04:31"
"797","97","20210608065558","PC","AAA05","8","480000","160000","320000","2021-06-08 06:55:58"
"798","83","20210607023244","Mobile","AAA02","7","105000","16100","88900","2021-06-07 14:32:44"
"799","77","20210607124950","Mobile","AAA04","3","24000","1200","22800","2021-06-07 12:49:50"
"800","56","20210607114004","PC","AAA05","10","600000","200000","400000","2021-06-07 11:40:04"
"801","55","20210607104559","Mobile","AAA03","14","238000","42000","196000","2021-06-07 10:45:59"
"802","6","20210607102411","Shop","AAA01","8","80000","16000","64000","2021-06-07 10:24:11"
"803","40","20210607092742","PC","AAA02","1","15000","2300","12700","2021-06-07 09:27:42"
"804","94","20210604035401","PC","AAA03","26","442000","78000","364000","2021-06-04 15:54:01"
"805","69","20210604022038","Shop","AAA04","5","40000","2000","38000","2021-06-04 14:20:38"
"806","89","20210604115722","Mobile","AAA04","10","80000","4000","76000","2021-06-04 11:57:22"
"807","38","20210604103344","Mobile","AAA03","1","17000","3000","14000","2021-06-04 10:33:44"
"808","86","20210604094106","Shop","AAA02","8","120000","18400","101600","2021-06-04 09:41:06"
"809","68","20210604080838","PC","AAA02","8","120000","18400","101600","2021-06-04 08:08:38"
"810","48","20210604011934","Shop","AAA03","6","102000","18000","84000","2021-06-04 01:19:34"
"811","85","20210603033514","Mobile","AAA03","3","51000","9000","42000","2021-06-03 15:35:14"
"812","19","20210603021908","Mobile","AAA04","8","64000","3200","60800","2021-06-03 14:19:08"
"813","98","20210603125728","Shop","AAA02","10","150000","23000","127000","2021-06-03 12:57:28"
"814","73","20210603113826","Mobile","AAA01","13","130000","26000","104000","2021-06-03 11:38:26"
"815","60","20210603105636","Shop","AAA03","4","68000","12000","56000","2021-06-03 10:56:36"
"816","21","20210603101517","PC","AAA02","5","75000","11500","63500","2021-06-03 10:15:17"
"817","85","20210603091130","Shop","AAA01","1","10000","2000","8000","2021-06-03 09:11:30"
"818","55","20210603073703","Shop","AAA01","8","80000","16000","64000","2021-06-03 07:37:03"
"819","91","20210602112453","PC","AAA02","8","120000","18400","101600","2021-06-02 23:24:53"
"820","63","20210602090119","PC","AAA01","5","50000","10000","40000","2021-06-02 21:01:19"
"821","17","20210602053745","Mobile","AAA02","3","45000","6900","38100","2021-06-02 17:37:45"
"822","27","20210602032814","PC","AAA02","11","165000","25300","139700","2021-06-02 15:28:14"
"823","34","20210602021819","PC","AAA05","24","1440000","480000","960000","2021-06-02 14:18:19"
"824","22","20210602012829","Shop","AAA04","10","80000","4000","76000","2021-06-02 13:28:29"
"825","88","20210602120422","Shop","AAA02","10","150000","23000","127000","2021-06-02 12:04:22"
"826","82","20210602104017","Mobile","AAA01","13","130000","26000","104000","2021-06-02 10:40:17"
"827","54","20210602091139","Mobile","AAA03","12","204000","36000","168000","2021-06-02 09:11:39"
"828","61","20210602075820","Shop","AAA01","6","60000","12000","48000","2021-06-02 07:58:20"
"829","31","20210601114533","Shop","AAA02","17","255000","39100","215900","2021-06-01 23:45:33"
"830","83","20210601010353","Mobile","AAA03","17","289000","51000","238000","2021-06-01 13:03:53"
"831","5","20210601121245","PC","AAA04","20","160000","8000","152000","2021-06-01 12:12:45"
"832","66","20210601102225","Mobile","AAA05","3","180000","60000","120000","2021-06-01 10:22:25"
"833","73","20210601075431","Shop","AAA05","9","540000","180000","360000","2021-06-01 07:54:31"
"834","33","20210531034638","PC","AAA04","6","48000","2400","45600","2021-05-31 15:46:38"
"835","83","20210531030501","Mobile","AAA02","21","315000","48300","266700","2021-05-31 15:05:01"
"836","59","20210531015710","Shop","AAA04","2","16000","800","15200","2021-05-31 13:57:10"
"837","48","20210531010749","PC","AAA05","7","420000","140000","280000","2021-05-31 13:07:49"
"838","6","20210531091123","Shop","AAA05","10","600000","200000","400000","2021-05-31 09:11:23"
"839","94","20210529023600","PC","AAA05","12","720000","240000","480000","2021-05-29 14:36:00"
"840","19","20210528045844","Mobile","AAA02","4","60000","9200","50800","2021-05-28 04:58:44"
"841","47","20210527085450","Shop","AAA03","8","136000","24000","112000","2021-05-27 20:54:50"
"842","94","20210527062213","PC","AAA03","6","102000","18000","84000","2021-05-27 18:22:13"
"843","97","20210527025712","Shop","AAA05","2","120000","40000","80000","2021-05-27 14:57:12"
"844","2","20210527015000","PC","AAA03","10","170000","30000","140000","2021-05-27 13:50:00"
"845","53","20210527011919","Mobile","AAA02","9","135000","20700","114300","2021-05-27 13:19:19"
"846","79","20210527123339","PC","AAA02","9","135000","20700","114300","2021-05-27 12:33:39"
"847","57","20210527102031","Shop","AAA04","6","48000","2400","45600","2021-05-27 10:20:31"
"848","88","20210527073608","Shop","AAA03","6","102000","18000","84000","2021-05-27 07:36:08"
"849","5","20210526094208","Shop","AAA04","4","32000","1600","30400","2021-05-26 21:42:08"
"850","7","20210526054344","PC","AAA03","9","153000","27000","126000","2021-05-26 17:43:44"
"851","69","20210526051418","Shop","AAA01","2","20000","4000","16000","2021-05-26 17:14:18"
"852","17","20210526042020","PC","AAA03","10","170000","30000","140000","2021-05-26 16:20:20"
"853","34","20210526032211","Shop","AAA02","11","165000","25300","139700","2021-05-26 15:22:11"
"854","51","20210526014304","PC","AAA05","14","840000","280000","560000","2021-05-26 13:43:04"
"855","74","20210526122952","PC","AAA01","7","70000","14000","56000","2021-05-26 12:29:52"
"856","37","20210526113310","PC","AAA03","11","187000","33000","154000","2021-05-26 11:33:10"
"857","38","20210526102041","PC","AAA05","5","300000","100000","200000","2021-05-26 10:20:41"
"858","91","20210526092955","Mobile","AAA02","5","75000","11500","63500","2021-05-26 09:29:55"
"859","94","20210526080016","Shop","AAA01","4","40000","8000","32000","2021-05-26 08:00:16"
"860","71","20210526064246","PC","AAA02","6","90000","13800","76200","2021-05-26 06:42:46"
"861","44","20210525091251","Shop","AAA02","2","30000","4600","25400","2021-05-25 21:12:51"
"862","66","20210525065641","Mobile","AAA04","3","24000","1200","22800","2021-05-25 18:56:41"
"863","60","20210525034939","Mobile","AAA02","5","75000","11500","63500","2021-05-25 15:49:39"
"864","40","20210525030057","Shop","AAA04","7","56000","2800","53200","2021-05-25 15:00:57"
"865","7","20210525014717","Mobile","AAA03","5","85000","15000","70000","2021-05-25 13:47:17"
"866","71","20210525113921","Shop","AAA02","17","255000","39100","215900","2021-05-25 11:39:21"
"867","83","20210525093155","Mobile","AAA01","8","80000","16000","64000","2021-05-25 09:31:55"
"868","22","20210525082729","Shop","AAA03","5","85000","15000","70000","2021-05-25 08:27:29"
"869","84","20210525072849","PC","AAA05","1","60000","20000","40000","2021-05-25 07:28:49"
"870","83","20210524124912","Mobile","AAA04","17","136000","6800","129200","2021-05-24 12:49:12"
"871","61","20210524120122","Mobile","AAA01","7","70000","14000","56000","2021-05-24 12:01:22"
"872","47","20210524101124","Shop","AAA01","6","60000","12000","48000","2021-05-24 10:11:24"
"873","30","20210524082601","Shop","AAA04","10","80000","4000","76000","2021-05-24 08:26:01"
"874","34","20210521083233","Mobile","AAA02","4","60000","9200","50800","2021-05-21 08:32:33"
"875","6","20210521071356","PC","AAA04","3","24000","1200","22800","2021-05-21 07:13:56"
"876","80","20210520111408","Mobile","AAA02","6","90000","13800","76200","2021-05-20 23:14:08"
"877","9","20210520060414","Mobile","AAA03","4","68000","12000","56000","2021-05-20 18:04:14"
"878","31","20210520030727","PC","AAA01","10","100000","20000","80000","2021-05-20 15:07:27"
"879","27","20210520025804","Mobile","AAA01","4","40000","8000","32000","2021-05-20 14:58:04"
"880","97","20210520014128","Shop","AAA04","1","8000","400","7600","2021-05-20 13:41:28"
"881","73","20210520123926","Shop","AAA02","1","15000","2300","12700","2021-05-20 12:39:26"
"882","15","20210520114543","Shop","AAA01","2","20000","4000","16000","2021-05-20 11:45:43"
"883","54","20210520095727","Mobile","AAA03","2","34000","6000","28000","2021-05-20 09:57:27"
"884","52","20210520091231","Mobile","AAA02","2","30000","4600","25400","2021-05-20 09:12:31"
"885","85","20210520081458","Shop","AAA03","6","102000","18000","84000","2021-05-20 08:14:58"
"886","56","20210520062704","Shop","AAA05","15","900000","300000","600000","2021-05-20 06:27:04"
"887","87","20210519060028","PC","AAA02","5","75000","11500","63500","2021-05-19 18:00:28"
"888","31","20210519015613","Mobile","AAA02","9","135000","20700","114300","2021-05-19 13:56:13"
"889","61","20210519124809","Shop","AAA02","1","15000","2300","12700","2021-05-19 12:48:09"
"890","79","20210519113356","Shop","AAA04","11","88000","4400","83600","2021-05-19 11:33:56"
"891","10","20210519102450","PC","AAA03","9","153000","27000","126000","2021-05-19 10:24:50"
"892","16","20210519090740","Shop","AAA03","2","34000","6000","28000","2021-05-19 09:07:40"
"893","54","20210519080825","PC","AAA01","3","30000","6000","24000","2021-05-19 08:08:25"
"894","13","20210519073022","Shop","AAA04","5","40000","2000","38000","2021-05-19 07:30:22"
"895","19","20210518085256","Mobile","AAA04","5","40000","2000","38000","2021-05-18 20:52:56"
"896","95","20210518061702","Mobile","AAA04","3","24000","1200","22800","2021-05-18 18:17:02"
"897","16","20210518041456","Mobile","AAA03","9","153000","27000","126000","2021-05-18 16:14:56"
"898","99","20210518024721","Mobile","AAA02","5","75000","11500","63500","2021-05-18 14:47:21"
"899","35","20210518015821","PC","AAA04","4","32000","1600","30400","2021-05-18 13:58:21"
"900","22","20210518011111","Mobile","AAA02","12","180000","27600","152400","2021-05-18 13:11:11"
"901","1","20210518103912","Mobile","AAA02","11","165000","25300","139700","2021-05-18 10:39:12"
"902","4","20210518085122","Shop","AAA01","1","10000","2000","8000","2021-05-18 08:51:22"
"903","28","20210518080811","Mobile","AAA05","10","600000","200000","400000","2021-05-18 08:08:11"
"904","13","20210518070413","PC","AAA03","2","34000","6000","28000","2021-05-18 07:04:13"
"905","80","20210517092551","Mobile","AAA03","3","51000","9000","42000","2021-05-17 21:25:51"
"906","95","20210517033050","Mobile","AAA04","4","32000","1600","30400","2021-05-17 15:30:50"
"907","13","20210517024429","PC","AAA04","7","56000","2800","53200","2021-05-17 14:44:29"
"908","88","20210517013216","Mobile","AAA01","5","50000","10000","40000","2021-05-17 13:32:16"
"909","9","20210517121616","PC","AAA04","3","24000","1200","22800","2021-05-17 12:16:16"
"910","86","20210517111613","Shop","AAA04","3","24000","1200","22800","2021-05-17 11:16:13"
"911","36","20210517100504","Shop","AAA04","8","64000","3200","60800","2021-05-17 10:05:04"
"912","33","20210517084826","PC","AAA03","2","34000","6000","28000","2021-05-17 08:48:26"
"913","1","20210513045311","Shop","AAA03","10","170000","30000","140000","2021-05-13 16:53:11"
"914","65","20210513042724","PC","AAA01","22","220000","44000","176000","2021-05-13 16:27:24"
"915","57","20210513032535","PC","AAA04","6","48000","2400","45600","2021-05-13 15:25:35"
"916","100","20210513022306","PC","AAA04","2","16000","800","15200","2021-05-13 14:23:06"
"917","59","20210513013658","PC","AAA04","9","72000","3600","68400","2021-05-13 13:36:58"
"918","32","20210513125345","PC","AAA05","23","1380000","460000","920000","2021-05-13 12:53:45"
"919","5","20210513114136","Shop","AAA03","5","85000","15000","70000","2021-05-13 11:41:36"
"920","22","20210513105500","PC","AAA04","17","136000","6800","129200","2021-05-13 10:55:00"
"921","26","20210513095936","Shop","AAA03","6","102000","18000","84000","2021-05-13 09:59:36"
"922","25","20210513084951","Shop","AAA04","7","56000","2800","53200","2021-05-13 08:49:51"
"923","47","20210513074751","PC","AAA02","13","195000","29900","165100","2021-05-13 07:47:51"
"924","86","20210513012745","Shop","AAA03","6","102000","18000","84000","2021-05-13 01:27:45"
"925","41","20210512043903","Mobile","AAA04","6","48000","2400","45600","2021-05-12 16:39:03"
"926","1","20210512042009","PC","AAA01","6","60000","12000","48000","2021-05-12 16:20:09"
"927","88","20210512020224","PC","AAA05","1","60000","20000","40000","2021-05-12 14:02:24"
"928","76","20210512124902","PC","AAA02","5","75000","11500","63500","2021-05-12 12:49:02"
"929","68","20210512113137","Mobile","AAA04","7","56000","2800","53200","2021-05-12 11:31:37"
"930","12","20210512102117","Mobile","AAA03","1","17000","3000","14000","2021-05-12 10:21:17"
"931","76","20210512091307","PC","AAA03","6","102000","18000","84000","2021-05-12 09:13:07"
"932","20","20210512084534","Shop","AAA01","12","120000","24000","96000","2021-05-12 08:45:34"
"933","17","20210512073742","Mobile","AAA02","11","165000","25300","139700","2021-05-12 07:37:42"
"934","30","20210512123633","Shop","AAA02","11","165000","25300","139700","2021-05-12 00:36:33"
"935","63","20210511023213","PC","AAA04","4","32000","1600","30400","2021-05-11 14:32:13"
"936","2","20210511111117","PC","AAA03","1","17000","3000","14000","2021-05-11 11:11:17"
"937","41","20210511102024","Shop","AAA04","6","48000","2400","45600","2021-05-11 10:20:24"
"938","78","20210511094742","Shop","AAA02","3","45000","6900","38100","2021-05-11 09:47:42"
"939","72","20210511085231","Mobile","AAA01","7","70000","14000","56000","2021-05-11 08:52:31"
"940","38","20210511080615","Shop","AAA02","17","255000","39100","215900","2021-05-11 08:06:15"
"941","43","20210511061516","PC","AAA04","9","72000","3600","68400","2021-05-11 06:15:16"
"942","16","20210510045638","Shop","AAA05","15","900000","300000","600000","2021-05-10 16:56:38"
"943","60","20210510040434","Mobile","AAA03","1","17000","3000","14000","2021-05-10 16:04:34"
"944","16","20210510030207","Mobile","AAA05","1","60000","20000","40000","2021-05-10 15:02:07"
"945","35","20210510021304","PC","AAA03","5","85000","15000","70000","2021-05-10 14:13:04"
"946","92","20210510013627","Mobile","AAA02","4","60000","9200","50800","2021-05-10 13:36:27"
"947","54","20210510114905","PC","AAA05","7","420000","140000","280000","2021-05-10 11:49:05"
"948","67","20210510104534","PC","AAA03","15","255000","45000","210000","2021-05-10 10:45:34"
"949","55","20210510085422","PC","AAA01","10","100000","20000","80000","2021-05-10 08:54:22"
"950","4","20210506015704","Shop","AAA01","9","90000","18000","72000","2021-05-06 13:57:04"
"951","35","20210506011738","Mobile","AAA05","8","480000","160000","320000","2021-05-06 13:17:38"
"952","24","20210506115529","PC","AAA02","7","105000","16100","88900","2021-05-06 11:55:29"
"953","14","20210506103912","PC","AAA04","5","40000","2000","38000","2021-05-06 10:39:12"
"954","50","20210506100352","Mobile","AAA01","12","120000","24000","96000","2021-05-06 10:03:52"
"955","31","20210506092720","Shop","AAA05","8","480000","160000","320000","2021-05-06 09:27:20"
"956","53","20210506084747","PC","AAA05","7","420000","140000","280000","2021-05-06 08:47:47"
"957","97","20210506081551","Shop","AAA02","2","30000","4600","25400","2021-05-06 08:15:51"
"958","29","20210506064546","PC","AAA04","9","72000","3600","68400","2021-05-06 06:45:46"
"959","54","20210505024237","PC","AAA02","15","225000","34500","190500","2021-05-05 14:42:37"
"960","47","20210505020846","Shop","AAA05","4","240000","80000","160000","2021-05-05 14:08:46"
"961","33","20210505014205","PC","AAA01","2","20000","4000","16000","2021-05-05 13:42:05"
"962","45","20210505124456","Shop","AAA05","5","300000","100000","200000","2021-05-05 12:44:56"
"963","82","20210505113311","PC","AAA03","10","170000","30000","140000","2021-05-05 11:33:11"
"964","70","20210505102059","Shop","AAA01","9","90000","18000","72000","2021-05-05 10:20:59"
"965","39","20210505090012","Shop","AAA02","5","75000","11500","63500","2021-05-05 09:00:12"
"966","68","20210505073927","Mobile","AAA04","3","24000","1200","22800","2021-05-05 07:39:27"
"967","67","20210504094552","PC","AAA04","10","80000","4000","76000","2021-05-04 21:45:52"
"968","43","20210504060209","PC","AAA02","13","195000","29900","165100","2021-05-04 18:02:09"
"969","66","20210504025247","Mobile","AAA02","5","75000","11500","63500","2021-05-04 14:52:47"
"970","4","20210504020343","PC","AAA01","2","20000","4000","16000","2021-05-04 14:03:43"
"971","19","20210504010432","Shop","AAA05","4","240000","80000","160000","2021-05-04 13:04:32"
"972","99","20210504120221","PC","AAA01","2","20000","4000","16000","2021-05-04 12:02:21"
"973","16","20210504103257","Shop","AAA03","17","289000","51000","238000","2021-05-04 10:32:57"
"974","95","20210504080404","Shop","AAA04","5","40000","2000","38000","2021-05-04 08:04:04"
"975","40","20210503112158","Mobile","AAA05","2","120000","40000","80000","2021-05-03 23:21:58"
"976","11","20210503030813","Mobile","AAA04","19","152000","7600","144400","2021-05-03 15:08:13"
"977","54","20210503024645","PC","AAA02","6","90000","13800","76200","2021-05-03 14:46:45"
"978","72","20210503011747","Mobile","AAA01","9","90000","18000","72000","2021-05-03 13:17:47"
"979","95","20210503120417","PC","AAA03","1","17000","3000","14000","2021-05-03 12:04:17"
"980","46","20210503110536","Mobile","AAA03","14","238000","42000","196000","2021-05-03 11:05:36"
"981","11","20210503101405","Mobile","AAA01","9","90000","18000","72000","2021-05-03 10:14:05"
"982","38","20210503082840","Mobile","AAA01","10","100000","20000","80000","2021-05-03 08:28:40"
"983","39","20210501032215","Mobile","AAA03","7","119000","21000","98000","2021-05-01 15:22:15"
"984","45","20210501013352","Mobile","AAA03","1","17000","3000","14000","2021-05-01 01:33:52"
"985","3","20210430074345","PC","AAA03","6","102000","18000","84000","2021-04-30 07:43:45"
"986","36","20210430010825","PC","AAA04","11","88000","4400","83600","2021-04-30 01:08:25"
"987","57","20210429010208","PC","AAA01","14","140000","28000","112000","2021-04-29 13:02:08"
"988","43","20210429121706","Shop","AAA04","7","56000","2800","53200","2021-04-29 12:17:06"
"989","65","20210429120050","PC","AAA02","2","30000","4600","25400","2021-04-29 12:00:50"
"990","39","20210429104747","PC","AAA03","3","51000","9000","42000","2021-04-29 10:47:47"
"991","78","20210429095406","PC","AAA03","12","204000","36000","168000","2021-04-29 09:54:06"
"992","96","20210429083530","Shop","AAA02","17","255000","39100","215900","2021-04-29 08:35:30"
"993","12","20210429074144","PC","AAA03","2","34000","6000","28000","2021-04-29 07:41:44"
"994","44","20210428050855","Mobile","AAA05","10","600000","200000","400000","2021-04-28 17:08:55"
"995","30","20210428040931","PC","AAA01","12","120000","24000","96000","2021-04-28 16:09:31"
"996","47","20210428025407","PC","AAA02","17","255000","39100","215900","2021-04-28 14:54:07"
"997","70","20210428014436","PC","AAA03","20","340000","60000","280000","2021-04-28 13:44:36"
"998","56","20210428123843","Mobile","AAA05","16","960000","320000","640000","2021-04-28 12:38:43"
"999","74","20210428113106","Shop","AAA05","12","720000","240000","480000","2021-04-28 11:31:06"
"1000","43","20210428103852","PC","AAA04","4","32000","1600","30400","2021-04-28 10:38:52"
"1001","78","20210428093245","PC","AAA01","8","80000","16000","64000","2021-04-28 09:32:45"
"1002","52","20210428071325","Mobile","AAA01","2","20000","4000","16000","2021-04-28 07:13:25"
"1003","79","20210427084227","PC","AAA02","1","15000","2300","12700","2021-04-27 20:42:27"
"1004","26","20210427044547","PC","AAA02","1","15000","2300","12700","2021-04-27 16:45:47"
"1005","2","20210427033644","Shop","AAA04","3","24000","1200","22800","2021-04-27 15:36:44"
"1006","2","20210427023353","PC","AAA04","4","32000","1600","30400","2021-04-27 14:33:53"
"1007","37","20210427121529","PC","AAA03","13","221000","39000","182000","2021-04-27 12:15:29"
"1008","82","20210427112133","Shop","AAA05","2","120000","40000","80000","2021-04-27 11:21:33"
"1009","31","20210427100342","Mobile","AAA01","9","90000","18000","72000","2021-04-27 10:03:42"
"1010","33","20210427084823","Shop","AAA05","3","180000","60000","120000","2021-04-27 08:48:23"
"1011","16","20210427073840","Mobile","AAA02","37","555000","85100","469900","2021-04-27 07:38:40"
"1012","89","20210426051745","PC","AAA04","2","16000","800","15200","2021-04-26 17:17:45"
"1013","13","20210426041001","PC","AAA03","5","85000","15000","70000","2021-04-26 16:10:01"
"1014","41","20210426025220","Shop","AAA04","12","96000","4800","91200","2021-04-26 14:52:20"
"1015","31","20210426014510","PC","AAA03","9","153000","27000","126000","2021-04-26 13:45:10"
"1016","80","20210426121401","PC","AAA05","8","480000","160000","320000","2021-04-26 12:14:01"
"1017","12","20210426110923","Shop","AAA01","4","40000","8000","32000","2021-04-26 11:09:23"
"1018","1","20210426102013","Mobile","AAA04","4","32000","1600","30400","2021-04-26 10:20:13"
"1019","61","20210423025457","Mobile","AAA04","2","16000","800","15200","2021-04-23 02:54:57"
"1020","40","20210422042059","PC","AAA05","3","180000","60000","120000","2021-04-22 16:20:59"
"1021","15","20210422034626","Shop","AAA01","7","70000","14000","56000","2021-04-22 15:46:26"
"1022","6","20210422022425","Mobile","AAA03","6","102000","18000","84000","2021-04-22 14:24:25"
"1023","13","20210422012903","Shop","AAA05","11","660000","220000","440000","2021-04-22 13:29:03"
"1024","88","20210422110603","PC","AAA02","14","210000","32200","177800","2021-04-22 11:06:03"
"1025","20","20210422101601","Shop","AAA02","6","90000","13800","76200","2021-04-22 10:16:01"
"1026","17","20210422093333","Mobile","AAA01","6","60000","12000","48000","2021-04-22 09:33:33"
"1027","28","20210422083026","PC","AAA05","11","660000","220000","440000","2021-04-22 08:30:26"
"1028","74","20210421085844","PC","AAA05","2","120000","40000","80000","2021-04-21 20:58:44"
"1029","48","20210421072710","Mobile","AAA05","4","240000","80000","160000","2021-04-21 19:27:10"
"1030","97","20210421032857","Shop","AAA05","8","480000","160000","320000","2021-04-21 15:28:57"
"1031","20","20210421011222","Shop","AAA04","7","56000","2800","53200","2021-04-21 13:12:22"
"1032","81","20210421123853","PC","AAA04","5","40000","2000","38000","2021-04-21 12:38:53"
"1033","21","20210421103147","Shop","AAA01","5","50000","10000","40000","2021-04-21 10:31:47"
"1034","87","20210421092433","Shop","AAA05","7","420000","140000","280000","2021-04-21 09:24:33"
"1035","82","20210421075414","Mobile","AAA01","6","60000","12000","48000","2021-04-21 07:54:14"
"1036","23","20210421025937","PC","AAA03","1","17000","3000","14000","2021-04-21 02:59:37"
"1037","81","20210420044055","Mobile","AAA05","6","360000","120000","240000","2021-04-20 16:40:55"
"1038","93","20210420032202","Shop","AAA04","1","8000","400","7600","2021-04-20 15:22:02"
"1039","38","20210420020737","Mobile","AAA03","1","17000","3000","14000","2021-04-20 14:07:37"
"1040","30","20210420010639","PC","AAA01","5","50000","10000","40000","2021-04-20 13:06:39"
"1041","57","20210420120717","PC","AAA03","5","85000","15000","70000","2021-04-20 12:07:17"
"1042","64","20210420110920","PC","AAA03","2","34000","6000","28000","2021-04-20 11:09:20"
"1043","90","20210420101836","PC","AAA01","5","50000","10000","40000","2021-04-20 10:18:36"
"1044","33","20210420090159","PC","AAA03","1","17000","3000","14000","2021-04-20 09:01:59"
"1045","73","20210420072228","Shop","AAA05","2","120000","40000","80000","2021-04-20 07:22:28"
"1046","13","20210419083642","PC","AAA01","6","60000","12000","48000","2021-04-19 20:36:42"
"1047","41","20210419073334","PC","AAA01","1","10000","2000","8000","2021-04-19 19:33:34"
"1048","4","20210419054627","Mobile","AAA05","11","660000","220000","440000","2021-04-19 17:46:27"
"1049","21","20210419044920","Mobile","AAA01","17","170000","34000","136000","2021-04-19 16:49:20"
"1050","1","20210419034042","PC","AAA02","9","135000","20700","114300","2021-04-19 15:40:42"
"1051","32","20210419022311","PC","AAA02","12","180000","27600","152400","2021-04-19 14:23:11"
"1052","71","20210419011220","PC","AAA01","8","80000","16000","64000","2021-04-19 13:12:20"
"1053","34","20210419120935","Mobile","AAA05","6","360000","120000","240000","2021-04-19 12:09:35"
"1054","21","20210419095751","Mobile","AAA01","17","170000","34000","136000","2021-04-19 09:57:51"
"1055","46","20210417055614","PC","AAA04","11","88000","4400","83600","2021-04-17 05:56:14"
"1056","37","20210416093826","PC","AAA04","15","120000","6000","114000","2021-04-16 09:38:26"
"1057","7","20210416083302","Shop","AAA01","6","60000","12000","48000","2021-04-16 08:33:02"
"1058","59","20210416073520","Shop","AAA01","12","120000","24000","96000","2021-04-16 07:35:20"
"1059","12","20210415080006","PC","AAA05","4","240000","80000","160000","2021-04-15 20:00:06"
"1060","50","20210415030846","Shop","AAA02","4","60000","9200","50800","2021-04-15 15:08:46"
"1061","50","20210415022131","Mobile","AAA04","8","64000","3200","60800","2021-04-15 14:21:31"
"1062","45","20210415013301","PC","AAA01","1","10000","2000","8000","2021-04-15 13:33:01"
"1063","39","20210415114100","Mobile","AAA01","8","80000","16000","64000","2021-04-15 11:41:00"
"1064","98","20210415104950","PC","AAA01","1","10000","2000","8000","2021-04-15 10:49:50"
"1065","56","20210415092900","PC","AAA01","5","50000","10000","40000","2021-04-15 09:29:00"
"1066","52","20210415083007","Shop","AAA05","5","300000","100000","200000","2021-04-15 08:30:07"
"1067","46","20210415071954","Mobile","AAA03","4","68000","12000","56000","2021-04-15 07:19:54"
"1068","6","20210414085642","Shop","AAA04","8","64000","3200","60800","2021-04-14 20:56:42"
"1069","43","20210414072659","Mobile","AAA01","5","50000","10000","40000","2021-04-14 19:26:59"
"1070","18","20210414040102","PC","AAA04","3","24000","1200","22800","2021-04-14 16:01:02"
"1071","34","20210414024455","PC","AAA02","10","150000","23000","127000","2021-04-14 14:44:55"
"1072","35","20210414013533","Shop","AAA04","6","48000","2400","45600","2021-04-14 13:35:33"
"1073","62","20210414125648","Mobile","AAA04","7","56000","2800","53200","2021-04-14 12:56:48"
"1074","59","20210414103952","Shop","AAA05","3","180000","60000","120000","2021-04-14 10:39:52"
"1075","64","20210414091409","Mobile","AAA05","12","720000","240000","480000","2021-04-14 09:14:09"
"1076","79","20210414074758","Mobile","AAA02","7","105000","16100","88900","2021-04-14 07:47:58"
"1077","3","20210413080359","Shop","AAA01","15","150000","30000","120000","2021-04-13 20:03:59"
"1078","63","20210413042831","Mobile","AAA04","3","24000","1200","22800","2021-04-13 16:28:31"
"1079","46","20210413024058","PC","AAA04","10","80000","4000","76000","2021-04-13 14:40:58"
"1080","27","20210413021215","Mobile","AAA04","16","128000","6400","121600","2021-04-13 14:12:15"
"1081","23","20210413012302","Mobile","AAA04","12","96000","4800","91200","2021-04-13 13:23:02"
"1082","16","20210413120140","PC","AAA02","6","90000","13800","76200","2021-04-13 12:01:40"
"1083","43","20210413100022","Shop","AAA04","5","40000","2000","38000","2021-04-13 10:00:22"
"1084","87","20210413081707","Mobile","AAA05","1","60000","20000","40000","2021-04-13 08:17:07"
"1085","6","20210413072144","Mobile","AAA02","1","15000","2300","12700","2021-04-13 07:21:44"
"1086","10","20210412062100","Shop","AAA02","14","210000","32200","177800","2021-04-12 18:21:00"
"1087","25","20210412032354","Mobile","AAA01","5","50000","10000","40000","2021-04-12 15:23:54"
"1088","3","20210412023546","PC","AAA05","26","1560000","520000","1040000","2021-04-12 14:35:46"
"1089","51","20210412120019","Mobile","AAA01","6","60000","12000","48000","2021-04-12 12:00:19"
"1090","40","20210412100205","PC","AAA04","2","16000","800","15200","2021-04-12 10:02:05"
"1091","27","20210412090003","PC","AAA04","15","120000","6000","114000","2021-04-12 09:00:03"
"1092","87","20210412125724","Shop","AAA05","11","660000","220000","440000","2021-04-12 12:57:24"
"1093","82","20210412115440","PC","AAA01","9","90000","18000","72000","2021-04-12 11:54:40"
"1094","21","20210412103724","PC","AAA05","11","660000","220000","440000","2021-04-12 10:37:24"
"1095","3","20210412100108","Shop","AAA05","19","1140000","380000","760000","2021-04-12 10:01:08"
"1096","71","20210412091938","Shop","AAA01","9","90000","18000","72000","2021-04-12 09:19:38"
"1097","4","20210410025838","Mobile","AAA01","9","90000","18000","72000","2021-04-10 02:58:38"
"1098","74","20210409080329","Mobile","AAA01","6","60000","12000","48000","2021-04-09 08:03:29"
"1099","68","20210409070954","Shop","AAA01","4","40000","8000","32000","2021-04-09 07:09:54"
"1100","57","20210408105200","Mobile","AAA05","2","120000","40000","80000","2021-04-08 22:52:00"
"1101","96","20210408070508","PC","AAA01","8","80000","16000","64000","2021-04-08 19:05:08"
"1102","38","20210408014938","Shop","AAA03","2","34000","6000","28000","2021-04-08 13:49:38"
"1103","18","20210408011315","Shop","AAA03","1","17000","3000","14000","2021-04-08 13:13:15"
"1104","86","20210408112543","Mobile","AAA05","3","180000","60000","120000","2021-04-08 11:25:43"
"1105","83","20210408095832","Mobile","AAA04","8","64000","3200","60800","2021-04-08 09:58:32"
"1106","95","20210408084955","Mobile","AAA01","6","60000","12000","48000","2021-04-08 08:49:55"
"1107","71","20210408074658","PC","AAA02","5","75000","11500","63500","2021-04-08 07:46:58"
"1108","16","20210407103549","Mobile","AAA01","13","130000","26000","104000","2021-04-07 22:35:49"
"1109","62","20210407072625","Shop","AAA02","15","225000","34500","190500","2021-04-07 19:26:25"
"1110","13","20210407033921","Shop","AAA03","7","119000","21000","98000","2021-04-07 15:39:21"
"1111","82","20210407025757","Shop","AAA04","1","8000","400","7600","2021-04-07 14:57:57"
"1112","99","20210407015657","Mobile","AAA05","3","180000","60000","120000","2021-04-07 13:56:57"
"1113","95","20210407125825","Mobile","AAA04","15","120000","6000","114000","2021-04-07 12:58:25"
"1114","64","20210407115514","Mobile","AAA03","1","17000","3000","14000","2021-04-07 11:55:14"
"1115","43","20210407112045","Shop","AAA03","14","238000","42000","196000","2021-04-07 11:20:45"
"1116","70","20210407095021","Mobile","AAA02","27","405000","62100","342900","2021-04-07 09:50:21"
"1117","82","20210407090605","PC","AAA04","9","72000","3600","68400","2021-04-07 09:06:05"
"1118","87","20210407083825","Shop","AAA04","9","72000","3600","68400","2021-04-07 08:38:25"
"1119","16","20210407073526","Mobile","AAA04","14","112000","5600","106400","2021-04-07 07:35:26"
"1120","72","20210407015032","Shop","AAA02","8","120000","18400","101600","2021-04-07 01:50:32"
"1121","13","20210406110940","Shop","AAA05","8","480000","160000","320000","2021-04-06 11:09:40"
"1122","99","20210406092439","PC","AAA04","8","64000","3200","60800","2021-04-06 09:24:39"
"1123","17","20210406075153","Shop","AAA05","8","480000","160000","320000","2021-04-06 07:51:53"
"1124","36","20210405024036","Mobile","AAA02","6","90000","13800","76200","2021-04-05 14:40:36"
"1125","30","20210405011650","Shop","AAA04","5","40000","2000","38000","2021-04-05 13:16:50"
"1126","91","20210405114312","Shop","AAA02","2","30000","4600","25400","2021-04-05 11:43:12"
"1127","39","20210402023153","Mobile","AAA05","1","60000","20000","40000","2021-04-02 14:31:53"
"1128","8","20210402021616","PC","AAA01","2","20000","4000","16000","2021-04-02 14:16:16"
"1129","80","20210402123640","Shop","AAA03","6","102000","18000","84000","2021-04-02 12:36:40"
"1130","11","20210402110827","Mobile","AAA05","11","660000","220000","440000","2021-04-02 11:08:27"
"1131","41","20210402090745","Shop","AAA05","1","60000","20000","40000","2021-04-02 09:07:45"
"1132","4","20210402074034","Mobile","AAA04","1","8000","400","7600","2021-04-02 07:40:34"
"1133","82","20210401093952","Shop","AAA02","1","15000","2300","12700","2021-04-01 21:39:52"
"1134","64","20210401062521","Mobile","AAA03","12","204000","36000","168000","2021-04-01 18:25:21"
"1135","79","20210401020400","Mobile","AAA01","21","210000","42000","168000","2021-04-01 14:04:00"
"1136","15","20210401124349","PC","AAA05","6","360000","120000","240000","2021-04-01 12:43:49"
"1137","88","20210401113754","Shop","AAA04","5","40000","2000","38000","2021-04-01 11:37:54"
"1138","5","20210401100737","PC","AAA02","4","60000","9200","50800","2021-04-01 10:07:37"
"1139","48","20210401094638","PC","AAA02","10","150000","23000","127000","2021-04-01 09:46:38"
"1140","17","20210401085039","Mobile","AAA04","13","104000","5200","98800","2021-04-01 08:50:39"
"1141","27","20210401073727","Shop","AAA02","1","15000","2300","12700","2021-04-01 07:37:27"
"1142","36","20210401025548","Mobile","AAA03","7","119000","21000","98000","2021-04-01 02:55:48"
"1143","53","20210331041752","Mobile","AAA04","6","48000","2400","45600","2021-03-31 16:17:52"
"1144","8","20210331040115","Mobile","AAA01","10","100000","20000","80000","2021-03-31 16:01:15"
"1145","3","20210331021811","Shop","AAA02","18","270000","41400","228600","2021-03-31 14:18:11"
"1146","14","20210331125547","Mobile","AAA05","1","60000","20000","40000","2021-03-31 12:55:47"
"1147","60","20210331114012","Shop","AAA02","12","180000","27600","152400","2021-03-31 11:40:12"
"1148","38","20210331104129","PC","AAA04","1","8000","400","7600","2021-03-31 10:41:29"
"1149","27","20210331094412","Shop","AAA01","9","90000","18000","72000","2021-03-31 09:44:12"
"1150","69","20210331085312","PC","AAA03","2","34000","6000","28000","2021-03-31 08:53:12"
"1151","71","20210330091656","Mobile","AAA01","21","210000","42000","168000","2021-03-30 21:16:56"
"1152","55","20210330055044","Shop","AAA05","7","420000","140000","280000","2021-03-30 17:50:44"
"1153","42","20210330045644","Shop","AAA03","9","153000","27000","126000","2021-03-30 16:56:44"
"1154","68","20210330043739","Mobile","AAA04","1","8000","400","7600","2021-03-30 16:37:39"
"1155","40","20210330033025","Mobile","AAA01","4","40000","8000","32000","2021-03-30 15:30:25"
"1156","3","20210330020959","Shop","AAA02","35","525000","80500","444500","2021-03-30 14:09:59"
"1157","96","20210330012744","PC","AAA04","1","8000","400","7600","2021-03-30 13:27:44"
"1158","92","20210330125206","Mobile","AAA04","15","120000","6000","114000","2021-03-30 12:52:06"
"1159","79","20210330121313","PC","AAA05","4","240000","80000","160000","2021-03-30 12:13:13"
"1160","85","20210330104944","Shop","AAA03","1","17000","3000","14000","2021-03-30 10:49:44"
"1161","58","20210330101328","Shop","AAA02","14","210000","32200","177800","2021-03-30 10:13:28"
"1162","25","20210330085823","Shop","AAA02","7","105000","16100","88900","2021-03-30 08:58:23"
"1163","97","20210330081838","PC","AAA02","1","15000","2300","12700","2021-03-30 08:18:38"
"1164","62","20210330064314","Mobile","AAA03","2","34000","6000","28000","2021-03-30 06:43:14"
"1165","55","20210329084510","Mobile","AAA02","7","105000","16100","88900","2021-03-29 20:45:10"
"1166","14","20210329053819","Shop","AAA02","3","45000","6900","38100","2021-03-29 17:38:19"
"1167","4","20210329034048","Mobile","AAA04","1","8000","400","7600","2021-03-29 15:40:48"
"1168","5","20210329025030","PC","AAA05","16","960000","320000","640000","2021-03-29 14:50:30"
"1169","76","20210329015136","PC","AAA03","7","119000","21000","98000","2021-03-29 13:51:36"
"1170","56","20210329120709","Mobile","AAA05","6","360000","120000","240000","2021-03-29 12:07:09"
"1171","18","20210329115431","PC","AAA05","8","480000","160000","320000","2021-03-29 11:54:31"
"1172","92","20210329101951","Shop","AAA02","9","135000","20700","114300","2021-03-29 10:19:51"
"1173","64","20210329084949","PC","AAA04","7","56000","2800","53200","2021-03-29 08:49:49"
"1174","23","20210328122209","PC","AAA01","1","10000","2000","8000","2021-03-28 00:22:09"
"1175","38","20210324090710","PC","AAA03","6","102000","18000","84000","2021-03-24 21:07:10"
"1176","58","20210324053356","Shop","AAA01","2","20000","4000","16000","2021-03-24 17:33:56"
"1177","14","20210324041355","Shop","AAA04","8","64000","3200","60800","2021-03-24 16:13:55"
"1178","80","20210324025150","Mobile","AAA04","2","16000","800","15200","2021-03-24 14:51:50"
"1179","61","20210324012657","PC","AAA01","4","40000","8000","32000","2021-03-24 13:26:57"
"1180","7","20210324125228","Mobile","AAA01","5","50000","10000","40000","2021-03-24 12:52:28"
"1181","56","20210324123338","Mobile","AAA02","1","15000","2300","12700","2021-03-24 12:33:38"
"1182","62","20210324102835","Shop","AAA05","14","840000","280000","560000","2021-03-24 10:28:35"
"1183","63","20210324094509","Mobile","AAA05","11","660000","220000","440000","2021-03-24 09:45:09"
"1184","61","20210324090935","Shop","AAA01","6","60000","12000","48000","2021-03-24 09:09:35"
"1185","39","20210324074713","PC","AAA05","8","480000","160000","320000","2021-03-24 07:47:13"
"1186","30","20210323082206","Shop","AAA02","8","120000","18400","101600","2021-03-23 20:22:06"
"1187","73","20210323080048","PC","AAA01","17","170000","34000","136000","2021-03-23 20:00:48"
"1188","60","20210323035545","PC","AAA04","2","16000","800","15200","2021-03-23 15:55:45"
"1189","97","20210323033047","Mobile","AAA05","10","600000","200000","400000","2021-03-23 15:30:47"
"1190","3","20210323014813","PC","AAA01","19","190000","38000","152000","2021-03-23 13:48:13"
"1191","57","20210323123346","Shop","AAA03","3","51000","9000","42000","2021-03-23 12:33:46"
"1192","18","20210323120356","Mobile","AAA04","15","120000","6000","114000","2021-03-23 12:03:56"
"1193","69","20210323114247","Mobile","AAA04","1","8000","400","7600","2021-03-23 11:42:47"
"1194","97","20210323103502","PC","AAA05","3","180000","60000","120000","2021-03-23 10:35:02"
"1195","76","20210323094949","PC","AAA02","7","105000","16100","88900","2021-03-23 09:49:49"
"1196","20","20210323084844","Shop","AAA04","5","40000","2000","38000","2021-03-23 08:48:44"
"1197","38","20210323072954","Mobile","AAA01","6","60000","12000","48000","2021-03-23 07:29:54"
"1198","35","20210322115619","Shop","AAA03","1","17000","3000","14000","2021-03-22 23:56:19"
"1199","88","20210322033755","Mobile","AAA04","9","72000","3600","68400","2021-03-22 15:37:55"
"1200","14","20210322021242","Shop","AAA03","10","170000","30000","140000","2021-03-22 14:12:42"
"1201","27","20210322010137","PC","AAA05","3","180000","60000","120000","2021-03-22 13:01:37"
"1202","92","20210322121709","PC","AAA03","13","221000","39000","182000","2021-03-22 12:17:09"
"1203","31","20210322105913","Shop","AAA01","4","40000","8000","32000","2021-03-22 10:59:13"
"1204","93","20210322094448","Mobile","AAA01","15","150000","30000","120000","2021-03-22 09:44:48"
"1205","16","20210320094903","Shop","AAA05","18","1080000","360000","720000","2021-03-20 09:49:03"
"1206","33","20210320013217","Mobile","AAA04","8","64000","3200","60800","2021-03-20 01:32:17"
"1207","1","20210319032057","Shop","AAA01","11","110000","22000","88000","2021-03-19 15:20:57"
"1208","30","20210319021609","Shop","AAA05","6","360000","120000","240000","2021-03-19 14:16:09"
"1209","24","20210319012121","Mobile","AAA03","2","34000","6000","28000","2021-03-19 13:21:21"
"1210","20","20210319124740","PC","AAA05","7","420000","140000","280000","2021-03-19 12:47:40"
"1211","63","20210319114024","PC","AAA04","10","80000","4000","76000","2021-03-19 11:40:24"
"1212","71","20210319101727","Mobile","AAA02","3","45000","6900","38100","2021-03-19 10:17:27"
"1213","11","20210319093320","Mobile","AAA03","11","187000","33000","154000","2021-03-19 09:33:20"
"1214","22","20210319083758","Shop","AAA05","12","720000","240000","480000","2021-03-19 08:37:58"
"1215","33","20210319070105","Shop","AAA02","1","15000","2300","12700","2021-03-19 07:01:05"
"1216","79","20210318045748","PC","AAA01","10","100000","20000","80000","2021-03-18 16:57:48"
"1217","91","20210318042946","PC","AAA02","4","60000","9200","50800","2021-03-18 16:29:46"
"1218","59","20210318033230","Mobile","AAA04","1","8000","400","7600","2021-03-18 15:32:30"
"1219","89","20210318020334","PC","AAA01","5","50000","10000","40000","2021-03-18 14:03:34"
"1220","29","20210318120338","PC","AAA05","4","240000","80000","160000","2021-03-18 12:03:38"
"1221","100","20210318110705","PC","AAA05","3","180000","60000","120000","2021-03-18 11:07:05"
"1222","47","20210318075505","PC","AAA01","5","50000","10000","40000","2021-03-18 07:55:05"
"1223","47","20210317055649","Shop","AAA01","3","30000","6000","24000","2021-03-17 17:56:49"
"1224","8","20210317051343","Shop","AAA05","8","480000","160000","320000","2021-03-17 17:13:43"
"1225","97","20210317043658","Mobile","AAA01","6","60000","12000","48000","2021-03-17 16:36:58"
"1226","67","20210317021557","Mobile","AAA05","12","720000","240000","480000","2021-03-17 14:15:57"
"1227","45","20210317013057","PC","AAA03","2","34000","6000","28000","2021-03-17 13:30:57"
"1228","49","20210317114116","Shop","AAA03","14","238000","42000","196000","2021-03-17 11:41:16"
"1229","70","20210317084322","PC","AAA01","13","130000","26000","104000","2021-03-17 08:43:22"
"1230","24","20210317074014","Shop","AAA01","5","50000","10000","40000","2021-03-17 07:40:14"
"1231","18","20210316084859","PC","AAA04","9","72000","3600","68400","2021-03-16 20:48:59"
"1232","32","20210316054844","PC","AAA04","3","24000","1200","22800","2021-03-16 17:48:44"
"1233","46","20210316050407","Mobile","AAA04","17","136000","6800","129200","2021-03-16 17:04:07"
"1234","71","20210316040526","PC","AAA04","6","48000","2400","45600","2021-03-16 16:05:26"
"1235","44","20210316024806","PC","AAA05","17","1020000","340000","680000","2021-03-16 14:48:06"
"1236","53","20210316015730","Mobile","AAA02","1","15000","2300","12700","2021-03-16 13:57:30"
"1237","80","20210316012131","Shop","AAA04","3","24000","1200","22800","2021-03-16 13:21:31"
"1238","86","20210316121352","PC","AAA01","4","40000","8000","32000","2021-03-16 12:13:52"
"1239","74","20210316111926","Mobile","AAA02","6","90000","13800","76200","2021-03-16 11:19:26"
"1240","10","20210316104101","Mobile","AAA02","12","180000","27600","152400","2021-03-16 10:41:01"
"1241","56","20210316091828","Shop","AAA02","7","105000","16100","88900","2021-03-16 09:18:28"
"1242","24","20210316082751","Mobile","AAA05","5","300000","100000","200000","2021-03-16 08:27:51"
"1243","34","20210316070254","Mobile","AAA02","9","135000","20700","114300","2021-03-16 07:02:54"
"1244","89","20210315103121","Shop","AAA01","13","130000","26000","104000","2021-03-15 22:31:21"
"1245","7","20210315024206","Mobile","AAA01","5","50000","10000","40000","2021-03-15 14:42:06"
"1246","76","20210315123349","PC","AAA01","10","100000","20000","80000","2021-03-15 12:33:49"
"1247","58","20210315111648","Shop","AAA02","3","45000","6900","38100","2021-03-15 11:16:48"
"1248","22","20210315100113","Shop","AAA01","6","60000","12000","48000","2021-03-15 10:01:13"
"1249","82","20210312073056","Mobile","AAA04","6","48000","2400","45600","2021-03-12 07:30:56"
"1250","5","20210311104216","PC","AAA02","7","105000","16100","88900","2021-03-11 22:42:16"
"1251","56","20210311082822","PC","AAA02","14","210000","32200","177800","2021-03-11 20:28:22"
"1252","66","20210311044208","PC","AAA01","6","60000","12000","48000","2021-03-11 16:42:08"
"1253","41","20210311034338","Mobile","AAA02","11","165000","25300","139700","2021-03-11 15:43:38"
"1254","63","20210311030842","Shop","AAA02","4","60000","9200","50800","2021-03-11 15:08:42"
"1255","18","20210311124056","Mobile","AAA01","5","50000","10000","40000","2021-03-11 12:40:56"
"1256","73","20210311113006","Mobile","AAA05","8","480000","160000","320000","2021-03-11 11:30:06"
"1257","95","20210311102537","Mobile","AAA04","8","64000","3200","60800","2021-03-11 10:25:37"
"1258","85","20210311093517","PC","AAA03","2","34000","6000","28000","2021-03-11 09:35:17"
"1259","76","20210311085045","Mobile","AAA02","1","15000","2300","12700","2021-03-11 08:50:45"
"1260","38","20210311074033","Shop","AAA05","13","780000","260000","520000","2021-03-11 07:40:33"
"1261","80","20210310033125","PC","AAA05","8","480000","160000","320000","2021-03-10 15:31:25"
"1262","80","20210310021253","Mobile","AAA01","9","90000","18000","72000","2021-03-10 14:12:53"
"1263","98","20210310124309","PC","AAA05","3","180000","60000","120000","2021-03-10 12:43:09"
"1264","77","20210310113510","Mobile","AAA03","1","17000","3000","14000","2021-03-10 11:35:10"
"1265","96","20210310103306","PC","AAA05","15","900000","300000","600000","2021-03-10 10:33:06"
"1266","33","20210310083324","Mobile","AAA02","3","45000","6900","38100","2021-03-10 08:33:24"
"1267","47","20210310071752","PC","AAA04","3","24000","1200","22800","2021-03-10 07:17:52"
"1268","13","20210309102010","Mobile","AAA01","4","40000","8000","32000","2021-03-09 22:20:10"
"1269","66","20210309053330","PC","AAA02","11","165000","25300","139700","2021-03-09 17:33:30"
"1270","80","20210309043414","Shop","AAA02","8","120000","18400","101600","2021-03-09 16:34:14"
"1271","15","20210309033506","Shop","AAA05","1","60000","20000","40000","2021-03-09 15:35:06"
"1272","62","20210309025743","Mobile","AAA04","10","80000","4000","76000","2021-03-09 14:57:43"
"1273","92","20210309013817","PC","AAA05","2","120000","40000","80000","2021-03-09 13:38:17"
"1274","86","20210309124309","PC","AAA03","5","85000","15000","70000","2021-03-09 12:43:09"
"1275","68","20210309111255","Mobile","AAA04","2","16000","800","15200","2021-03-09 11:12:55"
"1276","29","20210309081748","PC","AAA01","10","100000","20000","80000","2021-03-09 08:17:48"
"1277","92","20210309064042","Mobile","AAA04","6","48000","2400","45600","2021-03-09 06:40:42"
"1278","41","20210308065202","PC","AAA04","19","152000","7600","144400","2021-03-08 18:52:02"
"1279","30","20210308040752","Mobile","AAA02","3","45000","6900","38100","2021-03-08 16:07:52"
"1280","34","20210308030511","PC","AAA01","12","120000","24000","96000","2021-03-08 15:05:11"
"1281","45","20210308020506","PC","AAA01","2","20000","4000","16000","2021-03-08 14:05:06"
"1282","50","20210308011013","Mobile","AAA02","12","180000","27600","152400","2021-03-08 13:10:13"
"1283","45","20210308122410","Mobile","AAA02","2","30000","4600","25400","2021-03-08 12:24:10"
"1284","34","20210308100140","Shop","AAA04","9","72000","3600","68400","2021-03-08 10:01:40"
"1285","52","20210308092417","Mobile","AAA01","2","20000","4000","16000","2021-03-08 09:24:17"
"1286","57","20210304070239","Shop","AAA03","10","170000","30000","140000","2021-03-04 19:02:39"
"1287","52","20210304013852","Mobile","AAA02","4","60000","9200","50800","2021-03-04 13:38:52"
"1288","42","20210304125412","PC","AAA02","14","210000","32200","177800","2021-03-04 12:54:12"
"1289","99","20210304114716","PC","AAA01","9","90000","18000","72000","2021-03-04 11:47:16"
"1290","85","20210304104737","Mobile","AAA03","12","204000","36000","168000","2021-03-04 10:47:37"
"1291","6","20210304094845","PC","AAA04","6","48000","2400","45600","2021-03-04 09:48:45"
"1292","87","20210304091734","Shop","AAA02","9","135000","20700","114300","2021-03-04 09:17:34"
"1293","98","20210304074800","Mobile","AAA04","1","8000","400","7600","2021-03-04 07:48:00"
"1294","53","20210303062640","PC","AAA01","5","50000","10000","40000","2021-03-03 18:26:40"
"1295","70","20210303015552","Shop","AAA05","29","1740000","580000","1160000","2021-03-03 13:55:52"
"1296","47","20210303011145","PC","AAA05","12","720000","240000","480000","2021-03-03 13:11:45"
"1297","30","20210303122725","PC","AAA03","1","17000","3000","14000","2021-03-03 12:27:25"
"1298","3","20210303111510","Mobile","AAA05","1","60000","20000","40000","2021-03-03 11:15:10"
"1299","51","20210303103210","Mobile","AAA05","8","480000","160000","320000","2021-03-03 10:32:10"
"1300","64","20210303093415","Shop","AAA03","13","221000","39000","182000","2021-03-03 09:34:15"
"1301","93","20210303082830","Shop","AAA03","4","68000","12000","56000","2021-03-03 08:28:30"
"1302","27","20210303072237","Mobile","AAA04","2","16000","800","15200","2021-03-03 07:22:37"
"1303","97","20210302065631","PC","AAA03","8","136000","24000","112000","2021-03-02 18:56:31"
"1304","21","20210302032704","PC","AAA04","6","48000","2400","45600","2021-03-02 15:27:04"
"1305","62","20210302022018","Mobile","AAA05","18","1080000","360000","720000","2021-03-02 14:20:18"
"1306","51","20210302010529","Shop","AAA01","4","40000","8000","32000","2021-03-02 13:05:29"
"1307","91","20210302121246","PC","AAA03","1","17000","3000","14000","2021-03-02 12:12:46"
"1308","71","20210302105633","Shop","AAA01","13","130000","26000","104000","2021-03-02 10:56:33"
"1309","5","20210302105332","Shop","AAA01","10","100000","20000","80000","2021-03-02 10:53:32"
"1310","46","20210302100633","Mobile","AAA05","15","900000","300000","600000","2021-03-02 10:06:33"
"1311","30","20210302090934","Mobile","AAA01","8","80000","16000","64000","2021-03-02 09:09:34"
"1312","43","20210302080126","Shop","AAA04","20","160000","8000","152000","2021-03-02 08:01:26"
"1313","99","20210302063520","PC","AAA03","6","102000","18000","84000","2021-03-02 06:35:20"
"1314","49","20210301075449","Shop","AAA04","3","24000","1200","22800","2021-03-01 19:54:49"
"1315","48","20210301051822","Shop","AAA05","13","780000","260000","520000","2021-03-01 17:18:22"
"1316","78","20210301043331","Mobile","AAA04","9","72000","3600","68400","2021-03-01 16:33:31"
"1317","81","20210301023426","Mobile","AAA05","7","420000","140000","280000","2021-03-01 14:34:26"
"1318","41","20210301011542","Shop","AAA01","2","20000","4000","16000","2021-03-01 13:15:42"
"1319","74","20210301124117","Mobile","AAA05","3","180000","60000","120000","2021-03-01 12:41:17"
"1320","92","20210301111909","Shop","AAA02","3","45000","6900","38100","2021-03-01 11:19:09"
"1321","88","20210301103319","PC","AAA01","4","40000","8000","32000","2021-03-01 10:33:19"
"1322","13","20210301093055","Shop","AAA03","1","17000","3000","14000","2021-03-01 09:30:55"
"1323","54","20210227082626","PC","AAA05","11","660000","220000","440000","2021-02-27 08:26:26"
"1324","82","20210226031353","PC","AAA02","9","135000","20700","114300","2021-02-26 15:13:53"
"1325","87","20210226021622","Mobile","AAA03","8","136000","24000","112000","2021-02-26 14:16:22"
"1326","25","20210226122955","Shop","AAA01","7","70000","14000","56000","2021-02-26 12:29:55"
"1327","37","20210226100512","Shop","AAA02","1","15000","2300","12700","2021-02-26 10:05:12"
"1328","37","20210226090004","PC","AAA01","5","50000","10000","40000","2021-02-26 09:00:04"
"1329","95","20210226071025","Shop","AAA01","9","90000","18000","72000","2021-02-26 07:10:25"
"1330","36","20210226011240","PC","AAA05","14","840000","280000","560000","2021-02-26 01:12:40"
"1331","79","20210225050315","PC","AAA01","1","10000","2000","8000","2021-02-25 17:03:15"
"1332","29","20210225041229","Shop","AAA05","10","600000","200000","400000","2021-02-25 16:12:29"
"1333","81","20210225032602","Mobile","AAA02","1","15000","2300","12700","2021-02-25 15:26:02"
"1334","59","20210225012942","Shop","AAA01","3","30000","6000","24000","2021-02-25 13:29:42"
"1335","29","20210225123049","Shop","AAA05","9","540000","180000","360000","2021-02-25 12:30:49"
"1336","83","20210225115039","PC","AAA05","16","960000","320000","640000","2021-02-25 11:50:39"
"1337","90","20210225113347","Mobile","AAA05","7","420000","140000","280000","2021-02-25 11:33:47"
"1338","32","20210225101749","Mobile","AAA01","11","110000","22000","88000","2021-02-25 10:17:49"
"1339","8","20210225092103","Mobile","AAA02","13","195000","29900","165100","2021-02-25 09:21:03"
"1340","28","20210225081128","Mobile","AAA02","10","150000","23000","127000","2021-02-25 08:11:28"
"1341","38","20210225071635","PC","AAA03","16","272000","48000","224000","2021-02-25 07:16:35"
"1342","64","20210224071839","Mobile","AAA03","11","187000","33000","154000","2021-02-24 19:18:39"
"1343","81","20210224050558","PC","AAA04","1","8000","400","7600","2021-02-24 17:05:58"
"1344","57","20210224035151","Mobile","AAA02","2","30000","4600","25400","2021-02-24 15:51:51"
"1345","72","20210224020914","Shop","AAA02","6","90000","13800","76200","2021-02-24 14:09:14"
"1346","82","20210224015244","Shop","AAA01","1","10000","2000","8000","2021-02-24 13:52:44"
"1347","88","20210224121453","Mobile","AAA01","5","50000","10000","40000","2021-02-24 12:14:53"
"1348","40","20210224111459","Shop","AAA04","6","48000","2400","45600","2021-02-24 11:14:59"
"1349","23","20210224100938","PC","AAA02","7","105000","16100","88900","2021-02-24 10:09:38"
"1350","45","20210224082952","Mobile","AAA01","4","40000","8000","32000","2021-02-24 08:29:52"
"1351","69","20210223045822","Mobile","AAA02","7","105000","16100","88900","2021-02-23 16:58:22"
"1352","83","20210223033531","Mobile","AAA04","1","8000","400","7600","2021-02-23 15:35:31"
"1353","12","20210223022303","Mobile","AAA02","1","15000","2300","12700","2021-02-23 14:23:03"
"1354","15","20210223014402","PC","AAA03","14","238000","42000","196000","2021-02-23 13:44:02"
"1355","1","20210223010222","Shop","AAA02","12","180000","27600","152400","2021-02-23 13:02:22"
"1356","90","20210223120100","PC","AAA02","2","30000","4600","25400","2021-02-23 12:01:00"
"1357","29","20210223111703","Shop","AAA03","9","153000","27000","126000","2021-02-23 11:17:03"
"1358","86","20210223100353","PC","AAA03","6","102000","18000","84000","2021-02-23 10:03:53"
"1359","43","20210223083251","PC","AAA03","7","119000","21000","98000","2021-02-23 08:32:51"
"1360","35","20210223071859","PC","AAA03","4","68000","12000","56000","2021-02-23 07:18:59"
"1361","61","20210222062714","Mobile","AAA03","5","85000","15000","70000","2021-02-22 18:27:14"
"1362","27","20210222033728","Mobile","AAA04","6","48000","2400","45600","2021-02-22 15:37:28"
"1363","10","20210222020214","PC","AAA03","18","306000","54000","252000","2021-02-22 14:02:14"
"1364","22","20210222115918","Shop","AAA01","5","50000","10000","40000","2021-02-22 11:59:18"
"1365","81","20210222111708","Shop","AAA01","5","50000","10000","40000","2021-02-22 11:17:08"
"1366","73","20210222102621","Mobile","AAA02","11","165000","25300","139700","2021-02-22 10:26:21"
"1367","68","20210222092012","Mobile","AAA02","1","15000","2300","12700","2021-02-22 09:20:12"
"1368","76","20210221121920","Mobile","AAA01","5","50000","10000","40000","2021-02-21 00:19:20"
"1369","71","20210217032635","Mobile","AAA02","7","105000","16100","88900","2021-02-17 15:26:35"
"1370","56","20210217020327","PC","AAA05","11","660000","220000","440000","2021-02-17 14:03:27"
"1371","49","20210217013702","Mobile","AAA02","5","75000","11500","63500","2021-02-17 13:37:02"
"1372","45","20210217115531","Mobile","AAA04","6","48000","2400","45600","2021-02-17 11:55:31"
"1373","83","20210217104107","PC","AAA01","2","20000","4000","16000","2021-02-17 10:41:07"
"1374","5","20210217100257","Mobile","AAA01","10","100000","20000","80000","2021-02-17 10:02:57"
"1375","36","20210217084917","Shop","AAA04","9","72000","3600","68400","2021-02-17 08:49:17"
"1376","41","20210217060742","PC","AAA01","11","110000","22000","88000","2021-02-17 06:07:42"
"1377","40","20210216040014","PC","AAA05","5","300000","100000","200000","2021-02-16 16:00:14"
"1378","85","20210216020332","PC","AAA03","9","153000","27000","126000","2021-02-16 14:03:32"
"1379","7","20210216012459","Mobile","AAA02","25","375000","57500","317500","2021-02-16 13:24:59"
"1380","79","20210216124422","Mobile","AAA02","4","60000","9200","50800","2021-02-16 12:44:22"
"1381","97","20210216110738","Shop","AAA01","9","90000","18000","72000","2021-02-16 11:07:38"
"1382","92","20210216102828","PC","AAA04","5","40000","2000","38000","2021-02-16 10:28:28"
"1383","15","20210216083558","Shop","AAA01","23","230000","46000","184000","2021-02-16 08:35:58"
"1384","1","20210216065413","Shop","AAA05","6","360000","120000","240000","2021-02-16 06:54:13"
"1385","51","20210215035635","Shop","AAA05","7","420000","140000","280000","2021-02-15 15:56:35"
"1386","48","20210215034201","Mobile","AAA03","8","136000","24000","112000","2021-02-15 15:42:01"
"1387","60","20210215024304","PC","AAA03","5","85000","15000","70000","2021-02-15 14:43:04"
"1388","46","20210215012911","PC","AAA03","5","85000","15000","70000","2021-02-15 13:29:11"
"1389","29","20210215124800","Mobile","AAA04","11","88000","4400","83600","2021-02-15 12:48:00"
"1390","65","20210215122327","Shop","AAA01","14","140000","28000","112000","2021-02-15 12:23:27"
"1391","75","20210215114942","PC","AAA05","3","180000","60000","120000","2021-02-15 11:49:42"
"1392","28","20210215105617","Mobile","AAA01","9","90000","18000","72000","2021-02-15 10:56:17"
"1393","95","20210215095026","PC","AAA03","4","68000","12000","56000","2021-02-15 09:50:26"
"1394","56","20210210032730","Shop","AAA04","14","112000","5600","106400","2021-02-10 15:27:30"
"1395","17","20210210012516","PC","AAA03","1","17000","3000","14000","2021-02-10 13:25:16"
"1396","60","20210210120808","Shop","AAA05","9","540000","180000","360000","2021-02-10 12:08:08"
"1397","23","20210210105912","Shop","AAA05","1","60000","20000","40000","2021-02-10 10:59:12"
"1398","80","20210210100830","PC","AAA03","8","136000","24000","112000","2021-02-10 10:08:30"
"1399","67","20210210075755","PC","AAA03","12","204000","36000","168000","2021-02-10 07:57:55"
"1400","49","20210209035400","Mobile","AAA02","14","210000","32200","177800","2021-02-09 15:54:00"
"1401","39","20210209022514","PC","AAA03","1","17000","3000","14000","2021-02-09 14:25:14"
"1402","1","20210209012157","PC","AAA05","22","1320000","440000","880000","2021-02-09 13:21:57"
"1403","65","20210209122357","Mobile","AAA03","20","340000","60000","280000","2021-02-09 12:23:57"
"1404","90","20210209111216","PC","AAA03","4","68000","12000","56000","2021-02-09 11:12:16"
"1405","97","20210209095312","PC","AAA02","1","15000","2300","12700","2021-02-09 09:53:12"
"1406","3","20210209083746","PC","AAA05","22","1320000","440000","880000","2021-02-09 08:37:46"
"1407","33","20210209072241","Mobile","AAA04","1","8000","400","7600","2021-02-09 07:22:41"
"1408","54","20210208081852","Mobile","AAA02","6","90000","13800","76200","2021-02-08 20:18:52"
"1409","3","20210208053026","Mobile","AAA02","25","375000","57500","317500","2021-02-08 17:30:26"
"1410","5","20210208042801","PC","AAA01","8","80000","16000","64000","2021-02-08 16:28:01"
"1411","81","20210208031317","PC","AAA02","1","15000","2300","12700","2021-02-08 15:13:17"
"1412","14","20210208022653","PC","AAA01","11","110000","22000","88000","2021-02-08 14:26:53"
"1413","52","20210208012754","Shop","AAA03","4","68000","12000","56000","2021-02-08 13:27:54"
"1414","27","20210208114302","PC","AAA01","7","70000","14000","56000","2021-02-08 11:43:02"
"1415","26","20210208103305","Mobile","AAA02","2","30000","4600","25400","2021-02-08 10:33:05"
"1416","24","20210208092712","Shop","AAA01","1","10000","2000","8000","2021-02-08 09:27:12"
"1417","49","20210207051515","PC","AAA05","12","720000","240000","480000","2021-02-07 05:15:15"
"1418","100","20210205121817","Mobile","AAA02","7","105000","16100","88900","2021-02-05 12:18:17"
"1419","47","20210205103035","Shop","AAA04","9","72000","3600","68400","2021-02-05 10:30:35"
"1420","98","20210205085118","PC","AAA04","1","8000","400","7600","2021-02-05 08:51:18"
"1421","23","20210205080852","Shop","AAA05","1","60000","20000","40000","2021-02-05 08:08:52"
"1422","11","20210205073027","PC","AAA04","6","48000","2400","45600","2021-02-05 07:30:27"
"1423","39","20210204060652","Shop","AAA04","8","64000","3200","60800","2021-02-04 18:06:52"
"1424","76","20210204021644","PC","AAA02","7","105000","16100","88900","2021-02-04 14:16:44"
"1425","47","20210204015347","PC","AAA02","13","195000","29900","165100","2021-02-04 13:53:47"
"1426","69","20210204010921","PC","AAA05","8","480000","160000","320000","2021-02-04 13:09:21"
"1427","84","20210204114913","Shop","AAA01","2","20000","4000","16000","2021-02-04 11:49:13"
"1428","11","20210204104007","PC","AAA04","17","136000","6800","129200","2021-02-04 10:40:07"
"1429","22","20210204094648","Mobile","AAA03","3","51000","9000","42000","2021-02-04 09:46:48"
"1430","83","20210204083657","Shop","AAA04","16","128000","6400","121600","2021-02-04 08:36:57"
"1431","12","20210204073446","PC","AAA04","5","40000","2000","38000","2021-02-04 07:34:46"
"1432","24","20210203083933","PC","AAA03","6","102000","18000","84000","2021-02-03 20:39:33"
"1433","88","20210203053905","PC","AAA02","9","135000","20700","114300","2021-02-03 17:39:05"
"1434","1","20210203051143","Shop","AAA04","5","40000","2000","38000","2021-02-03 17:11:43"
"1435","53","20210203041112","Mobile","AAA05","4","240000","80000","160000","2021-02-03 16:11:12"
"1436","60","20210203030922","Shop","AAA01","1","10000","2000","8000","2021-02-03 15:09:22"
"1437","53","20210203014128","Shop","AAA04","9","72000","3600","68400","2021-02-03 13:41:28"
"1438","21","20210203121121","PC","AAA02","7","105000","16100","88900","2021-02-03 12:11:21"
"1439","33","20210203111358","Shop","AAA03","2","34000","6000","28000","2021-02-03 11:13:58"
"1440","55","20210203095638","Mobile","AAA01","14","140000","28000","112000","2021-02-03 09:56:38"
"1441","30","20210203082301","Mobile","AAA04","7","56000","2800","53200","2021-02-03 08:23:01"
"1442","23","20210203073319","PC","AAA03","5","85000","15000","70000","2021-02-03 07:33:19"
"1443","73","20210202094141","PC","AAA05","11","660000","220000","440000","2021-02-02 21:41:41"
"1444","25","20210202042404","Mobile","AAA04","8","64000","3200","60800","2021-02-02 16:24:04"
"1445","40","20210202030256","Mobile","AAA05","2","120000","40000","80000","2021-02-02 15:02:56"
"1446","51","20210202015934","Mobile","AAA03","10","170000","30000","140000","2021-02-02 13:59:34"
"1447","43","20210202124952","Shop","AAA05","7","420000","140000","280000","2021-02-02 12:49:52"
"1448","92","20210202110218","Shop","AAA04","8","64000","3200","60800","2021-02-02 11:02:18"
"1449","38","20210202073423","PC","AAA04","15","120000","6000","114000","2021-02-02 07:34:23"
"1450","44","20210201042603","PC","AAA02","10","150000","23000","127000","2021-02-01 16:26:03"
"1451","10","20210201040142","PC","AAA01","7","70000","14000","56000","2021-02-01 16:01:42"
"1452","98","20210201022850","Shop","AAA05","4","240000","80000","160000","2021-02-01 14:28:50"
"1453","23","20210201013405","Mobile","AAA04","12","96000","4800","91200","2021-02-01 13:34:05"
"1454","20","20210201012112","Shop","AAA03","2","34000","6000","28000","2021-02-01 13:21:12"
"1455","67","20210201120924","PC","AAA01","8","80000","16000","64000","2021-02-01 12:09:24"
"1456","62","20210201111039","PC","AAA04","5","40000","2000","38000","2021-02-01 11:10:39"
"1457","95","20210201101701","Mobile","AAA02","10","150000","23000","127000","2021-02-01 10:17:01"
"1458","70","20210201092408","Mobile","AAA04","2","16000","800","15200","2021-02-01 09:24:08"
"1459","89","20210131024037","Shop","AAA02","4","60000","9200","50800","2021-01-31 14:40:37"
"1460","55","20210129125625","PC","AAA01","8","80000","16000","64000","2021-01-29 12:56:25"
"1461","83","20210129114201","Mobile","AAA02","16","240000","36800","203200","2021-01-29 11:42:01"
"1462","42","20210129101502","PC","AAA05","9","540000","180000","360000","2021-01-29 10:15:02"
"1463","36","20210129090546","Mobile","AAA01","3","30000","6000","24000","2021-01-29 09:05:46"
"1464","40","20210129075817","Shop","AAA05","7","420000","140000","280000","2021-01-29 07:58:17"
"1465","29","20210128044209","Mobile","AAA04","5","40000","2000","38000","2021-01-28 16:42:09"
"1466","77","20210128033504","Mobile","AAA04","10","80000","4000","76000","2021-01-28 15:35:04"
"1467","68","20210128022754","PC","AAA03","10","170000","30000","140000","2021-01-28 14:27:54"
"1468","39","20210128014141","Mobile","AAA03","8","136000","24000","112000","2021-01-28 13:41:41"
"1469","1","20210128121429","PC","AAA02","12","180000","27600","152400","2021-01-28 12:14:29"
"1470","79","20210128104636","Mobile","AAA02","9","135000","20700","114300","2021-01-28 10:46:36"
"1471","28","20210128093224","PC","AAA04","12","96000","4800","91200","2021-01-28 09:32:24"
"1472","91","20210128081835","Mobile","AAA02","1","15000","2300","12700","2021-01-28 08:18:35"
"1473","34","20210127102711","PC","AAA04","4","32000","1600","30400","2021-01-27 22:27:11"
"1474","85","20210127071554","Mobile","AAA04","13","104000","5200","98800","2021-01-27 19:15:54"
"1475","12","20210127031416","PC","AAA01","3","30000","6000","24000","2021-01-27 15:14:16"
"1476","39","20210127020523","PC","AAA01","1","10000","2000","8000","2021-01-27 14:05:23"
"1477","94","20210127121055","Shop","AAA04","18","144000","7200","136800","2021-01-27 12:10:55"
"1478","48","20210127111123","Mobile","AAA03","11","187000","33000","154000","2021-01-27 11:11:23"
"1479","75","20210127093955","Shop","AAA05","1","60000","20000","40000","2021-01-27 09:39:55"
"1480","45","20210127082115","Mobile","AAA01","3","30000","6000","24000","2021-01-27 08:21:15"
"1481","58","20210127064907","PC","AAA01","5","50000","10000","40000","2021-01-27 06:49:07"
"1482","28","20210127011440","Mobile","AAA03","5","85000","15000","70000","2021-01-27 01:14:40"
"1483","79","20210126035601","Mobile","AAA02","5","75000","11500","63500","2021-01-26 15:56:01"
"1484","81","20210126014249","Shop","AAA04","7","56000","2800","53200","2021-01-26 13:42:49"
"1485","21","20210126011201","PC","AAA04","11","88000","4400","83600","2021-01-26 13:12:01"
"1486","8","20210126122554","PC","AAA02","10","150000","23000","127000","2021-01-26 12:25:54"
"1487","57","20210126113119","PC","AAA04","2","16000","800","15200","2021-01-26 11:31:19"
"1488","7","20210126095442","Mobile","AAA04","2","16000","800","15200","2021-01-26 09:54:42"
"1489","28","20210126080743","Shop","AAA02","23","345000","52900","292100","2021-01-26 08:07:43"
"1490","59","20210126072838","PC","AAA05","2","120000","40000","80000","2021-01-26 07:28:38"
"1491","87","20210125094035","PC","AAA05","6","360000","120000","240000","2021-01-25 21:40:35"
"1492","61","20210125054811","Mobile","AAA05","3","180000","60000","120000","2021-01-25 17:48:11"
"1493","18","20210125043116","PC","AAA03","14","238000","42000","196000","2021-01-25 16:31:16"
"1494","40","20210125025722","Mobile","AAA01","7","70000","14000","56000","2021-01-25 14:57:22"
"1495","91","20210125023729","Mobile","AAA04","6","48000","2400","45600","2021-01-25 14:37:29"
"1496","94","20210125013736","Mobile","AAA04","10","80000","4000","76000","2021-01-25 13:37:36"
"1497","11","20210125124002","PC","AAA04","13","104000","5200","98800","2021-01-25 12:40:02"
"1498","83","20210125113030","Mobile","AAA05","5","300000","100000","200000","2021-01-25 11:30:30"
"1499","93","20210125105637","Shop","AAA01","10","100000","20000","80000","2021-01-25 10:56:37"
"1500","47","20210125094856","Mobile","AAA01","1","10000","2000","8000","2021-01-25 09:48:56"
"1501","85","20210121125000","Mobile","AAA04","13","104000","5200","98800","2021-01-21 12:50:00"
"1502","99","20210121121605","Shop","AAA03","10","170000","30000","140000","2021-01-21 12:16:05"
"1503","4","20210121103914","PC","AAA03","1","17000","3000","14000","2021-01-21 10:39:14"
"1504","4","20210121093404","Shop","AAA05","7","420000","140000","280000","2021-01-21 09:34:04"
"1505","32","20210121085346","Mobile","AAA01","11","110000","22000","88000","2021-01-21 08:53:46"
"1506","88","20210121075208","Mobile","AAA01","3","30000","6000","24000","2021-01-21 07:52:08"
"1507","14","20210120083455","PC","AAA04","1","8000","400","7600","2021-01-20 20:34:55"
"1508","23","20210120023052","Shop","AAA01","2","20000","4000","16000","2021-01-20 14:30:52"
"1509","87","20210120014237","Shop","AAA05","9","540000","180000","360000","2021-01-20 13:42:37"
"1510","81","20210120121211","PC","AAA04","1","8000","400","7600","2021-01-20 12:12:11"
"1511","41","20210120102107","Shop","AAA03","4","68000","12000","56000","2021-01-20 10:21:07"
"1512","81","20210120090638","Mobile","AAA02","7","105000","16100","88900","2021-01-20 09:06:38"
"1513","67","20210120063506","Mobile","AAA05","8","480000","160000","320000","2021-01-20 06:35:06"
"1514","15","20210119103501","Shop","AAA03","26","442000","78000","364000","2021-01-19 22:35:01"
"1515","6","20210119085156","Mobile","AAA04","9","72000","3600","68400","2021-01-19 20:51:56"
"1516","21","20210119065518","PC","AAA04","13","104000","5200","98800","2021-01-19 18:55:18"
"1517","23","20210119024117","PC","AAA04","10","80000","4000","76000","2021-01-19 14:41:17"
"1518","63","20210119010816","Shop","AAA01","11","110000","22000","88000","2021-01-19 13:08:16"
"1519","73","20210119121233","Mobile","AAA03","5","85000","15000","70000","2021-01-19 12:12:33"
"1520","40","20210119101650","PC","AAA01","6","60000","12000","48000","2021-01-19 10:16:50"
"1521","93","20210119091017","Mobile","AAA04","5","40000","2000","38000","2021-01-19 09:10:17"
"1522","57","20210119073556","PC","AAA05","5","300000","100000","200000","2021-01-19 07:35:56"
"1523","93","20210118084106","Shop","AAA02","14","210000","32200","177800","2021-01-18 20:41:06"
"1524","8","20210118043946","PC","AAA02","18","270000","41400","228600","2021-01-18 16:39:46"
"1525","20","20210118031942","PC","AAA01","1","10000","2000","8000","2021-01-18 15:19:42"
"1526","81","20210118024208","Shop","AAA04","6","48000","2400","45600","2021-01-18 14:42:08"
"1527","58","20210118015431","Mobile","AAA04","8","64000","3200","60800","2021-01-18 13:54:31"
"1528","98","20210118114441","Mobile","AAA03","1","17000","3000","14000","2021-01-18 11:44:41"
"1529","11","20210118094700","PC","AAA02","7","105000","16100","88900","2021-01-18 09:47:00"
"1530","6","20210115100635","Shop","AAA02","5","75000","11500","63500","2021-01-15 10:06:35"
"1531","58","20210115084612","PC","AAA05","9","540000","180000","360000","2021-01-15 08:46:12"
"1532","50","20210115072430","PC","AAA01","14","140000","28000","112000","2021-01-15 07:24:30"
"1533","83","20210114080723","PC","AAA05","12","720000","240000","480000","2021-01-14 20:07:23"
"1534","5","20210114040554","Mobile","AAA04","6","48000","2400","45600","2021-01-14 16:05:54"
"1535","33","20210114031209","Mobile","AAA02","3","45000","6900","38100","2021-01-14 15:12:09"
"1536","44","20210114021622","Mobile","AAA05","6","360000","120000","240000","2021-01-14 14:16:22"
"1537","54","20210114102737","Shop","AAA04","9","72000","3600","68400","2021-01-14 10:27:37"
"1538","56","20210114081722","Mobile","AAA01","9","90000","18000","72000","2021-01-14 08:17:22"
"1539","33","20210114072033","Shop","AAA05","1","60000","20000","40000","2021-01-14 07:20:33"
"1540","63","20210114032559","Mobile","AAA05","1","60000","20000","40000","2021-01-14 03:25:59"
"1541","45","20210113094311","Shop","AAA02","1","15000","2300","12700","2021-01-13 21:43:11"
"1542","83","20210113082229","PC","AAA04","16","128000","6400","121600","2021-01-13 20:22:29"
"1543","68","20210113045041","Mobile","AAA01","9","90000","18000","72000","2021-01-13 16:50:41"
"1544","30","20210113035234","Mobile","AAA05","13","780000","260000","520000","2021-01-13 15:52:34"
"1545","57","20210113025709","Mobile","AAA02","6","90000","13800","76200","2021-01-13 14:57:09"
"1546","78","20210113022712","Shop","AAA04","8","64000","3200","60800","2021-01-13 14:27:12"
"1547","70","20210113121419","PC","AAA04","6","48000","2400","45600","2021-01-13 12:14:19"
"1548","88","20210113102314","PC","AAA04","3","24000","1200","22800","2021-01-13 10:23:14"
"1549","3","20210113091619","Shop","AAA04","21","168000","8400","159600","2021-01-13 09:16:19"
"1550","19","20210113072802","Shop","AAA04","8","64000","3200","60800","2021-01-13 07:28:02"
"1551","29","20210112082440","Shop","AAA01","2","20000","4000","16000","2021-01-12 20:24:40"
"1552","79","20210112013212","PC","AAA02","8","120000","18400","101600","2021-01-12 13:32:12"
"1553","93","20210112121352","Shop","AAA04","7","56000","2800","53200","2021-01-12 12:13:52"
"1554","64","20210112113733","Mobile","AAA02","10","150000","23000","127000","2021-01-12 11:37:33"
"1555","81","20210112103543","Mobile","AAA02","5","75000","11500","63500","2021-01-12 10:35:43"
"1556","18","20210112092113","Shop","AAA03","12","204000","36000","168000","2021-01-12 09:21:13"
"1557","58","20210112081248","Mobile","AAA04","3","24000","1200","22800","2021-01-12 08:12:48"
"1558","41","20210112064446","PC","AAA02","22","330000","50600","279400","2021-01-12 06:44:46"
"1559","89","20210111052547","PC","AAA04","13","104000","5200","98800","2021-01-11 17:25:47"
"1560","16","20210111043015","Mobile","AAA01","16","160000","32000","128000","2021-01-11 16:30:15"
"1561","20","20210111023604","Shop","AAA02","5","75000","11500","63500","2021-01-11 14:36:04"
"1562","80","20210111022651","PC","AAA05","4","240000","80000","160000","2021-01-11 14:26:51"
"1563","1","20210111012417","Mobile","AAA02","10","150000","23000","127000","2021-01-11 13:24:17"
"1564","37","20210111110934","Shop","AAA04","13","104000","5200","98800","2021-01-11 11:09:34"
"1565","40","20210111100130","PC","AAA03","12","204000","36000","168000","2021-01-11 10:01:30"
"1566","35","20210108025530","Mobile","AAA01","2","20000","4000","16000","2021-01-08 02:55:30"
"1567","83","20210107043139","Shop","AAA04","30","240000","12000","228000","2021-01-07 16:31:39"
"1568","55","20210107030431","Mobile","AAA02","8","120000","18400","101600","2021-01-07 15:04:31"
"1569","86","20210107021437","PC","AAA03","3","51000","9000","42000","2021-01-07 14:14:37"
"1570","58","20210107011728","Mobile","AAA04","1","8000","400","7600","2021-01-07 13:17:28"
"1571","29","20210107115226","Mobile","AAA05","6","360000","120000","240000","2021-01-07 11:52:26"
"1572","50","20210107110841","PC","AAA02","15","225000","34500","190500","2021-01-07 11:08:41"
"1573","71","20210107095727","PC","AAA02","5","75000","11500","63500","2021-01-07 09:57:27"
"1574","17","20210107082530","Shop","AAA05","1","60000","20000","40000","2021-01-07 08:25:30"
"1575","99","20210107070040","Mobile","AAA05","8","480000","160000","320000","2021-01-07 07:00:40"
"1576","78","20210107011804","PC","AAA04","1","8000","400","7600","2021-01-07 01:18:04"
"1577","22","20210106061045","PC","AAA03","4","68000","12000","56000","2021-01-06 18:10:45"
"1578","44","20210106041153","PC","AAA02","2","30000","4600","25400","2021-01-06 16:11:53"
"1579","59","20210106030351","Mobile","AAA03","2","34000","6000","28000","2021-01-06 15:03:51"
"1580","93","20210106014154","Shop","AAA01","10","100000","20000","80000","2021-01-06 13:41:54"
"1581","43","20210106124646","Mobile","AAA03","10","170000","30000","140000","2021-01-06 12:46:46"
"1582","51","20210106112705","PC","AAA05","11","660000","220000","440000","2021-01-06 11:27:05"
"1583","50","20210106104802","Mobile","AAA04","16","128000","6400","121600","2021-01-06 10:48:02"
"1584","63","20210106094535","Mobile","AAA01","4","40000","8000","32000","2021-01-06 09:45:35"
"1585","88","20210106084634","Mobile","AAA04","1","8000","400","7600","2021-01-06 08:46:34"
"1586","32","20210106073705","PC","AAA01","11","110000","22000","88000","2021-01-06 07:37:05"
"1587","12","20210105070505","PC","AAA01","5","50000","10000","40000","2021-01-05 19:05:05"
"1588","55","20210105040350","Shop","AAA04","11","88000","4400","83600","2021-01-05 16:03:50"
"1589","20","20210105030040","Shop","AAA03","2","34000","6000","28000","2021-01-05 15:00:40"
"1590","27","20210105012312","PC","AAA04","15","120000","6000","114000","2021-01-05 13:23:12"
"1591","86","20210105114607","Mobile","AAA01","3","30000","6000","24000","2021-01-05 11:46:07"
"1592","3","20210105104135","Mobile","AAA05","15","900000","300000","600000","2021-01-05 10:41:35"
"1593","73","20210105094035","Mobile","AAA02","17","255000","39100","215900","2021-01-05 09:40:35"
"1594","76","20210105084416","Mobile","AAA03","7","119000","21000","98000","2021-01-05 08:44:16"
"1595","74","20210105073542","Shop","AAA02","1","15000","2300","12700","2021-01-05 07:35:42"
"1596","61","20210104110336","PC","AAA05","5","300000","100000","200000","2021-01-04 23:03:36"
"1597","80","20210104015320","Mobile","AAA05","8","480000","160000","320000","2021-01-04 13:53:20"
"1598","92","20210104010935","PC","AAA04","9","72000","3600","68400","2021-01-04 13:09:35"
"1599","77","20210104115721","Shop","AAA03","2","34000","6000","28000","2021-01-04 11:57:21"
"1600","82","20210104110746","PC","AAA04","16","128000","6400","121600","2021-01-04 11:07:46"
"1601","83","20210104095821","PC","AAA02","14","210000","32200","177800","2021-01-04 09:58:21"
"1602","24","20201231011721","Mobile","AAA01","6","60000","12000","48000","2020-12-31 01:17:21"
"1603","15","20201230015708","Mobile","AAA04","22","176000","8800","167200","2020-12-30 13:57:08"
"1604","39","20201230014312","Shop","AAA01","9","90000","18000","72000","2020-12-30 13:43:12"
"1605","9","20201230121853","PC","AAA03","2","34000","6000","28000","2020-12-30 12:18:53"
"1606","45","20201230112805","Shop","AAA02","3","45000","6900","38100","2020-12-30 11:28:05"
"1607","70","20201230102148","PC","AAA01","18","180000","36000","144000","2020-12-30 10:21:48"
"1608","16","20201230080832","Mobile","AAA01","16","160000","32000","128000","2020-12-30 08:08:32"
"1609","99","20201229110356","Shop","AAA02","1","15000","2300","12700","2020-12-29 23:03:56"
"1610","84","20201229022550","Shop","AAA05","5","300000","100000","200000","2020-12-29 14:25:50"
"1611","92","20201229011318","PC","AAA03","1","17000","3000","14000","2020-12-29 13:13:18"
"1612","25","20201229120025","Mobile","AAA03","8","136000","24000","112000","2020-12-29 12:00:25"
"1613","36","20201229110034","Shop","AAA05","9","540000","180000","360000","2020-12-29 11:00:34"
"1614","8","20201229084128","Mobile","AAA01","5","50000","10000","40000","2020-12-29 08:41:28"
"1615","95","20201229080438","Mobile","AAA01","6","60000","12000","48000","2020-12-29 08:04:38"
"1616","57","20201229071444","Shop","AAA01","6","60000","12000","48000","2020-12-29 07:14:44"
"1617","90","20201228055816","PC","AAA04","1","8000","400","7600","2020-12-28 17:58:16"
"1618","45","20201228051934","Mobile","AAA01","4","40000","8000","32000","2020-12-28 17:19:34"
"1619","40","20201228040029","Mobile","AAA05","3","180000","60000","120000","2020-12-28 16:00:29"
"1620","90","20201228024808","PC","AAA01","1","10000","2000","8000","2020-12-28 14:48:08"
"1621","81","20201228014457","PC","AAA05","8","480000","160000","320000","2020-12-28 13:44:57"
"1622","3","20201228125342","Shop","AAA02","12","180000","27600","152400","2020-12-28 12:53:42"
"1623","60","20201228113420","PC","AAA01","6","60000","12000","48000","2020-12-28 11:34:20"
"1624","88","20201228100945","Mobile","AAA03","6","102000","18000","84000","2020-12-28 10:09:45"
"1625","16","20201228090219","PC","AAA05","1","60000","20000","40000","2020-12-28 09:02:19"
"1626","24","20201225103856","Shop","AAA01","3","30000","6000","24000","2020-12-25 22:38:56"
"1627","88","20201225074147","Mobile","AAA02","1","15000","2300","12700","2020-12-25 19:41:47"
"1628","14","20201225043626","Shop","AAA04","1","8000","400","7600","2020-12-25 16:36:26"
"1629","69","20201225035157","PC","AAA01","5","50000","10000","40000","2020-12-25 15:51:57"
"1630","47","20201225025632","Shop","AAA04","9","72000","3600","68400","2020-12-25 14:56:32"
"1631","96","20201225020027","Mobile","AAA02","19","285000","43700","241300","2020-12-25 14:00:27"
"1632","48","20201225012239","Mobile","AAA05","14","840000","280000","560000","2020-12-25 13:22:39"
"1633","81","20201225122613","PC","AAA05","2","120000","40000","80000","2020-12-25 12:26:13"
"1634","91","20201225104000","Shop","AAA01","1","10000","2000","8000","2020-12-25 10:40:00"
"1635","66","20201225102446","PC","AAA03","1","17000","3000","14000","2020-12-25 10:24:46"
"1636","63","20201225093155","PC","AAA05","1","60000","20000","40000","2020-12-25 09:31:55"
"1637","29","20201225082530","Mobile","AAA04","2","16000","800","15200","2020-12-25 08:25:30"
"1638","47","20201225072255","Mobile","AAA02","13","195000","29900","165100","2020-12-25 07:22:55"
"1639","2","20201224092831","Shop","AAA04","13","104000","5200","98800","2020-12-24 21:28:31"
"1640","6","20201224054727","Shop","AAA04","9","72000","3600","68400","2020-12-24 17:47:27"
"1641","7","20201224030821","Shop","AAA03","14","238000","42000","196000","2020-12-24 15:08:21"
"1642","3","20201224021014","Shop","AAA05","15","900000","300000","600000","2020-12-24 14:10:14"
"1643","21","20201224121359","Shop","AAA05","29","1740000","580000","1160000","2020-12-24 12:13:59"
"1644","90","20201224103534","PC","AAA05","10","600000","200000","400000","2020-12-24 10:35:34"
"1645","56","20201224092519","Mobile","AAA05","7","420000","140000","280000","2020-12-24 09:25:19"
"1646","69","20201224074722","PC","AAA03","1","17000","3000","14000","2020-12-24 07:47:22"
"1647","20","20201223102659","Shop","AAA05","13","780000","260000","520000","2020-12-23 22:26:59"
"1648","43","20201223065358","Mobile","AAA03","13","221000","39000","182000","2020-12-23 18:53:58"
"1649","13","20201223030902","Mobile","AAA03","5","85000","15000","70000","2020-12-23 15:09:02"
"1650","35","20201223023731","PC","AAA05","8","480000","160000","320000","2020-12-23 14:37:31"
"1651","15","20201223013720","Shop","AAA04","18","144000","7200","136800","2020-12-23 13:37:20"
"1652","17","20201223120150","PC","AAA04","4","32000","1600","30400","2020-12-23 12:01:50"
"1653","40","20201223111750","Mobile","AAA04","8","64000","3200","60800","2020-12-23 11:17:50"
"1654","97","20201223082850","Mobile","AAA04","1","8000","400","7600","2020-12-23 08:28:50"
"1655","100","20201223072747","PC","AAA01","11","110000","22000","88000","2020-12-23 07:27:47"
"1656","96","20201222042227","PC","AAA05","8","480000","160000","320000","2020-12-22 16:22:27"
"1657","95","20201222035246","PC","AAA05","7","420000","140000","280000","2020-12-22 15:52:46"
"1658","98","20201222033023","PC","AAA05","1","60000","20000","40000","2020-12-22 15:30:23"
"1659","2","20201222025032","Mobile","AAA04","1","8000","400","7600","2020-12-22 14:50:32"
"1660","65","20201222013218","Shop","AAA03","7","119000","21000","98000","2020-12-22 13:32:18"
"1661","8","20201222012245","Shop","AAA02","9","135000","20700","114300","2020-12-22 13:22:45"
"1662","73","20201222112813","PC","AAA03","10","170000","30000","140000","2020-12-22 11:28:13"
"1663","24","20201222083753","Mobile","AAA05","2","120000","40000","80000","2020-12-22 08:37:53"
"1664","29","20201222080842","Shop","AAA01","1","10000","2000","8000","2020-12-22 08:08:42"
"1665","89","20201222065036","Shop","AAA02","19","285000","43700","241300","2020-12-22 06:50:36"
"1666","64","20201221072141","Mobile","AAA03","12","204000","36000","168000","2020-12-21 19:21:41"
"1667","66","20201221022449","PC","AAA04","1","8000","400","7600","2020-12-21 14:24:49"
"1668","12","20201221011339","Mobile","AAA02","1","15000","2300","12700","2020-12-21 13:13:39"
"1669","6","20201221115222","PC","AAA04","1","8000","400","7600","2020-12-21 11:52:22"
"1670","65","20201221104419","PC","AAA01","9","90000","18000","72000","2020-12-21 10:44:19"
"1671","60","20201221101639","PC","AAA03","9","153000","27000","126000","2020-12-21 10:16:39"
"1672","95","20201221091959","PC","AAA04","5","40000","2000","38000","2020-12-21 09:19:59"
"1673","82","20201220010145","Mobile","AAA04","10","80000","4000","76000","2020-12-20 01:01:45"
"1674","60","20201217023845","PC","AAA03","1","17000","3000","14000","2020-12-17 14:38:45"
"1675","40","20201217013929","Shop","AAA03","1","17000","3000","14000","2020-12-17 13:39:29"
"1676","91","20201217111103","PC","AAA02","2","30000","4600","25400","2020-12-17 11:11:03"
"1677","61","20201217095523","PC","AAA03","1","17000","3000","14000","2020-12-17 09:55:23"
"1678","18","20201217085057","Shop","AAA03","4","68000","12000","56000","2020-12-17 08:50:57"
"1679","79","20201217071032","PC","AAA03","3","51000","9000","42000","2020-12-17 07:10:32"
"1680","94","20201216044402","PC","AAA04","6","48000","2400","45600","2020-12-16 16:44:02"
"1681","94","20201216032206","PC","AAA01","19","190000","38000","152000","2020-12-16 15:22:06"
"1682","51","20201216020934","PC","AAA01","9","90000","18000","72000","2020-12-16 14:09:34"
"1683","32","20201216010626","PC","AAA03","14","238000","42000","196000","2020-12-16 13:06:26"
"1684","38","20201216120134","Shop","AAA02","16","240000","36800","203200","2020-12-16 12:01:34"
"1685","55","20201216111520","PC","AAA04","11","88000","4400","83600","2020-12-16 11:15:20"
"1686","7","20201216093355","Shop","AAA04","6","48000","2400","45600","2020-12-16 09:33:55"
"1687","13","20201216082415","Shop","AAA05","9","540000","180000","360000","2020-12-16 08:24:15"
"1688","22","20201216065213","Shop","AAA05","6","360000","120000","240000","2020-12-16 06:52:13"
"1689","2","20201215093708","PC","AAA04","6","48000","2400","45600","2020-12-15 21:37:08"
"1690","81","20201215043337","Mobile","AAA02","12","180000","27600","152400","2020-12-15 16:33:37"
"1691","34","20201215032414","Shop","AAA02","7","105000","16100","88900","2020-12-15 15:24:14"
"1692","25","20201215015933","Shop","AAA05","5","300000","100000","200000","2020-12-15 13:59:33"
"1693","62","20201215011634","Shop","AAA01","6","60000","12000","48000","2020-12-15 13:16:34"
"1694","1","20201215120850","PC","AAA02","7","105000","16100","88900","2020-12-15 12:08:50"
"1695","64","20201215110050","Shop","AAA02","13","195000","29900","165100","2020-12-15 11:00:50"
"1696","75","20201215095408","Mobile","AAA05","2","120000","40000","80000","2020-12-15 09:54:08"
"1697","100","20201215073409","Shop","AAA03","2","34000","6000","28000","2020-12-15 07:34:09"
"1698","12","20201214074048","Mobile","AAA04","2","16000","800","15200","2020-12-14 19:40:48"
"1699","9","20201214043544","Shop","AAA05","9","540000","180000","360000","2020-12-14 16:35:44"
"1700","66","20201214032230","Shop","AAA01","2","20000","4000","16000","2020-12-14 15:22:30"
"1701","73","20201214015945","Mobile","AAA05","12","720000","240000","480000","2020-12-14 13:59:45"
"1702","96","20201214010416","PC","AAA02","6","90000","13800","76200","2020-12-14 13:04:16"
"1703","1","20201214095229","Mobile","AAA04","7","56000","2800","53200","2020-12-14 09:52:29"
"1704","32","20201213103050","Mobile","AAA03","15","255000","45000","210000","2020-12-13 10:30:50"
"1705","44","20201209113024","Mobile","AAA04","8","64000","3200","60800","2020-12-09 23:30:24"
"1706","77","20201209012218","Mobile","AAA05","3","180000","60000","120000","2020-12-09 13:22:18"
"1707","75","20201209104016","Shop","AAA04","6","48000","2400","45600","2020-12-09 10:40:16"
"1708","42","20201209102415","PC","AAA05","11","660000","220000","440000","2020-12-09 10:24:15"
"1709","23","20201209090501","Shop","AAA04","1","8000","400","7600","2020-12-09 09:05:01"
"1710","36","20201209080723","Shop","AAA04","11","88000","4400","83600","2020-12-09 08:07:23"
"1711","62","20201209061608","Mobile","AAA04","4","32000","1600","30400","2020-12-09 06:16:08"
"1712","85","20201208112712","Shop","AAA01","16","160000","32000","128000","2020-12-08 23:27:12"
"1713","59","20201208110220","Mobile","AAA04","1","8000","400","7600","2020-12-08 11:02:20"
"1714","63","20201208103421","Mobile","AAA01","3","30000","6000","24000","2020-12-08 10:34:21"
"1715","38","20201208085836","Shop","AAA05","7","420000","140000","280000","2020-12-08 08:58:36"
"1716","94","20201208073508","PC","AAA04","13","104000","5200","98800","2020-12-08 07:35:08"
"1717","7","20201208040322","Shop","AAA01","9","90000","18000","72000","2020-12-08 04:03:22"
"1718","44","20201207063749","Shop","AAA02","9","135000","20700","114300","2020-12-07 18:37:49"
"1719","49","20201207024324","Mobile","AAA01","16","160000","32000","128000","2020-12-07 14:43:24"
"1720","87","20201207020029","Shop","AAA04","3","24000","1200","22800","2020-12-07 14:00:29"
"1721","40","20201207010657","PC","AAA03","1","17000","3000","14000","2020-12-07 13:06:57"
"1722","35","20201207113549","Shop","AAA01","7","70000","14000","56000","2020-12-07 11:35:49"
"1723","82","20201207111132","Shop","AAA05","2","120000","40000","80000","2020-12-07 11:11:32"
"1724","35","20201207093331","Shop","AAA04","2","16000","800","15200","2020-12-07 09:33:31"
"1725","87","20201204124346","Shop","AAA03","5","85000","15000","70000","2020-12-04 12:43:46"
"1726","48","20201204111640","Shop","AAA03","4","68000","12000","56000","2020-12-04 11:16:40"
"1727","22","20201204102953","PC","AAA01","8","80000","16000","64000","2020-12-04 10:29:53"
"1728","30","20201204092854","PC","AAA03","5","85000","15000","70000","2020-12-04 09:28:54"
"1729","41","20201204084716","Mobile","AAA05","3","180000","60000","120000","2020-12-04 08:47:16"
"1730","54","20201204074318","Mobile","AAA05","8","480000","160000","320000","2020-12-04 07:43:18"
"1731","2","20201203114419","Shop","AAA03","6","102000","18000","84000","2020-12-03 23:44:19"
"1732","2","20201203024712","PC","AAA01","3","30000","6000","24000","2020-12-03 02:47:12"
"1733","31","20201202052858","PC","AAA05","1","60000","20000","40000","2020-12-02 17:28:58"
"1734","5","20201202040138","PC","AAA05","4","240000","80000","160000","2020-12-02 16:01:38"
"1735","97","20201202025846","Mobile","AAA04","8","64000","3200","60800","2020-12-02 14:58:46"
"1736","68","20201202021030","Mobile","AAA02","9","135000","20700","114300","2020-12-02 14:10:30"
"1737","41","20201202124424","PC","AAA02","11","165000","25300","139700","2020-12-02 12:44:24"
"1738","72","20201202120316","Mobile","AAA02","3","45000","6900","38100","2020-12-02 12:03:16"
"1739","85","20201202104545","Shop","AAA01","14","140000","28000","112000","2020-12-02 10:45:45"
"1740","4","20201202094630","Shop","AAA01","1","10000","2000","8000","2020-12-02 09:46:30"
"1741","69","20201202083155","Mobile","AAA05","4","240000","80000","160000","2020-12-02 08:31:55"
"1742","31","20201201111852","Shop","AAA05","5","300000","100000","200000","2020-12-01 23:18:52"
"1743","4","20201201030822","Mobile","AAA05","6","360000","120000","240000","2020-12-01 15:08:22"
"1744","88","20201201015954","PC","AAA01","9","90000","18000","72000","2020-12-01 13:59:54"
"1745","57","20201201123538","Mobile","AAA04","7","56000","2800","53200","2020-12-01 12:35:38"
"1746","89","20201201114611","PC","AAA05","32","1920000","640000","1280000","2020-12-01 11:46:11"
"1747","47","20201201102804","PC","AAA04","10","80000","4000","76000","2020-12-01 10:28:04"
"1748","18","20201201084814","Mobile","AAA04","8","64000","3200","60800","2020-12-01 08:48:14"
"1749","92","20201201063049","PC","AAA05","3","180000","60000","120000","2020-12-01 06:30:49"
"1750","17","20201130020920","Mobile","AAA02","2","30000","4600","25400","2020-11-30 14:09:20"
"1751","36","20201130013036","Mobile","AAA01","10","100000","20000","80000","2020-11-30 13:30:36"
"1752","44","20201130122454","PC","AAA02","14","210000","32200","177800","2020-11-30 12:24:54"
"1753","12","20201130104915","Mobile","AAA05","4","240000","80000","160000","2020-11-30 10:49:15"
"1754","90","20201130091324","Mobile","AAA05","3","180000","60000","120000","2020-11-30 09:13:24"
"1755","75","20201127073554","PC","AAA01","7","70000","14000","56000","2020-11-27 19:35:54"
"1756","41","20201127041042","Mobile","AAA01","11","110000","22000","88000","2020-11-27 16:10:42"
"1757","72","20201127024722","Shop","AAA04","2","16000","800","15200","2020-11-27 14:47:22"
"1758","40","20201127014135","PC","AAA04","6","48000","2400","45600","2020-11-27 13:41:35"
"1759","69","20201127124700","Mobile","AAA03","3","51000","9000","42000","2020-11-27 12:47:00"
"1760","59","20201127115958","PC","AAA02","10","150000","23000","127000","2020-11-27 11:59:58"
"1761","99","20201127101720","PC","AAA05","6","360000","120000","240000","2020-11-27 10:17:20"
"1762","33","20201127085150","PC","AAA04","1","8000","400","7600","2020-11-27 08:51:50"
"1763","65","20201127073458","Shop","AAA04","5","40000","2000","38000","2020-11-27 07:34:58"
"1764","24","20201126072753","Shop","AAA02","1","15000","2300","12700","2020-11-26 19:27:53"
"1765","29","20201126033544","Mobile","AAA03","8","136000","24000","112000","2020-11-26 15:35:44"
"1766","42","20201126025843","PC","AAA04","21","168000","8400","159600","2020-11-26 14:58:43"
"1767","19","20201126013139","Mobile","AAA04","1","8000","400","7600","2020-11-26 13:31:39"
"1768","67","20201126122723","Mobile","AAA05","2","120000","40000","80000","2020-11-26 12:27:23"
"1769","46","20201126094241","Mobile","AAA03","13","221000","39000","182000","2020-11-26 09:42:41"
"1770","51","20201126084426","Mobile","AAA03","9","153000","27000","126000","2020-11-26 08:44:26"
"1771","63","20201126073511","PC","AAA03","6","102000","18000","84000","2020-11-26 07:35:11"
"1772","73","20201125103704","Shop","AAA04","3","24000","1200","22800","2020-11-25 22:37:04"
"1773","11","20201125044004","PC","AAA05","1","60000","20000","40000","2020-11-25 16:40:04"
"1774","2","20201125025028","Shop","AAA01","1","10000","2000","8000","2020-11-25 14:50:28"
"1775","78","20201125021138","Mobile","AAA03","3","51000","9000","42000","2020-11-25 14:11:38"
"1776","27","20201125014851","Mobile","AAA04","15","120000","6000","114000","2020-11-25 13:48:51"
"1777","21","20201125124430","Shop","AAA02","17","255000","39100","215900","2020-11-25 12:44:30"
"1778","50","20201125111843","Mobile","AAA05","10","600000","200000","400000","2020-11-25 11:18:43"
"1779","60","20201125103757","Mobile","AAA03","2","34000","6000","28000","2020-11-25 10:37:57"
"1780","88","20201125095553","Mobile","AAA05","1","60000","20000","40000","2020-11-25 09:55:53"
"1781","29","20201125090819","PC","AAA03","12","204000","36000","168000","2020-11-25 09:08:19"
"1782","92","20201125074428","PC","AAA01","4","40000","8000","32000","2020-11-25 07:44:28"
"1783","98","20201124042517","PC","AAA02","6","90000","13800","76200","2020-11-24 16:25:17"
"1784","13","20201124031314","PC","AAA05","7","420000","140000","280000","2020-11-24 15:13:14"
"1785","88","20201124022840","PC","AAA02","11","165000","25300","139700","2020-11-24 14:28:40"
"1786","32","20201124012327","PC","AAA03","10","170000","30000","140000","2020-11-24 13:23:27"
"1787","52","20201124120200","Shop","AAA04","6","48000","2400","45600","2020-11-24 12:02:00"
"1788","86","20201124105505","Shop","AAA05","4","240000","80000","160000","2020-11-24 10:55:05"
"1789","44","20201124101343","Mobile","AAA03","8","136000","24000","112000","2020-11-24 10:13:43"
"1790","56","20201124083219","PC","AAA05","4","240000","80000","160000","2020-11-24 08:32:19"
"1791","95","20201124064018","PC","AAA01","2","20000","4000","16000","2020-11-24 06:40:18"
"1792","65","20201123112219","Shop","AAA01","10","100000","20000","80000","2020-11-23 11:22:19"
"1793","95","20201122090513","Shop","AAA03","8","136000","24000","112000","2020-11-22 21:05:13"
"1794","91","20201120110653","Mobile","AAA02","1","15000","2300","12700","2020-11-20 11:06:53"
"1795","73","20201120101015","Mobile","AAA04","15","120000","6000","114000","2020-11-20 10:10:15"
"1796","67","20201120081619","Shop","AAA03","7","119000","21000","98000","2020-11-20 08:16:19"
"1797","20","20201120071400","Shop","AAA01","12","120000","24000","96000","2020-11-20 07:14:00"
"1798","88","20201119071715","Shop","AAA01","1","10000","2000","8000","2020-11-19 19:17:15"
"1799","86","20201119064211","Shop","AAA04","6","48000","2400","45600","2020-11-19 18:42:11"
"1800","72","20201119032717","PC","AAA05","14","840000","280000","560000","2020-11-19 15:27:17"
"1801","10","20201119030227","Mobile","AAA04","4","32000","1600","30400","2020-11-19 15:02:27"
"1802","42","20201119013532","Shop","AAA05","4","240000","80000","160000","2020-11-19 13:35:32"
"1803","79","20201119123906","Mobile","AAA02","2","30000","4600","25400","2020-11-19 12:39:06"
"1804","76","20201119110842","PC","AAA05","7","420000","140000","280000","2020-11-19 11:08:42"
"1805","35","20201119085258","Shop","AAA01","1","10000","2000","8000","2020-11-19 08:52:58"
"1806","53","20201119082756","Mobile","AAA02","6","90000","13800","76200","2020-11-19 08:27:56"
"1807","3","20201119073040","PC","AAA03","12","204000","36000","168000","2020-11-19 07:30:40"
"1808","95","20201118073105","PC","AAA02","1","15000","2300","12700","2020-11-18 19:31:05"
"1809","99","20201118023402","PC","AAA04","9","72000","3600","68400","2020-11-18 14:34:02"
"1810","52","20201118011329","Shop","AAA04","5","40000","2000","38000","2020-11-18 13:13:29"
"1811","39","20201118114027","PC","AAA02","1","15000","2300","12700","2020-11-18 11:40:27"
"1812","10","20201118104604","PC","AAA02","10","150000","23000","127000","2020-11-18 10:46:04"
"1813","58","20201118084325","PC","AAA02","1","15000","2300","12700","2020-11-18 08:43:25"
"1814","8","20201118073511","PC","AAA04","10","80000","4000","76000","2020-11-18 07:35:11"
"1815","71","20201118010430","Shop","AAA04","6","48000","2400","45600","2020-11-18 01:04:30"
"1816","63","20201117115355","Mobile","AAA04","9","72000","3600","68400","2020-11-17 11:53:55"
"1817","8","20201117105417","Shop","AAA01","12","120000","24000","96000","2020-11-17 10:54:17"
"1818","92","20201117095529","Mobile","AAA04","4","32000","1600","30400","2020-11-17 09:55:29"
"1819","19","20201117084713","Mobile","AAA01","9","90000","18000","72000","2020-11-17 08:47:13"
"1820","20","20201117075926","Shop","AAA01","8","80000","16000","64000","2020-11-17 07:59:26"
"1821","29","20201116115927","PC","AAA01","14","140000","28000","112000","2020-11-16 11:59:27"
"1822","18","20201116111604","PC","AAA02","2","30000","4600","25400","2020-11-16 11:16:04"
"1823","25","20201116103339","Shop","AAA02","12","180000","27600","152400","2020-11-16 10:33:39"
"1824","54","20201116094556","Mobile","AAA01","3","30000","6000","24000","2020-11-16 09:45:56"
"1825","93","20201113070310","Shop","AAA05","2","120000","40000","80000","2020-11-13 07:03:10"
"1826","79","20201112075543","Shop","AAA03","9","153000","27000","126000","2020-11-12 19:55:43"
"1827","51","20201112061959","Mobile","AAA03","12","204000","36000","168000","2020-11-12 18:19:59"
"1828","82","20201112030055","PC","AAA02","9","135000","20700","114300","2020-11-12 15:00:55"
"1829","12","20201112015850","Mobile","AAA04","3","24000","1200","22800","2020-11-12 13:58:50"
"1830","42","20201112125203","Shop","AAA02","12","180000","27600","152400","2020-11-12 12:52:03"
"1831","34","20201112113455","PC","AAA01","11","110000","22000","88000","2020-11-12 11:34:55"
"1832","7","20201112104204","Shop","AAA05","7","420000","140000","280000","2020-11-12 10:42:04"
"1833","94","20201112093640","Shop","AAA01","8","80000","16000","64000","2020-11-12 09:36:40"
"1834","56","20201112081930","Shop","AAA04","16","128000","6400","121600","2020-11-12 08:19:30"
"1835","10","20201112070349","Mobile","AAA01","9","90000","18000","72000","2020-11-12 07:03:49"
"1836","92","20201111082916","PC","AAA01","6","60000","12000","48000","2020-11-11 20:29:16"
"1837","55","20201111061856","Shop","AAA04","18","144000","7200","136800","2020-11-11 18:18:56"
"1838","28","20201111114746","PC","AAA01","3","30000","6000","24000","2020-11-11 11:47:46"
"1839","47","20201111110126","Shop","AAA05","4","240000","80000","160000","2020-11-11 11:01:26"
"1840","96","20201111100211","PC","AAA05","9","540000","180000","360000","2020-11-11 10:02:11"
"1841","23","20201111075425","PC","AAA03","11","187000","33000","154000","2020-11-11 07:54:25"
"1842","18","20201110095855","Shop","AAA01","11","110000","22000","88000","2020-11-10 21:58:55"
"1843","25","20201110032543","PC","AAA03","3","51000","9000","42000","2020-11-10 15:25:43"
"1844","24","20201110015045","Mobile","AAA02","9","135000","20700","114300","2020-11-10 13:50:45"
"1845","61","20201110010923","Shop","AAA01","2","20000","4000","16000","2020-11-10 13:09:23"
"1846","56","20201110121413","Shop","AAA02","11","165000","25300","139700","2020-11-10 12:14:13"
"1847","3","20201110105929","PC","AAA01","12","120000","24000","96000","2020-11-10 10:59:29"
"1848","10","20201110094219","Mobile","AAA03","8","136000","24000","112000","2020-11-10 09:42:19"
"1849","81","20201110074116","PC","AAA04","5","40000","2000","38000","2020-11-10 07:41:16"
"1850","35","20201109101050","Shop","AAA01","3","30000","6000","24000","2020-11-09 22:10:50"
"1851","33","20201109055832","PC","AAA04","2","16000","800","15200","2020-11-09 17:58:32"
"1852","94","20201109051446","Shop","AAA01","5","50000","10000","40000","2020-11-09 17:14:46"
"1853","69","20201109040216","Shop","AAA02","2","30000","4600","25400","2020-11-09 16:02:16"
"1854","96","20201109020935","Shop","AAA04","10","80000","4000","76000","2020-11-09 14:09:35"
"1855","32","20201109122204","Mobile","AAA02","16","240000","36800","203200","2020-11-09 12:22:04"
"1856","39","20201109113150","Mobile","AAA03","16","272000","48000","224000","2020-11-09 11:31:50"
"1857","29","20201109095138","Mobile","AAA04","7","56000","2800","53200","2020-11-09 09:51:38"
"1858","66","20201104114321","Shop","AAA02","3","45000","6900","38100","2020-11-04 23:43:21"
"1859","88","20201104105916","Shop","AAA01","1","10000","2000","8000","2020-11-04 10:59:16"
"1860","22","20201104091927","Shop","AAA01","9","90000","18000","72000","2020-11-04 09:19:27"
"1861","5","20201104082649","PC","AAA05","5","300000","100000","200000","2020-11-04 08:26:49"
"1862","18","20201104071323","Shop","AAA05","9","540000","180000","360000","2020-11-04 07:13:23"
"1863","68","20201103105206","Shop","AAA05","1","60000","20000","40000","2020-11-03 10:52:06"
"1864","83","20201103092943","Mobile","AAA02","21","315000","48300","266700","2020-11-03 09:29:43"
"1865","29","20201103073733","Mobile","AAA04","4","32000","1600","30400","2020-11-03 07:37:33"
"1866","27","20201102074123","PC","AAA02","4","60000","9200","50800","2020-11-02 19:41:23"
"1867","23","20201102024042","PC","AAA05","9","540000","180000","360000","2020-11-02 14:40:42"
"1868","13","20201102015836","Mobile","AAA01","5","50000","10000","40000","2020-11-02 13:58:36"
"1869","52","20201102012418","Shop","AAA03","2","34000","6000","28000","2020-11-02 13:24:18"
"1870","95","20201102115103","Mobile","AAA05","1","60000","20000","40000","2020-11-02 11:51:03"
"1871","14","20201102104936","Mobile","AAA04","4","32000","1600","30400","2020-11-02 10:49:36"
"1872","27","20201102093638","PC","AAA01","19","190000","38000","152000","2020-11-02 09:36:38"
"1873","57","20201030041022","PC","AAA04","11","88000","4400","83600","2020-10-30 04:10:22"
"1874","29","20201029054931","Mobile","AAA04","4","32000","1600","30400","2020-10-29 17:49:31"
"1875","97","20201029042753","Mobile","AAA03","2","34000","6000","28000","2020-10-29 16:27:53"
"1876","72","20201029031603","Mobile","AAA02","5","75000","11500","63500","2020-10-29 15:16:03"
"1877","52","20201029021835","Shop","AAA05","2","120000","40000","80000","2020-10-29 14:18:35"
"1878","21","20201029123824","PC","AAA04","15","120000","6000","114000","2020-10-29 12:38:24"
"1879","14","20201029112507","PC","AAA05","4","240000","80000","160000","2020-10-29 11:25:07"
"1880","78","20201029095719","Shop","AAA02","4","60000","9200","50800","2020-10-29 09:57:19"
"1881","92","20201029090946","Mobile","AAA02","2","30000","4600","25400","2020-10-29 09:09:46"
"1882","29","20201029081526","Mobile","AAA05","3","180000","60000","120000","2020-10-29 08:15:26"
"1883","36","20201029070557","PC","AAA01","25","250000","50000","200000","2020-10-29 07:05:57"
"1884","17","20201028101815","Mobile","AAA05","9","540000","180000","360000","2020-10-28 22:18:15"
"1885","35","20201028072737","Shop","AAA05","3","180000","60000","120000","2020-10-28 19:27:37"
"1886","18","20201028032357","Shop","AAA02","6","90000","13800","76200","2020-10-28 15:23:57"
"1887","93","20201028020001","Mobile","AAA02","8","120000","18400","101600","2020-10-28 14:00:01"
"1888","38","20201028010017","Shop","AAA03","15","255000","45000","210000","2020-10-28 13:00:17"
"1889","33","20201028115758","Shop","AAA02","7","105000","16100","88900","2020-10-28 11:57:58"
"1890","10","20201028102101","PC","AAA01","21","210000","42000","168000","2020-10-28 10:21:01"
"1891","10","20201028091223","Shop","AAA04","6","48000","2400","45600","2020-10-28 09:12:23"
"1892","68","20201028082250","PC","AAA03","4","68000","12000","56000","2020-10-28 08:22:50"
"1893","95","20201028071432","Shop","AAA04","2","16000","800","15200","2020-10-28 07:14:32"
"1894","67","20201027110557","PC","AAA01","4","40000","8000","32000","2020-10-27 23:05:57"
"1895","3","20201027115416","Mobile","AAA05","14","840000","280000","560000","2020-10-27 11:54:16"
"1896","92","20201027103647","PC","AAA04","2","16000","800","15200","2020-10-27 10:36:47"
"1897","80","20201027092349","Mobile","AAA03","12","204000","36000","168000","2020-10-27 09:23:49"
"1898","74","20201027080744","Mobile","AAA05","7","420000","140000","280000","2020-10-27 08:07:44"
"1899","100","20201027064328","Mobile","AAA03","9","153000","27000","126000","2020-10-27 06:43:28"
"1900","33","20201026024343","PC","AAA02","5","75000","11500","63500","2020-10-26 14:43:43"
"1901","33","20201026022319","Shop","AAA05","1","60000","20000","40000","2020-10-26 14:23:19"
"1902","3","20201026010610","PC","AAA05","15","900000","300000","600000","2020-10-26 13:06:10"
"1903","41","20201026121420","Shop","AAA01","4","40000","8000","32000","2020-10-26 12:14:20"
"1904","77","20201026110823","Mobile","AAA04","1","8000","400","7600","2020-10-26 11:08:23"
"1905","3","20201026091847","Shop","AAA05","17","1020000","340000","680000","2020-10-26 09:18:47"
"1906","85","20201022085523","Mobile","AAA04","7","56000","2800","53200","2020-10-22 08:55:23"
"1907","58","20201022082139","Mobile","AAA03","1","17000","3000","14000","2020-10-22 08:21:39"
"1908","55","20201022073351","Shop","AAA01","12","120000","24000","96000","2020-10-22 07:33:51"
"1909","81","20201021013152","Mobile","AAA02","4","60000","9200","50800","2020-10-21 13:31:52"
"1910","27","20201021121909","Shop","AAA01","17","170000","34000","136000","2020-10-21 12:19:09"
"1911","20","20201021110356","Mobile","AAA05","7","420000","140000","280000","2020-10-21 11:03:56"
"1912","2","20201021094028","Mobile","AAA01","10","100000","20000","80000","2020-10-21 09:40:28"
"1913","44","20201021084744","Mobile","AAA01","4","40000","8000","32000","2020-10-21 08:47:44"
"1914","16","20201021073932","Mobile","AAA01","11","110000","22000","88000","2020-10-21 07:39:32"
"1915","16","20201020102405","PC","AAA01","4","40000","8000","32000","2020-10-20 22:24:05"
"1916","6","20201020080215","Shop","AAA03","3","51000","9000","42000","2020-10-20 20:02:15"
"1917","79","20201020033413","Mobile","AAA01","4","40000","8000","32000","2020-10-20 15:34:13"
"1918","32","20201020115639","Shop","AAA05","13","780000","260000","520000","2020-10-20 11:56:39"
"1919","43","20201020105903","Shop","AAA02","5","75000","11500","63500","2020-10-20 10:59:03"
"1920","37","20201020095754","PC","AAA03","8","136000","24000","112000","2020-10-20 09:57:54"
"1921","78","20201020071746","Mobile","AAA03","8","136000","24000","112000","2020-10-20 07:17:46"
"1922","63","20201019062711","Mobile","AAA01","7","70000","14000","56000","2020-10-19 18:27:11"
"1923","3","20201019033428","Shop","AAA03","3","51000","9000","42000","2020-10-19 15:34:28"
"1924","15","20201019011400","PC","AAA04","11","88000","4400","83600","2020-10-19 13:14:00"
"1925","31","20201019101443","Mobile","AAA04","5","40000","2000","38000","2020-10-19 10:14:43"
"1926","20","20201019092124","Mobile","AAA05","3","180000","60000","120000","2020-10-19 09:21:24"
"1927","45","20201017055507","Mobile","AAA04","1","8000","400","7600","2020-10-17 17:55:07"
"1928","7","20201016014511","Shop","AAA05","8","480000","160000","320000","2020-10-16 13:45:11"
"1929","93","20201016122844","Shop","AAA03","3","51000","9000","42000","2020-10-16 12:28:44"
"1930","94","20201016112335","PC","AAA05","11","660000","220000","440000","2020-10-16 11:23:35"
"1931","67","20201016100113","Mobile","AAA05","9","540000","180000","360000","2020-10-16 10:01:13"
"1932","15","20201016085252","Shop","AAA03","12","204000","36000","168000","2020-10-16 08:52:52"
"1933","10","20201015095006","PC","AAA01","14","140000","28000","112000","2020-10-15 21:50:06"
"1934","38","20201015050950","Shop","AAA01","10","100000","20000","80000","2020-10-15 17:09:50"
"1935","51","20201015041857","Mobile","AAA03","4","68000","12000","56000","2020-10-15 16:18:57"
"1936","51","20201015035432","Shop","AAA02","13","195000","29900","165100","2020-10-15 15:54:32"
"1937","16","20201015010559","PC","AAA02","4","60000","9200","50800","2020-10-15 13:05:59"
"1938","91","20201015123112","PC","AAA05","3","180000","60000","120000","2020-10-15 12:31:12"
"1939","86","20201015111720","PC","AAA03","4","68000","12000","56000","2020-10-15 11:17:20"
"1940","8","20201015094649","Shop","AAA02","2","30000","4600","25400","2020-10-15 09:46:49"
"1941","74","20201015084033","PC","AAA01","5","50000","10000","40000","2020-10-15 08:40:33"
"1942","5","20201015081034","Shop","AAA05","7","420000","140000","280000","2020-10-15 08:10:34"
"1943","81","20201015072452","Mobile","AAA04","2","16000","800","15200","2020-10-15 07:24:52"
"1944","47","20201014081137","Mobile","AAA03","16","272000","48000","224000","2020-10-14 20:11:37"
"1945","52","20201014034241","Mobile","AAA02","2","30000","4600","25400","2020-10-14 15:42:41"
"1946","4","20201014024951","Shop","AAA05","8","480000","160000","320000","2020-10-14 14:49:51"
"1947","4","20201014125340","PC","AAA03","8","136000","24000","112000","2020-10-14 12:53:40"
"1948","77","20201014105728","PC","AAA01","11","110000","22000","88000","2020-10-14 10:57:28"
"1949","29","20201014103509","Mobile","AAA02","6","90000","13800","76200","2020-10-14 10:35:09"
"1950","42","20201014093808","PC","AAA02","17","255000","39100","215900","2020-10-14 09:38:08"
"1951","34","20201014085057","PC","AAA05","8","480000","160000","320000","2020-10-14 08:50:57"
"1952","44","20201014080235","PC","AAA05","2","120000","40000","80000","2020-10-14 08:02:35"
"1953","50","20201014065522","Shop","AAA04","20","160000","8000","152000","2020-10-14 06:55:22"
"1954","64","20201014121757","Shop","AAA04","4","32000","1600","30400","2020-10-14 00:17:57"
"1955","82","20201013054730","PC","AAA02","5","75000","11500","63500","2020-10-13 17:47:30"
"1956","43","20201013044449","Shop","AAA05","1","60000","20000","40000","2020-10-13 16:44:49"
"1957","72","20201013033806","Mobile","AAA05","10","600000","200000","400000","2020-10-13 15:38:06"
"1958","48","20201013031347","Shop","AAA01","3","30000","6000","24000","2020-10-13 15:13:47"
"1959","80","20201013014038","Shop","AAA03","2","34000","6000","28000","2020-10-13 13:40:38"
"1960","77","20201013122323","PC","AAA04","6","48000","2400","45600","2020-10-13 12:23:23"
"1961","88","20201013114301","Shop","AAA02","6","90000","13800","76200","2020-10-13 11:43:01"
"1962","58","20201013104456","Mobile","AAA02","12","180000","27600","152400","2020-10-13 10:44:56"
"1963","52","20201013094623","PC","AAA03","2","34000","6000","28000","2020-10-13 09:46:23"
"1964","66","20201013090337","PC","AAA02","1","15000","2300","12700","2020-10-13 09:03:37"
"1965","96","20201012065952","PC","AAA01","4","40000","8000","32000","2020-10-12 18:59:52"
"1966","4","20201012053503","Mobile","AAA02","2","30000","4600","25400","2020-10-12 17:35:03"
"1967","58","20201012040829","Mobile","AAA02","1","15000","2300","12700","2020-10-12 16:08:29"
"1968","5","20201012025104","PC","AAA01","14","140000","28000","112000","2020-10-12 14:51:04"
"1969","70","20201012014735","Shop","AAA05","12","720000","240000","480000","2020-10-12 13:47:35"
"1970","58","20201012124325","PC","AAA02","9","135000","20700","114300","2020-10-12 12:43:25"
"1971","67","20201012114627","Mobile","AAA04","4","32000","1600","30400","2020-10-12 11:46:27"
"1972","55","20201012103803","PC","AAA02","7","105000","16100","88900","2020-10-12 10:38:03"
"1973","51","20201012090534","Mobile","AAA02","11","165000","25300","139700","2020-10-12 09:05:34"
"1974","96","20201009064847","Mobile","AAA04","10","80000","4000","76000","2020-10-09 06:48:47"
"1975","15","20201008032707","Shop","AAA01","13","130000","26000","104000","2020-10-08 15:27:07"
"1976","49","20201008020850","Shop","AAA05","9","540000","180000","360000","2020-10-08 14:08:50"
"1977","31","20201008113533","Shop","AAA05","16","960000","320000","640000","2020-10-08 11:35:33"
"1978","58","20201008104404","Shop","AAA04","4","32000","1600","30400","2020-10-08 10:44:04"
"1979","50","20201008084646","Shop","AAA01","9","90000","18000","72000","2020-10-08 08:46:46"
"1980","70","20201008072318","Shop","AAA05","7","420000","140000","280000","2020-10-08 07:23:18"
"1981","32","20201007071334","Shop","AAA02","11","165000","25300","139700","2020-10-07 19:13:34"
"1982","3","20201007023547","Mobile","AAA05","4","240000","80000","160000","2020-10-07 14:35:47"
"1983","36","20201007124644","Shop","AAA01","15","150000","30000","120000","2020-10-07 12:46:44"
"1984","87","20201007113815","Shop","AAA02","3","45000","6900","38100","2020-10-07 11:38:15"
"1985","48","20201007104542","Shop","AAA01","5","50000","10000","40000","2020-10-07 10:45:42"
"1986","17","20201007093035","Mobile","AAA01","2","20000","4000","16000","2020-10-07 09:30:35"
"1987","33","20201007083349","Shop","AAA02","1","15000","2300","12700","2020-10-07 08:33:49"
"1988","18","20201007074120","Mobile","AAA02","4","60000","9200","50800","2020-10-07 07:41:20"
"1989","17","20201006055112","Mobile","AAA04","1","8000","400","7600","2020-10-06 17:51:12"
"1990","7","20201006044610","Shop","AAA03","2","34000","6000","28000","2020-10-06 16:46:10"
"1991","95","20201006040424","PC","AAA04","7","56000","2800","53200","2020-10-06 16:04:24"
"1992","51","20201006024420","Shop","AAA03","10","170000","30000","140000","2020-10-06 14:44:20"
"1993","32","20201006020236","Shop","AAA04","19","152000","7600","144400","2020-10-06 14:02:36"
"1994","52","20201006011426","Mobile","AAA05","6","360000","120000","240000","2020-10-06 13:14:26"
"1995","72","20201006112653","Mobile","AAA03","6","102000","18000","84000","2020-10-06 11:26:53"
"1996","75","20201006101807","PC","AAA01","1","10000","2000","8000","2020-10-06 10:18:07"
"1997","16","20201006085458","Mobile","AAA02","23","345000","52900","292100","2020-10-06 08:54:58"
"1998","40","20201006075411","Mobile","AAA01","4","40000","8000","32000","2020-10-06 07:54:11"
"1999","86","20201006014600","Mobile","AAA02","4","60000","9200","50800","2020-10-06 01:46:00"
"2000","85","20201005010259","Shop","AAA05","1","60000","20000","40000","2020-10-05 13:02:59"
"2001","39","20201005122318","PC","AAA04","7","56000","2800","53200","2020-10-05 12:23:18"
"2002","17","20201005111247","PC","AAA04","1","8000","400","7600","2020-10-05 11:12:47"
"2003","5","20201005102132","Shop","AAA01","6","60000","12000","48000","2020-10-05 10:21:32"
"2004","95","20201005094607","PC","AAA03","4","68000","12000","56000","2020-10-05 09:46:07"
"2005","14","20201002120522","Shop","AAA03","6","102000","18000","84000","2020-10-02 00:05:22"
"2006","50","20201001085915","Mobile","AAA02","13","195000","29900","165100","2020-10-01 20:59:15"
"2007","38","20201001055043","Mobile","AAA05","14","840000","280000","560000","2020-10-01 17:50:43"
"2008","35","20201001043343","Mobile","AAA01","1","10000","2000","8000","2020-10-01 16:33:43"
"2009","34","20201001032317","Shop","AAA03","13","221000","39000","182000","2020-10-01 15:23:17"
"2010","80","20201001021601","Mobile","AAA02","5","75000","11500","63500","2020-10-01 14:16:01"
"2011","90","20201001011712","Shop","AAA04","1","8000","400","7600","2020-10-01 13:17:12"
"2012","41","20201001123226","PC","AAA03","13","221000","39000","182000","2020-10-01 12:32:26"
"2013","38","20201001102518","Mobile","AAA04","9","72000","3600","68400","2020-10-01 10:25:18"
"2014","61","20201001064124","Mobile","AAA05","3","180000","60000","120000","2020-10-01 06:41:24"
"2015","78","20200930082642","Mobile","AAA04","7","56000","2800","53200","2020-09-30 20:26:42"
"2016","19","20200930062108","Mobile","AAA02","5","75000","11500","63500","2020-09-30 18:21:08"
"2017","3","20200930024557","Mobile","AAA04","15","120000","6000","114000","2020-09-30 14:45:57"
"2018","85","20200930015328","PC","AAA02","8","120000","18400","101600","2020-09-30 13:53:28"
"2019","70","20200930123950","Mobile","AAA03","17","289000","51000","238000","2020-09-30 12:39:50"
"2020","68","20200930105228","Shop","AAA05","6","360000","120000","240000","2020-09-30 10:52:28"
"2021","41","20200930093748","PC","AAA02","1","15000","2300","12700","2020-09-30 09:37:48"
"2022","52","20200930084734","Mobile","AAA01","4","40000","8000","32000","2020-09-30 08:47:34"
"2023","74","20200930074543","PC","AAA04","3","24000","1200","22800","2020-09-30 07:45:43"
"2024","52","20200929090557","Shop","AAA04","7","56000","2800","53200","2020-09-29 21:05:57"
"2025","4","20200929051108","Shop","AAA05","3","180000","60000","120000","2020-09-29 17:11:08"
"2026","69","20200929033208","Shop","AAA01","6","60000","12000","48000","2020-09-29 15:32:08"
"2027","32","20200929124549","Mobile","AAA01","8","80000","16000","64000","2020-09-29 12:45:49"
"2028","94","20200929111726","Shop","AAA03","16","272000","48000","224000","2020-09-29 11:17:26"
"2029","5","20200929100519","Shop","AAA01","17","170000","34000","136000","2020-09-29 10:05:19"
"2030","25","20200929084837","Shop","AAA01","8","80000","16000","64000","2020-09-29 08:48:37"
"2031","90","20200929074716","Mobile","AAA03","4","68000","12000","56000","2020-09-29 07:47:16"
"2032","26","20200928031245","Shop","AAA02","1","15000","2300","12700","2020-09-28 15:12:45"
"2033","36","20200928021136","Shop","AAA04","23","184000","9200","174800","2020-09-28 14:11:36"
"2034","93","20200928012107","Shop","AAA03","3","51000","9000","42000","2020-09-28 13:21:07"
"2035","96","20200928122119","Shop","AAA01","14","140000","28000","112000","2020-09-28 12:21:19"
"2036","28","20200928114420","Mobile","AAA02","9","135000","20700","114300","2020-09-28 11:44:20"
"2037","81","20200928102703","Mobile","AAA01","3","30000","6000","24000","2020-09-28 10:27:03"
"2038","85","20200925115420","PC","AAA04","2","16000","800","15200","2020-09-25 11:54:20"
"2039","67","20200925102933","Mobile","AAA02","3","45000","6900","38100","2020-09-25 10:29:33"
"2040","69","20200925092048","Shop","AAA02","3","45000","6900","38100","2020-09-25 09:20:48"
"2041","90","20200925082114","PC","AAA05","2","120000","40000","80000","2020-09-25 08:21:14"
"2042","3","20200925072404","PC","AAA05","24","1440000","480000","960000","2020-09-25 07:24:04"
"2043","79","20200924091125","Mobile","AAA04","4","32000","1600","30400","2020-09-24 21:11:25"
"2044","17","20200924054614","Shop","AAA03","7","119000","21000","98000","2020-09-24 17:46:14"
"2045","33","20200924043628","Shop","AAA03","6","102000","18000","84000","2020-09-24 16:36:28"
"2046","85","20200924020025","Shop","AAA01","12","120000","24000","96000","2020-09-24 14:00:25"
"2047","27","20200924125754","PC","AAA05","8","480000","160000","320000","2020-09-24 12:57:54"
"2048","69","20200924114610","Mobile","AAA05","5","300000","100000","200000","2020-09-24 11:46:10"
"2049","24","20200924095729","Mobile","AAA02","6","90000","13800","76200","2020-09-24 09:57:29"
"2050","22","20200924074340","Mobile","AAA01","4","40000","8000","32000","2020-09-24 07:43:40"
"2051","37","20200924014928","Shop","AAA02","6","90000","13800","76200","2020-09-24 01:49:28"
"2052","23","20200923013324","Mobile","AAA01","7","70000","14000","56000","2020-09-23 13:33:24"
"2053","53","20200923010416","PC","AAA01","4","40000","8000","32000","2020-09-23 13:04:16"
"2054","23","20200923115251","Mobile","AAA05","13","780000","260000","520000","2020-09-23 11:52:51"
"2055","73","20200923112442","Mobile","AAA02","7","105000","16100","88900","2020-09-23 11:24:42"
"2056","66","20200923105637","Shop","AAA01","4","40000","8000","32000","2020-09-23 10:56:37"
"2057","29","20200923093925","Shop","AAA03","11","187000","33000","154000","2020-09-23 09:39:25"
"2058","71","20200923080909","PC","AAA03","4","68000","12000","56000","2020-09-23 08:09:09"
"2059","20","20200923070349","Mobile","AAA05","4","240000","80000","160000","2020-09-23 07:03:49"
"2060","44","20200922044533","Mobile","AAA05","3","180000","60000","120000","2020-09-22 16:45:33"
"2061","42","20200922030906","Shop","AAA03","8","136000","24000","112000","2020-09-22 15:09:06"
"2062","1","20200922110804","Mobile","AAA02","14","210000","32200","177800","2020-09-22 11:08:04"
"2063","44","20200922091349","Shop","AAA05","5","300000","100000","200000","2020-09-22 09:13:49"
"2064","54","20200922080106","PC","AAA05","4","240000","80000","160000","2020-09-22 08:01:06"
"2065","21","20200922064308","Shop","AAA05","14","840000","280000","560000","2020-09-22 06:43:08"
"2066","11","20200921095521","Mobile","AAA05","20","1200000","400000","800000","2020-09-21 21:55:21"
"2067","92","20200921041551","PC","AAA04","9","72000","3600","68400","2020-09-21 16:15:51"
"2068","19","20200921032244","PC","AAA01","4","40000","8000","32000","2020-09-21 15:22:44"
"2069","75","20200921023636","PC","AAA02","3","45000","6900","38100","2020-09-21 14:36:36"
"2070","58","20200921125539","Shop","AAA04","13","104000","5200","98800","2020-09-21 12:55:39"
"2071","17","20200921110642","Shop","AAA01","10","100000","20000","80000","2020-09-21 11:06:42"
"2072","41","20200921094536","Mobile","AAA04","8","64000","3200","60800","2020-09-21 09:45:36"
"2073","71","20200919012200","Mobile","AAA04","11","88000","4400","83600","2020-09-19 01:22:00"
"2074","89","20200918013400","Shop","AAA02","5","75000","11500","63500","2020-09-18 13:34:00"
"2075","52","20200918121041","Mobile","AAA03","4","68000","12000","56000","2020-09-18 12:10:41"
"2076","21","20200918103957","Shop","AAA01","12","120000","24000","96000","2020-09-18 10:39:57"
"2077","9","20200918093414","PC","AAA05","7","420000","140000","280000","2020-09-18 09:34:14"
"2078","59","20200918075402","Shop","AAA04","1","8000","400","7600","2020-09-18 07:54:02"
"2079","35","20200917114737","PC","AAA03","1","17000","3000","14000","2020-09-17 23:47:37"
"2080","85","20200917121401","Mobile","AAA01","11","110000","22000","88000","2020-09-17 12:14:01"
"2081","26","20200917113625","PC","AAA05","7","420000","140000","280000","2020-09-17 11:36:25"
"2082","95","20200917094358","PC","AAA03","2","34000","6000","28000","2020-09-17 09:43:58"
"2083","5","20200917072348","PC","AAA03","6","102000","18000","84000","2020-09-17 07:23:48"
"2084","15","20200916033452","Mobile","AAA01","22","220000","44000","176000","2020-09-16 15:34:52"
"2085","9","20200916024442","Mobile","AAA01","12","120000","24000","96000","2020-09-16 14:44:42"
"2086","83","20200916014539","PC","AAA04","3","24000","1200","22800","2020-09-16 13:45:39"
"2087","100","20200916123110","Mobile","AAA02","4","60000","9200","50800","2020-09-16 12:31:10"
"2088","34","20200916112634","Shop","AAA04","11","88000","4400","83600","2020-09-16 11:26:34"
"2089","13","20200916095720","Shop","AAA03","4","68000","12000","56000","2020-09-16 09:57:20"
"2090","81","20200916090604","PC","AAA04","6","48000","2400","45600","2020-09-16 09:06:04"
"2091","93","20200916074857","Shop","AAA01","4","40000","8000","32000","2020-09-16 07:48:57"
"2092","12","20200915091944","Mobile","AAA05","1","60000","20000","40000","2020-09-15 21:19:44"
"2093","48","20200915043533","Mobile","AAA04","8","64000","3200","60800","2020-09-15 16:35:33"
"2094","57","20200915033556","Shop","AAA04","10","80000","4000","76000","2020-09-15 15:35:56"
"2095","40","20200915124327","Mobile","AAA04","3","24000","1200","22800","2020-09-15 12:43:27"
"2096","4","20200915112536","Mobile","AAA04","8","64000","3200","60800","2020-09-15 11:25:36"
"2097","60","20200915103411","Shop","AAA05","4","240000","80000","160000","2020-09-15 10:34:11"
"2098","24","20200915092719","PC","AAA05","5","300000","100000","200000","2020-09-15 09:27:19"
"2099","53","20200915080340","Shop","AAA04","5","40000","2000","38000","2020-09-15 08:03:40"
"2100","26","20200915063831","Mobile","AAA02","4","60000","9200","50800","2020-09-15 06:38:31"
"2101","84","20200914042721","Mobile","AAA04","6","48000","2400","45600","2020-09-14 16:27:21"
"2102","5","20200914034744","Shop","AAA01","2","20000","4000","16000","2020-09-14 15:47:44"
"2103","23","20200914021032","Shop","AAA05","14","840000","280000","560000","2020-09-14 14:10:32"
"2104","69","20200914014718","Shop","AAA05","6","360000","120000","240000","2020-09-14 13:47:18"
"2105","21","20200914010502","Shop","AAA01","15","150000","30000","120000","2020-09-14 13:05:02"
"2106","20","20200914115219","Mobile","AAA03","1","17000","3000","14000","2020-09-14 11:52:19"
"2107","2","20200914104252","PC","AAA05","3","180000","60000","120000","2020-09-14 10:42:52"
"2108","37","20200911073027","PC","AAA05","14","840000","280000","560000","2020-09-11 07:30:27"
"2109","19","20200911033350","PC","AAA01","5","50000","10000","40000","2020-09-11 03:33:50"
"2110","24","20200910033952","Mobile","AAA02","2","30000","4600","25400","2020-09-10 15:39:52"
"2111","38","20200910022748","PC","AAA05","8","480000","160000","320000","2020-09-10 14:27:48"
"2112","8","20200910011329","Mobile","AAA02","11","165000","25300","139700","2020-09-10 13:13:29"
"2113","25","20200910110843","Mobile","AAA02","1","15000","2300","12700","2020-09-10 11:08:43"
"2114","68","20200910090947","Mobile","AAA02","2","30000","4600","25400","2020-09-10 09:09:47"
"2115","99","20200910075449","Mobile","AAA03","7","119000","21000","98000","2020-09-10 07:54:49"
"2116","12","20200909084438","PC","AAA01","2","20000","4000","16000","2020-09-09 20:44:38"
"2117","20","20200909030400","Mobile","AAA05","5","300000","100000","200000","2020-09-09 15:04:00"
"2118","15","20200909020456","Mobile","AAA05","19","1140000","380000","760000","2020-09-09 14:04:56"
"2119","22","20200909125120","Shop","AAA05","9","540000","180000","360000","2020-09-09 12:51:20"
"2120","83","20200909121549","Shop","AAA05","10","600000","200000","400000","2020-09-09 12:15:49"
"2121","33","20200909103417","Mobile","AAA03","8","136000","24000","112000","2020-09-09 10:34:17"
"2122","56","20200909083640","PC","AAA03","8","136000","24000","112000","2020-09-09 08:36:40"
"2123","36","20200909075406","Shop","AAA03","9","153000","27000","126000","2020-09-09 07:54:06"
"2124","90","20200908113211","Shop","AAA05","1","60000","20000","40000","2020-09-08 23:32:11"
"2125","23","20200908031944","PC","AAA02","6","90000","13800","76200","2020-09-08 15:19:44"
"2126","24","20200908030657","PC","AAA05","2","120000","40000","80000","2020-09-08 15:06:57"
"2127","30","20200908022132","Mobile","AAA04","7","56000","2800","53200","2020-09-08 14:21:32"
"2128","10","20200908011952","PC","AAA02","6","90000","13800","76200","2020-09-08 13:19:52"
"2129","45","20200908114544","Shop","AAA03","2","34000","6000","28000","2020-09-08 11:45:44"
"2130","59","20200908100953","Shop","AAA03","1","17000","3000","14000","2020-09-08 10:09:53"
"2131","81","20200908081926","Mobile","AAA01","4","40000","8000","32000","2020-09-08 08:19:26"
"2132","49","20200908070953","Shop","AAA03","6","102000","18000","84000","2020-09-08 07:09:53"
"2133","50","20200907115800","Shop","AAA03","14","238000","42000","196000","2020-09-07 23:58:00"
"2134","54","20200907100136","Shop","AAA01","2","20000","4000","16000","2020-09-07 10:01:36"
"2135","58","20200907084919","Shop","AAA04","2","16000","800","15200","2020-09-07 08:49:19"
"2136","78","20200903050339","PC","AAA04","8","64000","3200","60800","2020-09-03 17:03:39"
"2137","57","20200903032123","PC","AAA03","3","51000","9000","42000","2020-09-03 15:21:23"
"2138","43","20200903015916","Shop","AAA02","9","135000","20700","114300","2020-09-03 13:59:16"
"2139","13","20200903011848","Mobile","AAA04","2","16000","800","15200","2020-09-03 13:18:48"
"2140","11","20200903114206","Mobile","AAA02","14","210000","32200","177800","2020-09-03 11:42:06"
"2141","68","20200903093701","Mobile","AAA04","18","144000","7200","136800","2020-09-03 09:37:01"
"2142","50","20200903081808","Shop","AAA02","16","240000","36800","203200","2020-09-03 08:18:08"
"2143","68","20200903070347","Mobile","AAA01","2","20000","4000","16000","2020-09-03 07:03:47"
"2144","33","20200902045421","PC","AAA02","6","90000","13800","76200","2020-09-02 16:54:21"
"2145","55","20200902041801","PC","AAA05","7","420000","140000","280000","2020-09-02 16:18:01"
"2146","92","20200902025011","PC","AAA05","13","780000","260000","520000","2020-09-02 14:50:11"
"2147","28","20200902010123","PC","AAA04","4","32000","1600","30400","2020-09-02 13:01:23"
"2148","68","20200902114439","Mobile","AAA03","5","85000","15000","70000","2020-09-02 11:44:39"
"2149","77","20200902110028","PC","AAA01","2","20000","4000","16000","2020-09-02 11:00:28"
"2150","7","20200902093931","Shop","AAA02","6","90000","13800","76200","2020-09-02 09:39:31"
"2151","67","20200902090809","Shop","AAA03","7","119000","21000","98000","2020-09-02 09:08:09"
"2152","23","20200902075008","PC","AAA01","7","70000","14000","56000","2020-09-02 07:50:08"
"2153","38","20200902024359","PC","AAA02","9","135000","20700","114300","2020-09-02 02:43:59"
"2154","19","20200901070644","Shop","AAA04","6","48000","2400","45600","2020-09-01 19:06:44"
"2155","25","20200901035643","Shop","AAA05","10","600000","200000","400000","2020-09-01 15:56:43"
"2156","98","20200901124806","Mobile","AAA05","7","420000","140000","280000","2020-09-01 12:48:06"
"2157","22","20200901114938","PC","AAA01","9","90000","18000","72000","2020-09-01 11:49:38"
"2158","94","20200901111436","Mobile","AAA02","5","75000","11500","63500","2020-09-01 11:14:36"
"2159","45","20200901082812","Shop","AAA02","8","120000","18400","101600","2020-09-01 08:28:12"
"2160","57","20200901072457","PC","AAA01","2","20000","4000","16000","2020-09-01 07:24:57"
"2161","49","20200831040508","Mobile","AAA04","11","88000","4400","83600","2020-08-31 16:05:08"
"2162","48","20200831024245","Shop","AAA01","4","40000","8000","32000","2020-08-31 14:42:45"
"2163","45","20200831021004","Mobile","AAA04","9","72000","3600","68400","2020-08-31 14:10:04"
"2164","55","20200831114309","PC","AAA05","14","840000","280000","560000","2020-08-31 11:43:09"
"2165","87","20200831103252","Mobile","AAA02","5","75000","11500","63500","2020-08-31 10:32:52"
"2166","36","20200829113836","Mobile","AAA02","6","90000","13800","76200","2020-08-29 23:38:36"
"2167","81","20200829010646","Shop","AAA05","7","420000","140000","280000","2020-08-29 01:06:46"
"2168","9","20200828064708","Shop","AAA04","6","48000","2400","45600","2020-08-28 06:47:08"
"2169","68","20200827035244","Shop","AAA01","8","80000","16000","64000","2020-08-27 15:52:44"
"2170","48","20200827025609","Mobile","AAA01","12","120000","24000","96000","2020-08-27 14:56:09"
"2171","83","20200827020438","PC","AAA03","7","119000","21000","98000","2020-08-27 14:04:38"
"2172","93","20200827123429","Shop","AAA03","10","170000","30000","140000","2020-08-27 12:34:29"
"2173","55","20200827094938","PC","AAA01","5","50000","10000","40000","2020-08-27 09:49:38"
"2174","2","20200827090159","Mobile","AAA02","4","60000","9200","50800","2020-08-27 09:01:59"
"2175","64","20200827080916","PC","AAA02","11","165000","25300","139700","2020-08-27 08:09:16"
"2176","93","20200827062622","Mobile","AAA05","1","60000","20000","40000","2020-08-27 06:26:22"
"2177","32","20200826055522","PC","AAA01","5","50000","10000","40000","2020-08-26 17:55:22"
"2178","99","20200826045028","PC","AAA01","3","30000","6000","24000","2020-08-26 16:50:28"
"2179","19","20200826032530","Shop","AAA05","3","180000","60000","120000","2020-08-26 15:25:30"
"2180","98","20200826021610","Shop","AAA05","3","180000","60000","120000","2020-08-26 14:16:10"
"2181","11","20200826012435","Mobile","AAA04","13","104000","5200","98800","2020-08-26 13:24:35"
"2182","5","20200826123624","PC","AAA02","4","60000","9200","50800","2020-08-26 12:36:24"
"2183","95","20200826115602","Mobile","AAA04","2","16000","800","15200","2020-08-26 11:56:02"
"2184","64","20200826092922","PC","AAA05","6","360000","120000","240000","2020-08-26 09:29:22"
"2185","45","20200826081812","PC","AAA03","5","85000","15000","70000","2020-08-26 08:18:12"
"2186","15","20200826070003","Mobile","AAA03","13","221000","39000","182000","2020-08-26 07:00:03"
"2187","34","20200825032441","Shop","AAA05","13","780000","260000","520000","2020-08-25 15:24:41"
"2188","72","20200825023217","Mobile","AAA02","5","75000","11500","63500","2020-08-25 14:32:17"
"2189","69","20200825010722","Mobile","AAA04","1","8000","400","7600","2020-08-25 13:07:22"
"2190","36","20200825105537","Mobile","AAA03","5","85000","15000","70000","2020-08-25 10:55:37"
"2191","81","20200825092927","Shop","AAA02","4","60000","9200","50800","2020-08-25 09:29:27"
"2192","83","20200825081448","Shop","AAA03","6","102000","18000","84000","2020-08-25 08:14:48"
"2193","55","20200825064552","Mobile","AAA03","6","102000","18000","84000","2020-08-25 06:45:52"
"2194","9","20200824113306","Shop","AAA03","5","85000","15000","70000","2020-08-24 23:33:06"
"2195","40","20200824054634","Mobile","AAA04","3","24000","1200","22800","2020-08-24 17:46:34"
"2196","46","20200824045859","PC","AAA01","19","190000","38000","152000","2020-08-24 16:58:59"
"2197","8","20200824030758","Shop","AAA02","4","60000","9200","50800","2020-08-24 15:07:58"
"2198","3","20200824023712","PC","AAA03","12","204000","36000","168000","2020-08-24 14:37:12"
"2199","22","20200824110726","PC","AAA01","6","60000","12000","48000","2020-08-24 11:07:26"
"2200","80","20200824095946","Shop","AAA02","1","15000","2300","12700","2020-08-24 09:59:46"
"2201","74","20200822022055","Mobile","AAA01","5","50000","10000","40000","2020-08-22 02:20:55"
"2202","36","20200821120542","Mobile","AAA04","12","96000","4800","91200","2020-08-21 12:05:42"
"2203","90","20200821100720","Shop","AAA02","1","15000","2300","12700","2020-08-21 10:07:20"
"2204","15","20200821082523","Shop","AAA05","11","660000","220000","440000","2020-08-21 08:25:23"
"2205","79","20200820100802","Mobile","AAA01","3","30000","6000","24000","2020-08-20 22:08:02"
"2206","38","20200820070057","Mobile","AAA02","6","90000","13800","76200","2020-08-20 19:00:57"
"2207","12","20200820024104","Mobile","AAA02","4","60000","9200","50800","2020-08-20 14:41:04"
"2208","79","20200820013503","Mobile","AAA05","4","240000","80000","160000","2020-08-20 13:35:03"
"2209","97","20200820120848","Mobile","AAA01","12","120000","24000","96000","2020-08-20 12:08:48"
"2210","42","20200820085948","Shop","AAA03","14","238000","42000","196000","2020-08-20 08:59:48"
"2211","68","20200819113228","Mobile","AAA03","3","51000","9000","42000","2020-08-19 23:32:28"
"2212","94","20200819032637","Mobile","AAA04","10","80000","4000","76000","2020-08-19 15:26:37"
"2213","83","20200819013240","Shop","AAA04","7","56000","2800","53200","2020-08-19 13:32:40"
"2214","3","20200819123214","Mobile","AAA01","13","130000","26000","104000","2020-08-19 12:32:14"
"2215","31","20200819120534","PC","AAA01","3","30000","6000","24000","2020-08-19 12:05:34"
"2216","65","20200819105916","PC","AAA01","10","100000","20000","80000","2020-08-19 10:59:16"
"2217","12","20200819095505","Mobile","AAA04","8","64000","3200","60800","2020-08-19 09:55:05"
"2218","6","20200819063000","Shop","AAA02","4","60000","9200","50800","2020-08-19 06:30:00"
"2219","38","20200818082027","PC","AAA01","8","80000","16000","64000","2020-08-18 20:20:27"
"2220","16","20200818053655","Shop","AAA04","11","88000","4400","83600","2020-08-18 17:36:55"
"2221","2","20200818041802","Shop","AAA05","1","60000","20000","40000","2020-08-18 16:18:02"
"2222","22","20200818025353","Mobile","AAA04","7","56000","2800","53200","2020-08-18 14:53:53"
"2223","33","20200818122802","Mobile","AAA05","5","300000","100000","200000","2020-08-18 12:28:02"
"2224","9","20200818111656","Shop","AAA02","5","75000","11500","63500","2020-08-18 11:16:56"
"2225","93","20200818093423","Shop","AAA05","4","240000","80000","160000","2020-08-18 09:34:23"
"2226","97","20200818083619","Shop","AAA03","4","68000","12000","56000","2020-08-18 08:36:19"
"2227","28","20200818073126","Mobile","AAA05","11","660000","220000","440000","2020-08-18 07:31:26"
"2228","11","20200818012009","Mobile","AAA01","11","110000","22000","88000","2020-08-18 01:20:09"
"2229","74","20200817023803","PC","AAA01","2","20000","4000","16000","2020-08-17 14:38:03"
"2230","84","20200817120601","Shop","AAA05","3","180000","60000","120000","2020-08-17 12:06:01"
"2231","61","20200817112520","Shop","AAA02","3","45000","6900","38100","2020-08-17 11:25:20"
"2232","27","20200817110149","PC","AAA03","13","221000","39000","182000","2020-08-17 11:01:49"
"2233","52","20200817095835","Shop","AAA01","1","10000","2000","8000","2020-08-17 09:58:35"
"2234","32","20200813055730","Shop","AAA02","12","180000","27600","152400","2020-08-13 17:57:30"
"2235","11","20200813043507","Shop","AAA05","11","660000","220000","440000","2020-08-13 16:35:07"
"2236","1","20200813020234","Shop","AAA05","7","420000","140000","280000","2020-08-13 14:02:34"
"2237","67","20200813120849","Shop","AAA02","18","270000","41400","228600","2020-08-13 12:08:49"
"2238","19","20200813111322","Mobile","AAA03","1","17000","3000","14000","2020-08-13 11:13:22"
"2239","46","20200813085153","Mobile","AAA01","7","70000","14000","56000","2020-08-13 08:51:53"
"2240","81","20200813074025","Shop","AAA04","6","48000","2400","45600","2020-08-13 07:40:25"
"2241","80","20200812024053","PC","AAA05","8","480000","160000","320000","2020-08-12 14:40:53"
"2242","2","20200812020210","Mobile","AAA05","6","360000","120000","240000","2020-08-12 14:02:10"
"2243","94","20200812125907","Shop","AAA01","5","50000","10000","40000","2020-08-12 12:59:07"
"2244","44","20200812120345","PC","AAA05","2","120000","40000","80000","2020-08-12 12:03:45"
"2245","63","20200812094844","Mobile","AAA02","7","105000","16100","88900","2020-08-12 09:48:44"
"2246","50","20200812083001","PC","AAA05","5","300000","100000","200000","2020-08-12 08:30:01"
"2247","26","20200812071044","Shop","AAA01","1","10000","2000","8000","2020-08-12 07:10:44"
"2248","3","20200812120024","PC","AAA03","3","51000","9000","42000","2020-08-12 00:00:24"
"2249","57","20200811040029","Shop","AAA02","3","45000","6900","38100","2020-08-11 16:00:29"
"2250","99","20200811025410","Shop","AAA02","2","30000","4600","25400","2020-08-11 14:54:10"
"2251","87","20200811013303","Mobile","AAA01","6","60000","12000","48000","2020-08-11 13:33:03"
"2252","52","20200811121512","Mobile","AAA04","2","16000","800","15200","2020-08-11 12:15:12"
"2253","58","20200811105653","PC","AAA05","7","420000","140000","280000","2020-08-11 10:56:53"
"2254","42","20200811100452","Mobile","AAA02","8","120000","18400","101600","2020-08-11 10:04:52"
"2255","96","20200811091838","PC","AAA04","6","48000","2400","45600","2020-08-11 09:18:38"
"2256","57","20200811073617","Mobile","AAA05","8","480000","160000","320000","2020-08-11 07:36:17"
"2257","89","20200810015745","Shop","AAA05","25","1500000","500000","1000000","2020-08-10 13:57:45"
"2258","56","20200810122102","PC","AAA05","2","120000","40000","80000","2020-08-10 12:21:02"
"2259","16","20200810104519","Shop","AAA01","6","60000","12000","48000","2020-08-10 10:45:19"
"2260","19","20200810092246","Mobile","AAA04","4","32000","1600","30400","2020-08-10 09:22:46"
"2261","20","20200807065155","Mobile","AAA05","8","480000","160000","320000","2020-08-07 18:51:55"
"2262","16","20200807030828","PC","AAA05","15","900000","300000","600000","2020-08-07 15:08:28"
"2263","22","20200807121642","Mobile","AAA03","8","136000","24000","112000","2020-08-07 12:16:42"
"2264","47","20200807101501","Mobile","AAA02","8","120000","18400","101600","2020-08-07 10:15:01"
"2265","100","20200807085452","PC","AAA05","7","420000","140000","280000","2020-08-07 08:54:52"
"2266","56","20200807072048","PC","AAA01","10","100000","20000","80000","2020-08-07 07:20:48"
"2267","45","20200807124553","Mobile","AAA05","1","60000","20000","40000","2020-08-07 00:45:53"
"2268","83","20200806035920","Mobile","AAA03","8","136000","24000","112000","2020-08-06 15:59:20"
"2269","31","20200806030259","Mobile","AAA01","2","20000","4000","16000","2020-08-06 15:02:59"
"2270","47","20200806014046","PC","AAA03","11","187000","33000","154000","2020-08-06 13:40:46"
"2271","35","20200806123858","Shop","AAA05","7","420000","140000","280000","2020-08-06 12:38:58"
"2272","82","20200806110143","PC","AAA05","6","360000","120000","240000","2020-08-06 11:01:43"
"2273","24","20200806094821","Shop","AAA04","5","40000","2000","38000","2020-08-06 09:48:21"
"2274","38","20200806085922","Mobile","AAA01","17","170000","34000","136000","2020-08-06 08:59:22"
"2275","20","20200806075139","Mobile","AAA03","7","119000","21000","98000","2020-08-06 07:51:39"
"2276","70","20200805092128","PC","AAA01","14","140000","28000","112000","2020-08-05 21:21:28"
"2277","11","20200805054043","Shop","AAA04","5","40000","2000","38000","2020-08-05 17:40:43"
"2278","49","20200805041952","PC","AAA04","8","64000","3200","60800","2020-08-05 16:19:52"
"2279","72","20200805031245","PC","AAA05","13","780000","260000","520000","2020-08-05 15:12:45"
"2280","17","20200805020740","Mobile","AAA04","2","16000","800","15200","2020-08-05 14:07:40"
"2281","15","20200805010424","PC","AAA05","11","660000","220000","440000","2020-08-05 13:04:24"
"2282","51","20200805120402","Shop","AAA01","9","90000","18000","72000","2020-08-05 12:04:02"
"2283","15","20200805105657","Mobile","AAA03","15","255000","45000","210000","2020-08-05 10:56:57"
"2284","59","20200805092849","Shop","AAA03","9","153000","27000","126000","2020-08-05 09:28:49"
"2285","21","20200805080522","Shop","AAA02","22","330000","50600","279400","2020-08-05 08:05:22"
"2286","92","20200805063627","Mobile","AAA03","14","238000","42000","196000","2020-08-05 06:36:27"
"2287","89","20200804073557","Shop","AAA03","10","170000","30000","140000","2020-08-04 19:35:57"
"2288","93","20200804032937","PC","AAA02","4","60000","9200","50800","2020-08-04 15:29:37"
"2289","30","20200804124904","Mobile","AAA05","9","540000","180000","360000","2020-08-04 12:49:04"
"2290","49","20200804114836","Mobile","AAA04","17","136000","6800","129200","2020-08-04 11:48:36"
"2291","83","20200804112713","PC","AAA02","5","75000","11500","63500","2020-08-04 11:27:13"
"2292","56","20200804095304","Mobile","AAA05","9","540000","180000","360000","2020-08-04 09:53:04"
"2293","70","20200804083457","PC","AAA05","16","960000","320000","640000","2020-08-04 08:34:57"
"2294","48","20200804073918","Mobile","AAA04","6","48000","2400","45600","2020-08-04 07:39:18"
"2295","73","20200803100725","Mobile","AAA04","10","80000","4000","76000","2020-08-03 22:07:25"
"2296","23","20200803083445","Mobile","AAA05","13","780000","260000","520000","2020-08-03 20:34:45"
"2297","89","20200803062534","Mobile","AAA01","14","140000","28000","112000","2020-08-03 18:25:34"
"2298","68","20200803020603","Shop","AAA05","8","480000","160000","320000","2020-08-03 14:06:03"
"2299","28","20200803124301","Mobile","AAA04","9","72000","3600","68400","2020-08-03 12:43:01"
"2300","36","20200803101035","Mobile","AAA03","25","425000","75000","350000","2020-08-03 10:10:35"
"2301","56","20200803084127","Mobile","AAA03","11","187000","33000","154000","2020-08-03 08:41:27"
"2302","26","20200729033805","Mobile","AAA04","11","88000","4400","83600","2020-07-29 15:38:05"
"2303","29","20200729021751","PC","AAA01","20","200000","40000","160000","2020-07-29 14:17:51"
"2304","61","20200729124759","Shop","AAA01","2","20000","4000","16000","2020-07-29 12:47:59"
"2305","73","20200729112829","PC","AAA05","12","720000","240000","480000","2020-07-29 11:28:29"
"2306","14","20200729095037","Shop","AAA05","6","360000","120000","240000","2020-07-29 09:50:37"
"2307","52","20200729085157","PC","AAA04","6","48000","2400","45600","2020-07-29 08:51:57"
"2308","10","20200728043937","Shop","AAA01","22","220000","44000","176000","2020-07-28 16:39:37"
"2309","96","20200728014440","Shop","AAA01","9","90000","18000","72000","2020-07-28 13:44:40"
"2310","27","20200728123935","Shop","AAA04","7","56000","2800","53200","2020-07-28 12:39:35"
"2311","20","20200728114131","PC","AAA02","3","45000","6900","38100","2020-07-28 11:41:31"
"2312","44","20200728100121","PC","AAA03","1","17000","3000","14000","2020-07-28 10:01:21"
"2313","54","20200728081928","Shop","AAA01","10","100000","20000","80000","2020-07-28 08:19:28"
"2314","64","20200728072327","PC","AAA04","5","40000","2000","38000","2020-07-28 07:23:27"
"2315","43","20200727045517","PC","AAA04","4","32000","1600","30400","2020-07-27 16:55:17"
"2316","49","20200727013715","Mobile","AAA05","7","420000","140000","280000","2020-07-27 13:37:15"
"2317","54","20200727123227","PC","AAA05","6","360000","120000","240000","2020-07-27 12:32:27"
"2318","2","20200727112414","Shop","AAA02","6","90000","13800","76200","2020-07-27 11:24:14"
"2319","62","20200727101505","Shop","AAA02","4","60000","9200","50800","2020-07-27 10:15:05"
"2320","96","20200727091332","Shop","AAA03","1","17000","3000","14000","2020-07-27 09:13:32"
"2321","67","20200724055201","PC","AAA05","4","240000","80000","160000","2020-07-24 17:52:01"
"2322","94","20200724035855","Shop","AAA05","5","300000","100000","200000","2020-07-24 15:58:55"
"2323","17","20200724030853","Mobile","AAA04","8","64000","3200","60800","2020-07-24 15:08:53"
"2324","24","20200724021739","Shop","AAA02","9","135000","20700","114300","2020-07-24 14:17:39"
"2325","65","20200724011233","Mobile","AAA04","6","48000","2400","45600","2020-07-24 13:12:33"
"2326","55","20200724111119","Shop","AAA01","2","20000","4000","16000","2020-07-24 11:11:19"
"2327","42","20200724075024","Shop","AAA05","1","60000","20000","40000","2020-07-24 07:50:24"
"2328","80","20200723063635","Mobile","AAA04","15","120000","6000","114000","2020-07-23 18:36:35"
"2329","20","20200723021301","Shop","AAA05","7","420000","140000","280000","2020-07-23 14:13:01"
"2330","27","20200723013720","Mobile","AAA01","6","60000","12000","48000","2020-07-23 13:37:20"
"2331","67","20200723121212","Shop","AAA04","10","80000","4000","76000","2020-07-23 12:12:12"
"2332","62","20200723110959","Shop","AAA02","8","120000","18400","101600","2020-07-23 11:09:59"
"2333","10","20200723095355","PC","AAA02","8","120000","18400","101600","2020-07-23 09:53:55"
"2334","14","20200723090949","Shop","AAA02","1","15000","2300","12700","2020-07-23 09:09:49"
"2335","84","20200723083126","Shop","AAA01","1","10000","2000","8000","2020-07-23 08:31:26"
"2336","44","20200723072641","Mobile","AAA05","6","360000","120000","240000","2020-07-23 07:26:41"
"2337","61","20200723122347","Shop","AAA04","6","48000","2400","45600","2020-07-23 00:23:47"
"2338","81","20200722055515","Shop","AAA03","8","136000","24000","112000","2020-07-22 17:55:15"
"2339","28","20200722045235","Mobile","AAA03","15","255000","45000","210000","2020-07-22 16:52:35"
"2340","29","20200722033801","Shop","AAA01","12","120000","24000","96000","2020-07-22 15:38:01"
"2341","50","20200722023024","PC","AAA05","18","1080000","360000","720000","2020-07-22 14:30:24"
"2342","75","20200722013650","PC","AAA05","2","120000","40000","80000","2020-07-22 13:36:50"
"2343","15","20200722105951","Mobile","AAA02","15","225000","34500","190500","2020-07-22 10:59:51"
"2344","17","20200722093154","PC","AAA01","4","40000","8000","32000","2020-07-22 09:31:54"
"2345","1","20200722074507","Mobile","AAA03","15","255000","45000","210000","2020-07-22 07:45:07"
"2346","19","20200721101543","Shop","AAA02","4","60000","9200","50800","2020-07-21 22:15:43"
"2347","49","20200721073126","Mobile","AAA05","13","780000","260000","520000","2020-07-21 19:31:26"
"2348","71","20200721031251","Mobile","AAA01","3","30000","6000","24000","2020-07-21 15:12:51"
"2349","37","20200721022134","PC","AAA03","14","238000","42000","196000","2020-07-21 14:21:34"
"2350","39","20200721011315","PC","AAA05","5","300000","100000","200000","2020-07-21 13:13:15"
"2351","4","20200721115946","Shop","AAA04","3","24000","1200","22800","2020-07-21 11:59:46"
"2352","34","20200721105159","Shop","AAA03","6","102000","18000","84000","2020-07-21 10:51:59"
"2353","15","20200721092303","PC","AAA02","11","165000","25300","139700","2020-07-21 09:23:03"
"2354","57","20200721083806","Shop","AAA04","2","16000","800","15200","2020-07-21 08:38:06"
"2355","65","20200721071953","PC","AAA02","2","30000","4600","25400","2020-07-21 07:19:53"
"2356","52","20200720092835","PC","AAA02","1","15000","2300","12700","2020-07-20 21:28:35"
"2357","1","20200720065304","Shop","AAA04","9","72000","3600","68400","2020-07-20 18:53:04"
"2358","11","20200720040533","Shop","AAA02","4","60000","9200","50800","2020-07-20 16:05:33"
"2359","98","20200720031954","Shop","AAA02","4","60000","9200","50800","2020-07-20 15:19:54"
"2360","39","20200720024311","Mobile","AAA01","10","100000","20000","80000","2020-07-20 14:43:11"
"2361","96","20200720125100","PC","AAA03","1","17000","3000","14000","2020-07-20 12:51:00"
"2362","48","20200720114637","PC","AAA02","2","30000","4600","25400","2020-07-20 11:46:37"
"2363","72","20200720104326","Mobile","AAA05","11","660000","220000","440000","2020-07-20 10:43:26"
"2364","48","20200720100708","PC","AAA01","5","50000","10000","40000","2020-07-20 10:07:08"
"2365","25","20200720094319","Shop","AAA02","11","165000","25300","139700","2020-07-20 09:43:19"
"2366","60","20200716024657","Shop","AAA02","5","75000","11500","63500","2020-07-16 14:46:57"
"2367","100","20200716011319","Shop","AAA01","6","60000","12000","48000","2020-07-16 13:13:19"
"2368","37","20200716125646","PC","AAA02","15","225000","34500","190500","2020-07-16 12:56:46"
"2369","40","20200716105111","Shop","AAA01","6","60000","12000","48000","2020-07-16 10:51:11"
"2370","86","20200716092627","Shop","AAA04","5","40000","2000","38000","2020-07-16 09:26:27"
"2371","97","20200716083441","Mobile","AAA05","17","1020000","340000","680000","2020-07-16 08:34:41"
"2372","59","20200716075329","PC","AAA02","3","45000","6900","38100","2020-07-16 07:53:29"
"2373","95","20200715105515","Mobile","AAA04","4","32000","1600","30400","2020-07-15 22:55:15"
"2374","20","20200715082501","PC","AAA01","2","20000","4000","16000","2020-07-15 20:25:01"
"2375","55","20200715033426","PC","AAA02","15","225000","34500","190500","2020-07-15 15:34:26"
"2376","75","20200715025819","Mobile","AAA05","8","480000","160000","320000","2020-07-15 14:58:19"
"2377","50","20200715013433","PC","AAA02","12","180000","27600","152400","2020-07-15 13:34:33"
"2378","64","20200715082005","Mobile","AAA01","1","10000","2000","8000","2020-07-15 08:20:05"
"2379","77","20200715065606","Mobile","AAA02","2","30000","4600","25400","2020-07-15 06:56:06"
"2380","50","20200715010208","PC","AAA05","10","600000","200000","400000","2020-07-15 01:02:08"
"2381","97","20200714015324","Shop","AAA03","5","85000","15000","70000","2020-07-14 13:53:24"
"2382","36","20200714121419","PC","AAA01","13","130000","26000","104000","2020-07-14 12:14:19"
"2383","37","20200714111207","PC","AAA05","7","420000","140000","280000","2020-07-14 11:12:07"
"2384","97","20200714094317","PC","AAA03","7","119000","21000","98000","2020-07-14 09:43:17"
"2385","90","20200714082903","PC","AAA05","9","540000","180000","360000","2020-07-14 08:29:03"
"2386","28","20200714073310","Shop","AAA03","17","289000","51000","238000","2020-07-14 07:33:10"
"2387","64","20200713070136","Mobile","AAA04","2","16000","800","15200","2020-07-13 19:01:36"
"2388","77","20200713034733","Mobile","AAA01","5","50000","10000","40000","2020-07-13 15:47:33"
"2389","26","20200713030300","Mobile","AAA01","4","40000","8000","32000","2020-07-13 15:03:00"
"2390","20","20200713010252","PC","AAA03","1","17000","3000","14000","2020-07-13 13:02:52"
"2391","36","20200713121524","Shop","AAA02","12","180000","27600","152400","2020-07-13 12:15:24"
"2392","54","20200713103414","Shop","AAA02","7","105000","16100","88900","2020-07-13 10:34:14"
"2393","79","20200713093224","Mobile","AAA01","11","110000","22000","88000","2020-07-13 09:32:24"
"2394","34","20200709071338","Shop","AAA02","13","195000","29900","165100","2020-07-09 19:13:38"
"2395","41","20200709031817","Mobile","AAA03","11","187000","33000","154000","2020-07-09 15:18:17"
"2396","11","20200709015321","Mobile","AAA04","5","40000","2000","38000","2020-07-09 13:53:21"
"2397","82","20200709125153","PC","AAA05","8","480000","160000","320000","2020-07-09 12:51:53"
"2398","45","20200709105338","PC","AAA01","7","70000","14000","56000","2020-07-09 10:53:38"
"2399","13","20200709095645","PC","AAA04","8","64000","3200","60800","2020-07-09 09:56:45"
"2400","29","20200709071733","PC","AAA03","1","17000","3000","14000","2020-07-09 07:17:33"
"2401","24","20200708051808","Mobile","AAA04","12","96000","4800","91200","2020-07-08 17:18:08"
"2402","3","20200708033916","Mobile","AAA01","14","140000","28000","112000","2020-07-08 15:39:16"
"2403","15","20200708025836","Mobile","AAA04","12","96000","4800","91200","2020-07-08 14:58:36"
"2404","50","20200708011758","Mobile","AAA02","15","225000","34500","190500","2020-07-08 13:17:58"
"2405","3","20200708121637","PC","AAA01","1","10000","2000","8000","2020-07-08 12:16:37"
"2406","55","20200708113113","Shop","AAA04","5","40000","2000","38000","2020-07-08 11:31:13"
"2407","57","20200708102953","Mobile","AAA02","8","120000","18400","101600","2020-07-08 10:29:53"
"2408","58","20200708082133","Mobile","AAA01","5","50000","10000","40000","2020-07-08 08:21:33"
"2409","18","20200708064058","Mobile","AAA03","4","68000","12000","56000","2020-07-08 06:40:58"
"2410","82","20200707075046","Shop","AAA05","1","60000","20000","40000","2020-07-07 19:50:46"
"2411","34","20200707033928","Mobile","AAA02","6","90000","13800","76200","2020-07-07 15:39:28"
"2412","83","20200707124234","PC","AAA01","12","120000","24000","96000","2020-07-07 12:42:34"
"2413","36","20200707115641","Mobile","AAA04","8","64000","3200","60800","2020-07-07 11:56:41"
"2414","25","20200707102328","Shop","AAA04","6","48000","2400","45600","2020-07-07 10:23:28"
"2415","3","20200707091107","PC","AAA03","14","238000","42000","196000","2020-07-07 09:11:07"
"2416","35","20200707072740","Mobile","AAA03","5","85000","15000","70000","2020-07-07 07:27:40"
"2417","55","20200707015320","Shop","AAA01","9","90000","18000","72000","2020-07-07 01:53:20"
"2418","14","20200706022234","Mobile","AAA03","8","136000","24000","112000","2020-07-06 14:22:34"
"2419","40","20200706013029","Mobile","AAA02","4","60000","9200","50800","2020-07-06 13:30:29"
"2420","80","20200706123637","Mobile","AAA05","6","360000","120000","240000","2020-07-06 12:36:37"
"2421","73","20200706103358","Mobile","AAA01","8","80000","16000","64000","2020-07-06 10:33:58"
"2422","77","20200706092356","Mobile","AAA03","2","34000","6000","28000","2020-07-06 09:23:56"
"2423","15","20200703090308","PC","AAA03","4","68000","12000","56000","2020-07-03 21:03:08"
"2424","15","20200703052009","PC","AAA03","16","272000","48000","224000","2020-07-03 17:20:09"
"2425","19","20200703044227","PC","AAA01","2","20000","4000","16000","2020-07-03 16:42:27"
"2426","12","20200703040339","Shop","AAA01","5","50000","10000","40000","2020-07-03 16:03:39"
"2427","82","20200703020357","Mobile","AAA04","9","72000","3600","68400","2020-07-03 14:03:57"
"2428","64","20200703010044","PC","AAA03","7","119000","21000","98000","2020-07-03 13:00:44"
"2429","6","20200703121038","Shop","AAA03","2","34000","6000","28000","2020-07-03 12:10:38"
"2430","62","20200703101354","Shop","AAA05","7","420000","140000","280000","2020-07-03 10:13:54"
"2431","45","20200703090605","PC","AAA03","6","102000","18000","84000","2020-07-03 09:06:05"
"2432","8","20200703022847","PC","AAA04","1","8000","400","7600","2020-07-03 02:28:47"
"2433","81","20200702091719","PC","AAA01","7","70000","14000","56000","2020-07-02 09:17:19"
"2434","65","20200702083200","Shop","AAA04","12","96000","4800","91200","2020-07-02 08:32:00"
"2435","78","20200702072508","PC","AAA01","6","60000","12000","48000","2020-07-02 07:25:08"
"2436","41","20200701094109","Shop","AAA05","13","780000","260000","520000","2020-07-01 21:41:09"
"2437","41","20200701065548","Shop","AAA02","5","75000","11500","63500","2020-07-01 18:55:48"
"2438","78","20200701035832","Mobile","AAA03","10","170000","30000","140000","2020-07-01 15:58:32"
"2439","42","20200701022814","Mobile","AAA02","8","120000","18400","101600","2020-07-01 14:28:14"
"2440","86","20200701011913","Mobile","AAA05","2","120000","40000","80000","2020-07-01 13:19:13"
"2441","62","20200701010145","Shop","AAA02","13","195000","29900","165100","2020-07-01 13:01:45"
"2442","96","20200701114059","Shop","AAA05","3","180000","60000","120000","2020-07-01 11:40:59"
"2443","5","20200701103849","PC","AAA04","12","96000","4800","91200","2020-07-01 10:38:49"
"2444","57","20200701092413","PC","AAA03","7","119000","21000","98000","2020-07-01 09:24:13"
"2445","60","20200701073721","Shop","AAA04","4","32000","1600","30400","2020-07-01 07:37:21"
"2446","3","20200630124846","Shop","AAA05","10","600000","200000","400000","2020-06-30 12:48:46"
"2447","24","20200630104852","Shop","AAA02","3","45000","6900","38100","2020-06-30 10:48:52"
"2448","67","20200630101118","PC","AAA01","9","90000","18000","72000","2020-06-30 10:11:18"
"2449","11","20200630085904","PC","AAA02","2","30000","4600","25400","2020-06-30 08:59:04"
"2450","53","20200629114353","Shop","AAA01","1","10000","2000","8000","2020-06-29 23:43:53"
"2451","92","20200629091839","PC","AAA05","4","240000","80000","160000","2020-06-29 21:18:39"
"2452","52","20200629073134","PC","AAA03","3","51000","9000","42000","2020-06-29 19:31:34"
"2453","32","20200629032505","Mobile","AAA02","5","75000","11500","63500","2020-06-29 15:25:05"
"2454","55","20200629015251","PC","AAA01","8","80000","16000","64000","2020-06-29 13:52:51"
"2455","64","20200629125734","Mobile","AAA03","8","136000","24000","112000","2020-06-29 12:57:34"
"2456","86","20200629121413","PC","AAA03","4","68000","12000","56000","2020-06-29 12:14:13"
"2457","56","20200629110316","Shop","AAA04","5","40000","2000","38000","2020-06-29 11:03:16"
"2458","24","20200629100237","PC","AAA03","4","68000","12000","56000","2020-06-29 10:02:37"
"2459","12","20200629082528","PC","AAA03","1","17000","3000","14000","2020-06-29 08:25:28"
"2460","22","20200626122524","PC","AAA04","4","32000","1600","30400","2020-06-26 00:25:24"
"2461","58","20200625093828","PC","AAA03","1","17000","3000","14000","2020-06-25 21:38:28"
"2462","46","20200625010350","Shop","AAA02","10","150000","23000","127000","2020-06-25 13:03:50"
"2463","79","20200625111748","PC","AAA03","5","85000","15000","70000","2020-06-25 11:17:48"
"2464","42","20200625093323","Shop","AAA01","1","10000","2000","8000","2020-06-25 09:33:23"
"2465","98","20200625082659","Shop","AAA02","1","15000","2300","12700","2020-06-25 08:26:59"
"2466","8","20200625064341","Shop","AAA04","12","96000","4800","91200","2020-06-25 06:43:41"
"2467","89","20200624072527","Mobile","AAA03","5","85000","15000","70000","2020-06-24 19:25:27"
"2468","73","20200624121724","PC","AAA05","1","60000","20000","40000","2020-06-24 12:17:24"
"2469","50","20200624113047","PC","AAA05","10","600000","200000","400000","2020-06-24 11:30:47"
"2470","24","20200624092150","PC","AAA02","10","150000","23000","127000","2020-06-24 09:21:50"
"2471","79","20200624081241","Mobile","AAA01","4","40000","8000","32000","2020-06-24 08:12:41"
"2472","90","20200624072025","PC","AAA03","2","34000","6000","28000","2020-06-24 07:20:25"
"2473","86","20200623040803","Mobile","AAA02","3","45000","6900","38100","2020-06-23 16:08:03"
"2474","71","20200623025104","Mobile","AAA02","7","105000","16100","88900","2020-06-23 14:51:04"
"2475","86","20200623010253","PC","AAA04","5","40000","2000","38000","2020-06-23 13:02:53"
"2476","21","20200623115651","Shop","AAA01","1","10000","2000","8000","2020-06-23 11:56:51"
"2477","6","20200623094732","Mobile","AAA04","2","16000","800","15200","2020-06-23 09:47:32"
"2478","38","20200623075137","Mobile","AAA03","7","119000","21000","98000","2020-06-23 07:51:37"
"2479","47","20200622035105","Mobile","AAA04","11","88000","4400","83600","2020-06-22 15:51:05"
"2480","96","20200622031130","Mobile","AAA03","7","119000","21000","98000","2020-06-22 15:11:30"
"2481","16","20200622011618","Mobile","AAA01","8","80000","16000","64000","2020-06-22 13:16:18"
"2482","45","20200622120244","Shop","AAA02","5","75000","11500","63500","2020-06-22 12:02:44"
"2483","99","20200622110842","Shop","AAA05","3","180000","60000","120000","2020-06-22 11:08:42"
"2484","1","20200622093441","Mobile","AAA03","16","272000","48000","224000","2020-06-22 09:34:41"
"2485","72","20200620093901","Shop","AAA05","2","120000","40000","80000","2020-06-20 09:39:01"
"2486","99","20200620022024","PC","AAA05","1","60000","20000","40000","2020-06-20 02:20:24"
"2487","84","20200619023628","Shop","AAA02","3","45000","6900","38100","2020-06-19 14:36:28"
"2488","35","20200619020728","Shop","AAA05","1","60000","20000","40000","2020-06-19 14:07:28"
"2489","81","20200619122922","PC","AAA04","9","72000","3600","68400","2020-06-19 12:29:22"
"2490","15","20200619114119","Shop","AAA02","7","105000","16100","88900","2020-06-19 11:41:19"
"2491","8","20200619102811","Shop","AAA03","6","102000","18000","84000","2020-06-19 10:28:11"
"2492","35","20200619094540","PC","AAA02","4","60000","9200","50800","2020-06-19 09:45:40"
"2493","10","20200619075636","Shop","AAA02","3","45000","6900","38100","2020-06-19 07:56:36"
"2494","60","20200619120902","PC","AAA02","2","30000","4600","25400","2020-06-19 00:09:02"
"2495","42","20200618122339","Mobile","AAA03","10","170000","30000","140000","2020-06-18 12:23:39"
"2496","24","20200618105650","PC","AAA05","8","480000","160000","320000","2020-06-18 10:56:50"
"2497","95","20200618090915","Shop","AAA04","1","8000","400","7600","2020-06-18 09:09:15"
"2498","30","20200618072237","Mobile","AAA05","7","420000","140000","280000","2020-06-18 07:22:37"
"2499","38","20200617093204","PC","AAA05","6","360000","120000","240000","2020-06-17 21:32:04"
"2500","97","20200617051102","Mobile","AAA02","7","105000","16100","88900","2020-06-17 17:11:02"
"2501","4","20200617025116","Mobile","AAA04","7","56000","2800","53200","2020-06-17 14:51:16"
"2502","54","20200617013432","Mobile","AAA03","5","85000","15000","70000","2020-06-17 13:34:32"
"2503","87","20200617122450","PC","AAA03","3","51000","9000","42000","2020-06-17 12:24:50"
"2504","15","20200617103841","PC","AAA04","4","32000","1600","30400","2020-06-17 10:38:41"
"2505","58","20200617095838","Mobile","AAA04","7","56000","2800","53200","2020-06-17 09:58:38"
"2506","9","20200617085630","PC","AAA04","2","16000","800","15200","2020-06-17 08:56:30"
"2507","31","20200617080155","PC","AAA02","1","15000","2300","12700","2020-06-17 08:01:55"
"2508","50","20200617070205","PC","AAA03","8","136000","24000","112000","2020-06-17 07:02:05"
"2509","60","20200616055701","Shop","AAA03","1","17000","3000","14000","2020-06-16 17:57:01"
"2510","60","20200616035919","PC","AAA02","1","15000","2300","12700","2020-06-16 15:59:19"
"2511","89","20200616031343","Shop","AAA03","22","374000","66000","308000","2020-06-16 15:13:43"
"2512","87","20200616015333","Mobile","AAA04","9","72000","3600","68400","2020-06-16 13:53:33"
"2513","54","20200616122513","Shop","AAA04","11","88000","4400","83600","2020-06-16 12:25:13"
"2514","2","20200616114231","PC","AAA04","4","32000","1600","30400","2020-06-16 11:42:31"
"2515","83","20200616095829","Mobile","AAA02","8","120000","18400","101600","2020-06-16 09:58:29"
"2516","54","20200616074545","Shop","AAA03","4","68000","12000","56000","2020-06-16 07:45:45"
"2517","38","20200615043132","Mobile","AAA05","7","420000","140000","280000","2020-06-15 16:31:32"
"2518","57","20200615024715","Mobile","AAA04","5","40000","2000","38000","2020-06-15 14:47:15"
"2519","49","20200615014059","PC","AAA04","4","32000","1600","30400","2020-06-15 13:40:59"
"2520","66","20200615125156","Shop","AAA01","5","50000","10000","40000","2020-06-15 12:51:56"
"2521","64","20200615114330","Shop","AAA02","5","75000","11500","63500","2020-06-15 11:43:30"
"2522","84","20200615100101","Mobile","AAA03","2","34000","6000","28000","2020-06-15 10:01:01"
"2523","86","20200615081210","PC","AAA05","1","60000","20000","40000","2020-06-15 08:12:10"
"2524","81","20200611111239","Shop","AAA04","8","64000","3200","60800","2020-06-11 11:12:39"
"2525","7","20200611080931","PC","AAA03","2","34000","6000","28000","2020-06-11 08:09:31"
"2526","46","20200611070649","PC","AAA04","5","40000","2000","38000","2020-06-11 07:06:49"
"2527","43","20200610034110","Shop","AAA03","10","170000","30000","140000","2020-06-10 15:41:10"
"2528","28","20200610021316","Mobile","AAA01","4","40000","8000","32000","2020-06-10 14:13:16"
"2529","70","20200610110946","Mobile","AAA03","5","85000","15000","70000","2020-06-10 11:09:46"
"2530","18","20200610092953","Shop","AAA04","6","48000","2400","45600","2020-06-10 09:29:53"
"2531","4","20200610082211","Shop","AAA03","5","85000","15000","70000","2020-06-10 08:22:11"
"2532","2","20200610073348","PC","AAA01","5","50000","10000","40000","2020-06-10 07:33:48"
"2533","24","20200610125121","Shop","AAA02","5","75000","11500","63500","2020-06-10 00:51:21"
"2534","85","20200609084955","PC","AAA04","2","16000","800","15200","2020-06-09 08:49:55"
"2535","37","20200609080602","Mobile","AAA03","14","238000","42000","196000","2020-06-09 08:06:02"
"2536","2","20200609065512","PC","AAA04","10","80000","4000","76000","2020-06-09 06:55:12"
"2537","96","20200608025027","Mobile","AAA01","14","140000","28000","112000","2020-06-08 14:50:27"
"2538","18","20200608012151","Mobile","AAA03","16","272000","48000","224000","2020-06-08 13:21:51"
"2539","99","20200608122415","PC","AAA03","8","136000","24000","112000","2020-06-08 12:24:15"
"2540","100","20200608112618","PC","AAA03","2","34000","6000","28000","2020-06-08 11:26:18"
"2541","89","20200605063900","Shop","AAA05","13","780000","260000","520000","2020-06-05 18:39:00"
"2542","35","20200605042408","PC","AAA02","6","90000","13800","76200","2020-06-05 16:24:08"
"2543","84","20200605032114","PC","AAA02","2","30000","4600","25400","2020-06-05 15:21:14"
"2544","28","20200605014826","PC","AAA04","14","112000","5600","106400","2020-06-05 13:48:26"
"2545","37","20200605120427","Shop","AAA01","4","40000","8000","32000","2020-06-05 12:04:27"
"2546","13","20200605111127","Shop","AAA02","3","45000","6900","38100","2020-06-05 11:11:27"
"2547","42","20200605102942","PC","AAA02","9","135000","20700","114300","2020-06-05 10:29:42"
"2548","16","20200605121104","Shop","AAA02","7","105000","16100","88900","2020-06-05 00:11:04"
"2549","73","20200604075153","Mobile","AAA01","1","10000","2000","8000","2020-06-04 07:51:53"
"2550","72","20200603111208","Shop","AAA01","7","70000","14000","56000","2020-06-03 11:12:08"
"2551","81","20200603084915","Shop","AAA01","4","40000","8000","32000","2020-06-03 08:49:15"
"2552","33","20200603070419","Mobile","AAA04","3","24000","1200","22800","2020-06-03 07:04:19"
"2553","57","20200602022403","Shop","AAA03","4","68000","12000","56000","2020-06-02 14:24:03"
"2554","78","20200602013701","Shop","AAA04","3","24000","1200","22800","2020-06-02 13:37:01"
"2555","7","20200602110008","PC","AAA05","12","720000","240000","480000","2020-06-02 11:00:08"
"2556","38","20200602100543","PC","AAA05","3","180000","60000","120000","2020-06-02 10:05:43"
"2557","87","20200602084011","Mobile","AAA01","14","140000","28000","112000","2020-06-02 08:40:11"
"2558","48","20200602075625","Mobile","AAA01","4","40000","8000","32000","2020-06-02 07:56:25"
"2559","14","20200601033644","Shop","AAA05","2","120000","40000","80000","2020-06-01 15:36:44"
"2560","20","20200601022608","Mobile","AAA04","8","64000","3200","60800","2020-06-01 14:26:08"
"2561","74","20200601010030","PC","AAA03","1","17000","3000","14000","2020-06-01 13:00:30"
"2562","95","20200601113738","PC","AAA03","1","17000","3000","14000","2020-06-01 11:37:38"
"2563","72","20200601084920","Shop","AAA02","3","45000","6900","38100","2020-06-01 08:49:20"
"2564","2","20200531114346","Shop","AAA01","10","100000","20000","80000","2020-05-31 11:43:46"
"2565","75","20200529102908","Shop","AAA04","4","32000","1600","30400","2020-05-29 22:29:08"
"2566","20","20200529074733","PC","AAA02","3","45000","6900","38100","2020-05-29 19:47:33"
"2567","70","20200529050639","Shop","AAA05","6","360000","120000","240000","2020-05-29 17:06:39"
"2568","49","20200529041217","Mobile","AAA02","9","135000","20700","114300","2020-05-29 16:12:17"
"2569","56","20200529032406","Shop","AAA04","12","96000","4800","91200","2020-05-29 15:24:06"
"2570","56","20200529022900","PC","AAA01","6","60000","12000","48000","2020-05-29 14:29:00"
"2571","12","20200529011705","Shop","AAA05","2","120000","40000","80000","2020-05-29 13:17:05"
"2572","30","20200529101744","Mobile","AAA03","11","187000","33000","154000","2020-05-29 10:17:44"
"2573","36","20200529092220","PC","AAA03","3","51000","9000","42000","2020-05-29 09:22:20"
"2574","52","20200529011038","Mobile","AAA03","4","68000","12000","56000","2020-05-29 01:10:38"
"2575","59","20200528075659","PC","AAA03","1","17000","3000","14000","2020-05-28 19:56:59"
"2576","67","20200528063758","PC","AAA01","8","80000","16000","64000","2020-05-28 18:37:58"
"2577","7","20200528021903","PC","AAA03","3","51000","9000","42000","2020-05-28 14:19:03"
"2578","6","20200528013413","Mobile","AAA02","6","90000","13800","76200","2020-05-28 13:34:13"
"2579","34","20200528121124","Mobile","AAA01","7","70000","14000","56000","2020-05-28 12:11:24"
"2580","73","20200528113556","PC","AAA03","12","204000","36000","168000","2020-05-28 11:35:56"
"2581","94","20200528103004","Mobile","AAA02","7","105000","16100","88900","2020-05-28 10:30:04"
"2582","40","20200528082947","PC","AAA02","4","60000","9200","50800","2020-05-28 08:29:47"
"2583","71","20200528065308","Shop","AAA03","9","153000","27000","126000","2020-05-28 06:53:08"
"2584","43","20200527042827","PC","AAA02","18","270000","41400","228600","2020-05-27 16:28:27"
"2585","65","20200527032114","PC","AAA05","5","300000","100000","200000","2020-05-27 15:21:14"
"2586","14","20200527122131","Shop","AAA04","3","24000","1200","22800","2020-05-27 12:21:31"
"2587","69","20200527111213","Shop","AAA02","3","45000","6900","38100","2020-05-27 11:12:13"
"2588","55","20200527095210","Shop","AAA04","7","56000","2800","53200","2020-05-27 09:52:10"
"2589","35","20200527090745","Shop","AAA05","3","180000","60000","120000","2020-05-27 09:07:45"
"2590","49","20200527071346","Mobile","AAA02","1","15000","2300","12700","2020-05-27 07:13:46"
"2591","88","20200526070929","PC","AAA02","8","120000","18400","101600","2020-05-26 19:09:29"
"2592","32","20200526024032","Shop","AAA03","10","170000","30000","140000","2020-05-26 14:40:32"
"2593","85","20200526122618","Shop","AAA03","4","68000","12000","56000","2020-05-26 12:26:18"
"2594","50","20200526111928","Shop","AAA05","13","780000","260000","520000","2020-05-26 11:19:28"
"2595","20","20200526080741","PC","AAA05","5","300000","100000","200000","2020-05-26 08:07:41"
"2596","88","20200526065408","PC","AAA03","7","119000","21000","98000","2020-05-26 06:54:08"
"2597","68","20200525064425","PC","AAA01","11","110000","22000","88000","2020-05-25 18:44:25"
"2598","51","20200525030559","Mobile","AAA02","7","105000","16100","88900","2020-05-25 15:05:59"
"2599","42","20200525021547","Shop","AAA04","3","24000","1200","22800","2020-05-25 14:15:47"
"2600","1","20200525010542","Shop","AAA04","13","104000","5200","98800","2020-05-25 13:05:42"
"2601","25","20200525120918","Shop","AAA02","8","120000","18400","101600","2020-05-25 12:09:18"
"2602","89","20200525112245","PC","AAA05","17","1020000","340000","680000","2020-05-25 11:22:45"
"2603","64","20200525093135","Shop","AAA05","14","840000","280000","560000","2020-05-25 09:31:35"
"2604","81","20200521020424","Mobile","AAA02","8","120000","18400","101600","2020-05-21 14:04:24"
"2605","20","20200521123755","Shop","AAA02","8","120000","18400","101600","2020-05-21 12:37:55"
"2606","46","20200521114827","Mobile","AAA01","3","30000","6000","24000","2020-05-21 11:48:27"
"2607","42","20200521104038","Mobile","AAA04","10","80000","4000","76000","2020-05-21 10:40:38"
"2608","73","20200521091036","Mobile","AAA01","12","120000","24000","96000","2020-05-21 09:10:36"
"2609","83","20200521081836","PC","AAA03","6","102000","18000","84000","2020-05-21 08:18:36"
"2610","78","20200520015516","Shop","AAA02","11","165000","25300","139700","2020-05-20 13:55:16"
"2611","92","20200520101820","Mobile","AAA05","3","180000","60000","120000","2020-05-20 10:18:20"
"2612","6","20200520094228","Mobile","AAA05","8","480000","160000","320000","2020-05-20 09:42:28"
"2613","96","20200520065619","PC","AAA04","1","8000","400","7600","2020-05-20 06:56:19"
"2614","44","20200520013243","Shop","AAA05","1","60000","20000","40000","2020-05-20 01:32:43"
"2615","73","20200519033504","Mobile","AAA05","5","300000","100000","200000","2020-05-19 15:35:04"
"2616","17","20200519021632","Mobile","AAA04","11","88000","4400","83600","2020-05-19 14:16:32"
"2617","9","20200519125116","Mobile","AAA01","1","10000","2000","8000","2020-05-19 12:51:16"
"2618","47","20200519114654","PC","AAA01","3","30000","6000","24000","2020-05-19 11:46:54"
"2619","77","20200519103503","Shop","AAA04","3","24000","1200","22800","2020-05-19 10:35:03"
"2620","79","20200519095806","PC","AAA02","4","60000","9200","50800","2020-05-19 09:58:06"
"2621","70","20200519091246","Shop","AAA02","16","240000","36800","203200","2020-05-19 09:12:46"
"2622","100","20200519082130","PC","AAA05","5","300000","100000","200000","2020-05-19 08:21:30"
"2623","31","20200519125121","PC","AAA05","4","240000","80000","160000","2020-05-19 00:51:21"
"2624","75","20200518093931","Mobile","AAA04","2","16000","800","15200","2020-05-18 21:39:31"
"2625","34","20200518045134","Mobile","AAA03","2","34000","6000","28000","2020-05-18 16:51:34"
"2626","81","20200518040425","Shop","AAA05","6","360000","120000","240000","2020-05-18 16:04:25"
"2627","75","20200518015910","Shop","AAA01","1","10000","2000","8000","2020-05-18 13:59:10"
"2628","57","20200518012324","Shop","AAA02","3","45000","6900","38100","2020-05-18 13:23:24"
"2629","77","20200518122921","Shop","AAA05","4","240000","80000","160000","2020-05-18 12:29:21"
"2630","43","20200518111941","Mobile","AAA02","14","210000","32200","177800","2020-05-18 11:19:41"
"2631","60","20200518105314","Shop","AAA05","3","180000","60000","120000","2020-05-18 10:53:14"
"2632","57","20200518100346","PC","AAA03","8","136000","24000","112000","2020-05-18 10:03:46"
"2633","18","20200518091409","Mobile","AAA03","6","102000","18000","84000","2020-05-18 09:14:09"
"2634","100","20200515084715","Mobile","AAA02","3","45000","6900","38100","2020-05-15 08:47:15"
"2635","56","20200515074642","Shop","AAA05","10","600000","200000","400000","2020-05-15 07:46:42"
"2636","29","20200514070800","Mobile","AAA03","20","340000","60000","280000","2020-05-14 19:08:00"
"2637","40","20200514025249","Mobile","AAA04","15","120000","6000","114000","2020-05-14 14:52:49"
"2638","21","20200514012143","Shop","AAA02","15","225000","34500","190500","2020-05-14 13:21:43"
"2639","7","20200514122606","Mobile","AAA02","3","45000","6900","38100","2020-05-14 12:26:06"
"2640","64","20200514101534","Shop","AAA05","17","1020000","340000","680000","2020-05-14 10:15:34"
"2641","9","20200514094349","Mobile","AAA03","3","51000","9000","42000","2020-05-14 09:43:49"
"2642","67","20200514091051","Mobile","AAA02","7","105000","16100","88900","2020-05-14 09:10:51"
"2643","36","20200514072126","Mobile","AAA02","18","270000","41400","228600","2020-05-14 07:21:26"
"2644","23","20200513101445","PC","AAA04","11","88000","4400","83600","2020-05-13 22:14:45"
"2645","43","20200513080645","Shop","AAA03","10","170000","30000","140000","2020-05-13 20:06:45"
"2646","37","20200513051232","Shop","AAA04","3","24000","1200","22800","2020-05-13 17:12:32"
"2647","81","20200513043851","PC","AAA05","7","420000","140000","280000","2020-05-13 16:38:51"
"2648","99","20200513034050","Mobile","AAA01","2","20000","4000","16000","2020-05-13 15:40:50"
"2649","73","20200513022834","Shop","AAA01","9","90000","18000","72000","2020-05-13 14:28:34"
"2650","67","20200513120008","Shop","AAA03","16","272000","48000","224000","2020-05-13 12:00:08"
"2651","93","20200513105420","Shop","AAA04","2","16000","800","15200","2020-05-13 10:54:20"
"2652","2","20200513100838","Mobile","AAA01","7","70000","14000","56000","2020-05-13 10:08:38"
"2653","100","20200513093522","PC","AAA01","8","80000","16000","64000","2020-05-13 09:35:22"
"2654","28","20200513075043","PC","AAA04","5","40000","2000","38000","2020-05-13 07:50:43"
"2655","23","20200512071200","PC","AAA05","8","480000","160000","320000","2020-05-12 19:12:00"
"2656","13","20200512050732","PC","AAA01","7","70000","14000","56000","2020-05-12 17:07:32"
"2657","85","20200512040200","PC","AAA02","13","195000","29900","165100","2020-05-12 16:02:00"
"2658","100","20200512031602","Mobile","AAA05","1","60000","20000","40000","2020-05-12 15:16:02"
"2659","56","20200512014946","Shop","AAA04","9","72000","3600","68400","2020-05-12 13:49:46"
"2660","45","20200512121011","Shop","AAA04","1","8000","400","7600","2020-05-12 12:10:11"
"2661","74","20200512104157","PC","AAA05","5","300000","100000","200000","2020-05-12 10:41:57"
"2662","81","20200512095351","PC","AAA03","1","17000","3000","14000","2020-05-12 09:53:51"
"2663","7","20200512090050","Shop","AAA03","2","34000","6000","28000","2020-05-12 09:00:50"
"2664","32","20200511100158","Shop","AAA01","16","160000","32000","128000","2020-05-11 22:01:58"
"2665","33","20200511072011","PC","AAA03","4","68000","12000","56000","2020-05-11 19:20:11"
"2666","23","20200511034750","Mobile","AAA02","7","105000","16100","88900","2020-05-11 15:47:50"
"2667","56","20200511024650","Mobile","AAA03","5","85000","15000","70000","2020-05-11 14:46:50"
"2668","34","20200511014945","PC","AAA05","15","900000","300000","600000","2020-05-11 13:49:45"
"2669","97","20200511125827","Mobile","AAA04","5","40000","2000","38000","2020-05-11 12:58:27"
"2670","83","20200511113758","Shop","AAA02","11","165000","25300","139700","2020-05-11 11:37:58"
"2671","4","20200511100804","PC","AAA01","8","80000","16000","64000","2020-05-11 10:08:04"
"2672","87","20200511101636","PC","AAA04","3","24000","1200","22800","2020-05-11 10:16:36"
"2673","75","20200511085329","PC","AAA03","4","68000","12000","56000","2020-05-11 08:53:29"
"2674","67","20200508043634","Shop","AAA03","1","17000","3000","14000","2020-05-08 16:36:34"
"2675","50","20200508034438","PC","AAA02","14","210000","32200","177800","2020-05-08 15:44:38"
"2676","85","20200508102231","Mobile","AAA01","4","40000","8000","32000","2020-05-08 10:22:31"
"2677","79","20200508072346","Mobile","AAA04","5","40000","2000","38000","2020-05-08 07:23:46"
"2678","62","20200507095533","PC","AAA03","4","68000","12000","56000","2020-05-07 21:55:33"
"2679","9","20200507060513","PC","AAA03","1","17000","3000","14000","2020-05-07 18:05:13"
"2680","3","20200507043015","Mobile","AAA05","10","600000","200000","400000","2020-05-07 16:30:15"
"2681","29","20200507023038","Shop","AAA02","15","225000","34500","190500","2020-05-07 14:30:38"
"2682","64","20200507013429","Shop","AAA01","5","50000","10000","40000","2020-05-07 13:34:29"
"2683","1","20200507121603","Mobile","AAA02","12","180000","27600","152400","2020-05-07 12:16:03"
"2684","76","20200507113835","PC","AAA02","12","180000","27600","152400","2020-05-07 11:38:35"
"2685","39","20200507094952","Shop","AAA04","3","24000","1200","22800","2020-05-07 09:49:52"
"2686","14","20200507083053","Mobile","AAA03","8","136000","24000","112000","2020-05-07 08:30:53"
"2687","55","20200507063138","PC","AAA05","6","360000","120000","240000","2020-05-07 06:31:38"
"2688","25","20200506023809","Mobile","AAA01","6","60000","12000","48000","2020-05-06 14:38:09"
"2689","12","20200506011439","Shop","AAA04","2","16000","800","15200","2020-05-06 13:14:39"
"2690","8","20200506121929","PC","AAA04","8","64000","3200","60800","2020-05-06 12:19:29"
"2691","90","20200506111030","Shop","AAA02","5","75000","11500","63500","2020-05-06 11:10:30"
"2692","30","20200506095013","Shop","AAA01","2","20000","4000","16000","2020-05-06 09:50:13"
"2693","9","20200506090312","Mobile","AAA01","1","10000","2000","8000","2020-05-06 09:03:12"
"2694","66","20200506075138","Shop","AAA03","11","187000","33000","154000","2020-05-06 07:51:38"
"2695","54","20200505044225","Shop","AAA05","20","1200000","400000","800000","2020-05-05 16:42:25"
"2696","7","20200505034305","Shop","AAA05","4","240000","80000","160000","2020-05-05 15:43:05"
"2697","4","20200505021345","Shop","AAA04","6","48000","2400","45600","2020-05-05 14:13:45"
"2698","57","20200505125026","Mobile","AAA02","4","60000","9200","50800","2020-05-05 12:50:26"
"2699","7","20200505120302","PC","AAA04","11","88000","4400","83600","2020-05-05 12:03:02"
"2700","27","20200505110210","PC","AAA02","15","225000","34500","190500","2020-05-05 11:02:10"
"2701","84","20200505095358","Shop","AAA04","2","16000","800","15200","2020-05-05 09:53:58"
"2702","5","20200505090607","Mobile","AAA03","11","187000","33000","154000","2020-05-05 09:06:07"
"2703","3","20200505072013","Mobile","AAA04","19","152000","7600","144400","2020-05-05 07:20:13"
"2704","87","20200504062930","Shop","AAA01","4","40000","8000","32000","2020-05-04 18:29:30"
"2705","94","20200504011522","Mobile","AAA05","6","360000","120000","240000","2020-05-04 13:15:22"
"2706","81","20200504120827","PC","AAA03","11","187000","33000","154000","2020-05-04 12:08:27"
"2707","91","20200504101443","Mobile","AAA04","4","32000","1600","30400","2020-05-04 10:14:43"
"2708","24","20200504092508","Shop","AAA03","5","85000","15000","70000","2020-05-04 09:25:08"
"2709","24","20200430012850","PC","AAA02","2","30000","4600","25400","2020-04-30 01:28:50"
"2710","47","20200429072558","Shop","AAA05","7","420000","140000","280000","2020-04-29 19:25:58"
"2711","3","20200429031110","PC","AAA03","23","391000","69000","322000","2020-04-29 15:11:10"
"2712","57","20200429012203","Mobile","AAA01","1","10000","2000","8000","2020-04-29 13:22:03"
"2713","6","20200429105747","PC","AAA05","8","480000","160000","320000","2020-04-29 10:57:47"
"2714","42","20200429101828","Shop","AAA04","1","8000","400","7600","2020-04-29 10:18:28"
"2715","32","20200429090947","Mobile","AAA03","8","136000","24000","112000","2020-04-29 09:09:47"
"2716","87","20200429083523","Shop","AAA04","4","32000","1600","30400","2020-04-29 08:35:23"
"2717","32","20200429085307","Mobile","AAA01","8","80000","16000","64000","2020-04-29 08:53:07"
"2718","15","20200429080848","Mobile","AAA04","18","144000","7200","136800","2020-04-29 08:08:48"
"2719","94","20200429070246","Shop","AAA05","20","1200000","400000","800000","2020-04-29 07:02:46"
"2720","66","20200428073912","PC","AAA05","5","300000","100000","200000","2020-04-28 19:39:12"
"2721","73","20200428055132","PC","AAA02","11","165000","25300","139700","2020-04-28 17:51:32"
"2722","77","20200428044741","Mobile","AAA05","4","240000","80000","160000","2020-04-28 16:47:41"
"2723","32","20200428024851","Mobile","AAA03","10","170000","30000","140000","2020-04-28 14:48:51"
"2724","43","20200428014748","Shop","AAA04","14","112000","5600","106400","2020-04-28 13:47:48"
"2725","23","20200428105249","Mobile","AAA05","1","60000","20000","40000","2020-04-28 10:52:49"
"2726","56","20200428093507","PC","AAA01","4","40000","8000","32000","2020-04-28 09:35:07"
"2727","16","20200428072147","Mobile","AAA02","11","165000","25300","139700","2020-04-28 07:21:47"
"2728","13","20200427082112","Mobile","AAA01","10","100000","20000","80000","2020-04-27 20:21:12"
"2729","73","20200427050027","Shop","AAA01","7","70000","14000","56000","2020-04-27 17:00:27"
"2730","20","20200427025901","PC","AAA04","1","8000","400","7600","2020-04-27 14:59:01"
"2731","33","20200427020025","Mobile","AAA05","7","420000","140000","280000","2020-04-27 14:00:25"
"2732","97","20200427010714","Shop","AAA01","6","60000","12000","48000","2020-04-27 13:07:14"
"2733","49","20200427112609","Shop","AAA01","8","80000","16000","64000","2020-04-27 11:26:09"
"2734","11","20200427094436","Shop","AAA02","12","180000","27600","152400","2020-04-27 09:44:36"
"2735","87","20200425063454","Mobile","AAA04","2","16000","800","15200","2020-04-25 06:34:54"
"2736","80","20200424123500","PC","AAA03","4","68000","12000","56000","2020-04-24 12:35:00"
"2737","38","20200424121338","Mobile","AAA04","4","32000","1600","30400","2020-04-24 12:13:38"
"2738","62","20200424112424","Mobile","AAA02","14","210000","32200","177800","2020-04-24 11:24:24"
"2739","37","20200424103431","PC","AAA04","7","56000","2800","53200","2020-04-24 10:34:31"
"2740","91","20200424090823","Shop","AAA01","6","60000","12000","48000","2020-04-24 09:08:23"
"2741","96","20200424081313","Shop","AAA04","10","80000","4000","76000","2020-04-24 08:13:13"
"2742","22","20200424070926","Mobile","AAA02","3","45000","6900","38100","2020-04-24 07:09:26"
"2743","16","20200424032206","Shop","AAA04","20","160000","8000","152000","2020-04-24 03:22:06"
"2744","29","20200423041606","Mobile","AAA04","14","112000","5600","106400","2020-04-23 16:16:06"
"2745","52","20200423032245","Mobile","AAA02","4","60000","9200","50800","2020-04-23 15:22:45"
"2746","72","20200423021335","Shop","AAA05","15","900000","300000","600000","2020-04-23 14:13:35"
"2747","64","20200423011516","Shop","AAA03","11","187000","33000","154000","2020-04-23 13:15:16"
"2748","9","20200423120356","PC","AAA04","2","16000","800","15200","2020-04-23 12:03:56"
"2749","63","20200423111350","Shop","AAA02","2","30000","4600","25400","2020-04-23 11:13:50"
"2750","4","20200423085934","PC","AAA01","3","30000","6000","24000","2020-04-23 08:59:34"
"2751","76","20200422070116","PC","AAA02","3","45000","6900","38100","2020-04-22 19:01:16"
"2752","64","20200422024051","PC","AAA01","1","10000","2000","8000","2020-04-22 14:40:51"
"2753","94","20200422011208","Shop","AAA04","9","72000","3600","68400","2020-04-22 13:12:08"
"2754","79","20200422115840","Shop","AAA01","6","60000","12000","48000","2020-04-22 11:58:40"
"2755","26","20200422083126","Shop","AAA05","4","240000","80000","160000","2020-04-22 08:31:26"
"2756","97","20200422073820","Mobile","AAA02","5","75000","11500","63500","2020-04-22 07:38:20"
"2757","45","20200422120232","Mobile","AAA04","5","40000","2000","38000","2020-04-22 00:02:32"
"2758","46","20200421034237","Shop","AAA01","4","40000","8000","32000","2020-04-21 15:42:37"
"2759","87","20200421023104","Shop","AAA01","6","60000","12000","48000","2020-04-21 14:31:04"
"2760","49","20200421014635","Mobile","AAA02","8","120000","18400","101600","2020-04-21 13:46:35"
"2761","37","20200421121456","Shop","AAA04","11","88000","4400","83600","2020-04-21 12:14:56"
"2762","95","20200421104353","Mobile","AAA02","5","75000","11500","63500","2020-04-21 10:43:53"
"2763","96","20200421075815","PC","AAA04","3","24000","1200","22800","2020-04-21 07:58:15"
"2764","47","20200420081249","PC","AAA05","23","1380000","460000","920000","2020-04-20 20:12:49"
"2765","51","20200420050847","PC","AAA02","9","135000","20700","114300","2020-04-20 17:08:47"
"2766","3","20200420035243","PC","AAA04","7","56000","2800","53200","2020-04-20 15:52:43"
"2767","76","20200420030631","PC","AAA05","5","300000","100000","200000","2020-04-20 15:06:31"
"2768","34","20200420015021","Mobile","AAA05","14","840000","280000","560000","2020-04-20 13:50:21"
"2769","63","20200420124341","Mobile","AAA02","1","15000","2300","12700","2020-04-20 12:43:41"
"2770","54","20200420113548","Mobile","AAA01","2","20000","4000","16000","2020-04-20 11:35:48"
"2771","84","20200420103318","PC","AAA01","2","20000","4000","16000","2020-04-20 10:33:18"
"2772","94","20200420084506","Shop","AAA03","11","187000","33000","154000","2020-04-20 08:45:06"
"2773","25","20200418030754","PC","AAA02","8","120000","18400","101600","2020-04-18 03:07:54"
"2774","23","20200417042722","Mobile","AAA04","9","72000","3600","68400","2020-04-17 16:27:22"
"2775","80","20200417032144","Shop","AAA04","8","64000","3200","60800","2020-04-17 15:21:44"
"2776","53","20200417020210","PC","AAA03","9","153000","27000","126000","2020-04-17 14:02:10"
"2777","94","20200417010522","Shop","AAA05","18","1080000","360000","720000","2020-04-17 13:05:22"
"2778","56","20200417115744","PC","AAA05","7","420000","140000","280000","2020-04-17 11:57:44"
"2779","3","20200417095415","Shop","AAA02","11","165000","25300","139700","2020-04-17 09:54:15"
"2780","78","20200417075520","Shop","AAA03","6","102000","18000","84000","2020-04-17 07:55:20"
"2781","42","20200417015301","PC","AAA03","11","187000","33000","154000","2020-04-17 01:53:01"
"2782","27","20200416083936","PC","AAA02","1","15000","2300","12700","2020-04-16 20:39:36"
"2783","39","20200416055742","Shop","AAA05","1","60000","20000","40000","2020-04-16 17:57:42"
"2784","65","20200416032021","Mobile","AAA01","3","30000","6000","24000","2020-04-16 15:20:21"
"2785","78","20200416021407","Shop","AAA01","8","80000","16000","64000","2020-04-16 14:14:07"
"2786","40","20200416122042","PC","AAA01","3","30000","6000","24000","2020-04-16 12:20:42"
"2787","36","20200416121134","Mobile","AAA02","11","165000","25300","139700","2020-04-16 12:11:34"
"2788","66","20200416103835","PC","AAA03","7","119000","21000","98000","2020-04-16 10:38:35"
"2789","45","20200416101426","Shop","AAA04","1","8000","400","7600","2020-04-16 10:14:26"
"2790","84","20200416091651","PC","AAA01","6","60000","12000","48000","2020-04-16 09:16:51"
"2791","11","20200416083933","Mobile","AAA02","16","240000","36800","203200","2020-04-16 08:39:33"
"2792","66","20200416065711","PC","AAA03","4","68000","12000","56000","2020-04-16 06:57:11"
"2793","78","20200415080431","Shop","AAA02","1","15000","2300","12700","2020-04-15 20:04:31"
"2794","72","20200415040800","PC","AAA02","1","15000","2300","12700","2020-04-15 16:08:00"
"2795","73","20200415032758","PC","AAA05","11","660000","220000","440000","2020-04-15 15:27:58"
"2796","82","20200415023455","Shop","AAA05","8","480000","160000","320000","2020-04-15 14:34:55"
"2797","16","20200415013219","Mobile","AAA04","17","136000","6800","129200","2020-04-15 13:32:19"
"2798","39","20200415122652","Mobile","AAA05","11","660000","220000","440000","2020-04-15 12:26:52"
"2799","46","20200415113139","Shop","AAA03","6","102000","18000","84000","2020-04-15 11:31:39"
"2800","96","20200415094452","Mobile","AAA04","9","72000","3600","68400","2020-04-15 09:44:52"
"2801","36","20200415083328","PC","AAA01","12","120000","24000","96000","2020-04-15 08:33:28"
"2802","82","20200415081435","Shop","AAA02","2","30000","4600","25400","2020-04-15 08:14:35"
"2803","46","20200415072423","Shop","AAA03","10","170000","30000","140000","2020-04-15 07:24:23"
"2804","97","20200414113751","PC","AAA03","5","85000","15000","70000","2020-04-14 23:37:51"
"2805","33","20200414101014","PC","AAA05","7","420000","140000","280000","2020-04-14 10:10:14"
"2806","74","20200414083634","Shop","AAA05","6","360000","120000","240000","2020-04-14 08:36:34"
"2807","38","20200414065417","Shop","AAA03","16","272000","48000","224000","2020-04-14 06:54:17"
"2808","6","20200413091611","Shop","AAA04","1","8000","400","7600","2020-04-13 21:16:11"
"2809","83","20200413070423","PC","AAA02","15","225000","34500","190500","2020-04-13 19:04:23"
"2810","44","20200413125528","Shop","AAA05","1","60000","20000","40000","2020-04-13 12:55:28"
"2811","2","20200413115633","PC","AAA05","4","240000","80000","160000","2020-04-13 11:56:33"
"2812","74","20200413105016","Mobile","AAA02","6","90000","13800","76200","2020-04-13 10:50:16"
"2813","96","20200413092415","PC","AAA05","3","180000","60000","120000","2020-04-13 09:24:15"
"2814","65","20200411055023","Mobile","AAA02","3","45000","6900","38100","2020-04-11 17:50:23"
"2815","92","20200410025244","Mobile","AAA04","7","56000","2800","53200","2020-04-10 14:52:44"
"2816","58","20200410021511","Shop","AAA05","11","660000","220000","440000","2020-04-10 14:15:11"
"2817","26","20200410125103","Shop","AAA05","3","180000","60000","120000","2020-04-10 12:51:03"
"2818","36","20200410105025","Mobile","AAA04","10","80000","4000","76000","2020-04-10 10:50:25"
"2819","96","20200410102140","Shop","AAA02","8","120000","18400","101600","2020-04-10 10:21:40"
"2820","30","20200410091547","Shop","AAA04","7","56000","2800","53200","2020-04-10 09:15:47"
"2821","89","20200410083743","PC","AAA02","10","150000","23000","127000","2020-04-10 08:37:43"
"2822","75","20200410083245","PC","AAA02","3","45000","6900","38100","2020-04-10 08:32:45"
"2823","76","20200409093500","PC","AAA04","6","48000","2400","45600","2020-04-09 21:35:00"
"2824","66","20200409042223","Shop","AAA05","4","240000","80000","160000","2020-04-09 16:22:23"
"2825","89","20200409030451","Mobile","AAA02","20","300000","46000","254000","2020-04-09 15:04:51"
"2826","98","20200409020710","Shop","AAA03","1","17000","3000","14000","2020-04-09 14:07:10"
"2827","89","20200409114020","Shop","AAA01","7","70000","14000","56000","2020-04-09 11:40:20"
"2828","94","20200409092009","Mobile","AAA04","10","80000","4000","76000","2020-04-09 09:20:09"
"2829","65","20200409080547","Shop","AAA02","3","45000","6900","38100","2020-04-09 08:05:47"
"2830","91","20200409064112","Mobile","AAA04","3","24000","1200","22800","2020-04-09 06:41:12"
"2831","49","20200408062026","Shop","AAA05","4","240000","80000","160000","2020-04-08 18:20:26"
"2832","92","20200408120400","Shop","AAA01","5","50000","10000","40000","2020-04-08 12:04:00"
"2833","68","20200408102804","Shop","AAA02","7","105000","16100","88900","2020-04-08 10:28:04"
"2834","59","20200408092355","PC","AAA03","7","119000","21000","98000","2020-04-08 09:23:55"
"2835","59","20200408080237","Shop","AAA04","4","32000","1600","30400","2020-04-08 08:02:37"
"2836","11","20200408063514","Mobile","AAA04","18","144000","7200","136800","2020-04-08 06:35:14"
"2837","77","20200407043656","Shop","AAA02","8","120000","18400","101600","2020-04-07 16:36:56"
"2838","73","20200407032130","Shop","AAA05","14","840000","280000","560000","2020-04-07 15:21:30"
"2839","82","20200407012311","PC","AAA03","1","17000","3000","14000","2020-04-07 13:23:11"
"2840","21","20200407121925","Mobile","AAA04","11","88000","4400","83600","2020-04-07 12:19:25"
"2841","61","20200407100634","PC","AAA04","5","40000","2000","38000","2020-04-07 10:06:34"
"2842","26","20200407083854","PC","AAA04","4","32000","1600","30400","2020-04-07 08:38:54"
"2843","28","20200407072041","Shop","AAA04","4","32000","1600","30400","2020-04-07 07:20:41"
"2844","77","20200406064317","Mobile","AAA05","1","60000","20000","40000","2020-04-06 18:43:17"
"2845","6","20200406032743","PC","AAA03","1","17000","3000","14000","2020-04-06 15:27:43"
"2846","64","20200406023941","Mobile","AAA01","12","120000","24000","96000","2020-04-06 14:39:41"
"2847","55","20200406014810","Mobile","AAA03","12","204000","36000","168000","2020-04-06 13:48:10"
"2848","65","20200406124126","Mobile","AAA01","4","40000","8000","32000","2020-04-06 12:41:26"
"2849","83","20200406111038","PC","AAA02","12","180000","27600","152400","2020-04-06 11:10:38"
"2850","99","20200406100058","Shop","AAA05","3","180000","60000","120000","2020-04-06 10:00:58"
"2851","35","20200406083629","Shop","AAA01","5","50000","10000","40000","2020-04-06 08:36:29"
"2852","22","20200403043814","Mobile","AAA01","7","70000","14000","56000","2020-04-03 04:38:14"
"2853","63","20200402071604","PC","AAA02","6","90000","13800","76200","2020-04-02 19:16:04"
"2854","1","20200402035415","Mobile","AAA03","8","136000","24000","112000","2020-04-02 15:54:15"
"2855","17","20200402030146","PC","AAA01","1","10000","2000","8000","2020-04-02 15:01:46"
"2856","20","20200402111155","PC","AAA05","8","480000","160000","320000","2020-04-02 11:11:55"
"2857","97","20200402093542","Shop","AAA05","5","300000","100000","200000","2020-04-02 09:35:42"
"2858","81","20200402081313","PC","AAA01","13","130000","26000","104000","2020-04-02 08:13:13"
"2859","23","20200402063942","Shop","AAA03","2","34000","6000","28000","2020-04-02 06:39:42"
"2860","55","20200401104909","Mobile","AAA01","2","20000","4000","16000","2020-04-01 22:49:09"
"2861","81","20200401062300","Shop","AAA04","6","48000","2400","45600","2020-04-01 18:23:00"
"2862","52","20200401010433","Mobile","AAA04","2","16000","800","15200","2020-04-01 13:04:33"
"2863","61","20200401103820","PC","AAA05","3","180000","60000","120000","2020-04-01 10:38:20"
"2864","16","20200401093240","Mobile","AAA05","16","960000","320000","640000","2020-04-01 09:32:40"
"2865","46","20200401075506","Mobile","AAA02","7","105000","16100","88900","2020-04-01 07:55:06"
"2866","96","20200401011727","Shop","AAA04","6","48000","2400","45600","2020-04-01 01:17:27"
"2867","63","20200331124452","Shop","AAA04","6","48000","2400","45600","2020-03-31 12:44:52"
"2868","92","20200331104626","Shop","AAA04","15","120000","6000","114000","2020-03-31 10:46:26"
"2869","1","20200331095125","Shop","AAA01","3","30000","6000","24000","2020-03-31 09:51:25"
"2870","39","20200331081500","Mobile","AAA03","6","102000","18000","84000","2020-03-31 08:15:00"
"2871","89","20200331071529","PC","AAA04","26","208000","10400","197600","2020-03-31 07:15:29"
"2872","66","20200330050018","Mobile","AAA03","3","51000","9000","42000","2020-03-30 17:00:18"
"2873","9","20200330044905","Mobile","AAA05","4","240000","80000","160000","2020-03-30 16:49:05"
"2874","97","20200330030753","Shop","AAA05","9","540000","180000","360000","2020-03-30 15:07:53"
"2875","81","20200330022341","Shop","AAA02","4","60000","9200","50800","2020-03-30 14:23:41"
"2876","21","20200330125405","Shop","AAA05","6","360000","120000","240000","2020-03-30 12:54:05"
"2877","3","20200330101146","Mobile","AAA03","21","357000","63000","294000","2020-03-30 10:11:46"
"2878","30","20200330090039","Shop","AAA03","1","17000","3000","14000","2020-03-30 09:00:39"
"2879","6","20200327051048","PC","AAA01","8","80000","16000","64000","2020-03-27 17:10:48"
"2880","89","20200327035541","Shop","AAA04","6","48000","2400","45600","2020-03-27 15:55:41"
"2881","34","20200327023720","Shop","AAA01","5","50000","10000","40000","2020-03-27 14:37:20"
"2882","76","20200327124824","PC","AAA01","5","50000","10000","40000","2020-03-27 12:48:24"
"2883","74","20200327111042","Shop","AAA03","11","187000","33000","154000","2020-03-27 11:10:42"
"2884","67","20200327084828","PC","AAA03","14","238000","42000","196000","2020-03-27 08:48:28"
"2885","7","20200326072816","PC","AAA01","3","30000","6000","24000","2020-03-26 19:28:16"
"2886","32","20200326025109","Mobile","AAA04","15","120000","6000","114000","2020-03-26 14:51:09"
"2887","76","20200326013806","PC","AAA02","4","60000","9200","50800","2020-03-26 13:38:06"
"2888","20","20200326120948","Mobile","AAA01","5","50000","10000","40000","2020-03-26 12:09:48"
"2889","77","20200326094049","PC","AAA04","4","32000","1600","30400","2020-03-26 09:40:49"
"2890","13","20200326081105","Shop","AAA02","1","15000","2300","12700","2020-03-26 08:11:05"
"2891","59","20200326071718","Mobile","AAA01","8","80000","16000","64000","2020-03-26 07:17:18"
"2892","20","20200325113938","Shop","AAA02","7","105000","16100","88900","2020-03-25 23:39:38"
"2893","69","20200325113851","Mobile","AAA03","6","102000","18000","84000","2020-03-25 11:38:51"
"2894","45","20200325091645","Mobile","AAA02","5","75000","11500","63500","2020-03-25 09:16:45"
"2895","81","20200325082446","Shop","AAA05","6","360000","120000","240000","2020-03-25 08:24:46"
"2896","25","20200325070025","PC","AAA04","1","8000","400","7600","2020-03-25 07:00:25"
"2897","13","20200324102818","Mobile","AAA01","8","80000","16000","64000","2020-03-24 22:28:18"
"2898","56","20200324042520","Shop","AAA04","15","120000","6000","114000","2020-03-24 16:25:20"
"2899","65","20200324030128","PC","AAA03","6","102000","18000","84000","2020-03-24 15:01:28"
"2900","62","20200324022319","Mobile","AAA04","14","112000","5600","106400","2020-03-24 14:23:19"
"2901","24","20200324111207","Shop","AAA05","3","180000","60000","120000","2020-03-24 11:12:07"
"2902","40","20200324075016","Mobile","AAA02","5","75000","11500","63500","2020-03-24 07:50:16"
"2903","38","20200323064739","Shop","AAA01","9","90000","18000","72000","2020-03-23 18:47:39"
"2904","8","20200323023539","PC","AAA02","3","45000","6900","38100","2020-03-23 14:35:39"
"2905","86","20200323010746","Mobile","AAA03","5","85000","15000","70000","2020-03-23 13:07:46"
"2906","19","20200323114423","Mobile","AAA03","1","17000","3000","14000","2020-03-23 11:44:23"
"2907","50","20200323105430","Mobile","AAA05","4","240000","80000","160000","2020-03-23 10:54:30"
"2908","3","20200323092407","PC","AAA03","11","187000","33000","154000","2020-03-23 09:24:07"
"2909","65","20200320084025","PC","AAA04","1","8000","400","7600","2020-03-20 20:40:25"
"2910","89","20200320055744","PC","AAA01","30","300000","60000","240000","2020-03-20 17:57:44"
"2911","28","20200320051337","Shop","AAA02","4","60000","9200","50800","2020-03-20 17:13:37"
"2912","65","20200320035324","Mobile","AAA02","13","195000","29900","165100","2020-03-20 15:53:24"
"2913","69","20200320023901","Shop","AAA04","1","8000","400","7600","2020-03-20 14:39:01"
"2914","76","20200320012730","PC","AAA05","12","720000","240000","480000","2020-03-20 13:27:30"
"2915","25","20200320125302","PC","AAA02","5","75000","11500","63500","2020-03-20 12:53:02"
"2916","28","20200320094039","Mobile","AAA05","5","300000","100000","200000","2020-03-20 09:40:39"
"2917","31","20200320083112","Mobile","AAA03","4","68000","12000","56000","2020-03-20 08:31:12"
"2918","50","20200320070901","Mobile","AAA03","12","204000","36000","168000","2020-03-20 07:09:01"
"2919","5","20200319071039","Shop","AAA02","13","195000","29900","165100","2020-03-19 19:10:39"
"2920","5","20200319034132","Mobile","AAA04","2","16000","800","15200","2020-03-19 15:41:32"
"2921","72","20200319020721","PC","AAA04","6","48000","2400","45600","2020-03-19 14:07:21"
"2922","79","20200319123506","Shop","AAA02","9","135000","20700","114300","2020-03-19 12:35:06"
"2923","67","20200319122108","Mobile","AAA02","9","135000","20700","114300","2020-03-19 12:21:08"
"2924","64","20200319113423","PC","AAA03","7","119000","21000","98000","2020-03-19 11:34:23"
"2925","44","20200319095318","Mobile","AAA02","6","90000","13800","76200","2020-03-19 09:53:18"
"2926","90","20200319084828","Shop","AAA01","3","30000","6000","24000","2020-03-19 08:48:28"
"2927","64","20200319073349","PC","AAA02","10","150000","23000","127000","2020-03-19 07:33:49"
"2928","89","20200318050929","Mobile","AAA05","26","1560000","520000","1040000","2020-03-18 17:09:29"
"2929","96","20200318042035","Shop","AAA01","2","20000","4000","16000","2020-03-18 16:20:35"
"2930","22","20200318033941","Shop","AAA01","7","70000","14000","56000","2020-03-18 15:39:41"
"2931","29","20200318024226","PC","AAA03","4","68000","12000","56000","2020-03-18 14:42:26"
"2932","18","20200318012425","Mobile","AAA05","7","420000","140000","280000","2020-03-18 13:24:25"
"2933","2","20200318113907","Mobile","AAA02","6","90000","13800","76200","2020-03-18 11:39:07"
"2934","61","20200318100908","PC","AAA03","7","119000","21000","98000","2020-03-18 10:09:08"
"2935","98","20200318085508","PC","AAA02","1","15000","2300","12700","2020-03-18 08:55:08"
"2936","47","20200318080725","PC","AAA02","1","15000","2300","12700","2020-03-18 08:07:25"
"2937","78","20200318064442","Shop","AAA01","1","10000","2000","8000","2020-03-18 06:44:42"
"2938","85","20200317043046","Mobile","AAA04","4","32000","1600","30400","2020-03-17 16:30:46"
"2939","92","20200317034033","Mobile","AAA04","4","32000","1600","30400","2020-03-17 15:40:33"
"2940","62","20200317012527","PC","AAA05","12","720000","240000","480000","2020-03-17 13:25:27"
"2941","77","20200317115550","PC","AAA03","7","119000","21000","98000","2020-03-17 11:55:50"
"2942","30","20200317111059","Mobile","AAA02","7","105000","16100","88900","2020-03-17 11:10:59"
"2943","43","20200317095044","PC","AAA03","7","119000","21000","98000","2020-03-17 09:50:44"
"2944","53","20200317085741","PC","AAA01","2","20000","4000","16000","2020-03-17 08:57:41"
"2945","42","20200317030228","Shop","AAA05","9","540000","180000","360000","2020-03-17 03:02:28"
"2946","89","20200316043031","Shop","AAA04","14","112000","5600","106400","2020-03-16 16:30:31"
"2947","36","20200316034126","Mobile","AAA03","10","170000","30000","140000","2020-03-16 15:41:26"
"2948","100","20200316024630","Mobile","AAA04","6","48000","2400","45600","2020-03-16 14:46:30"
"2949","67","20200316012418","Mobile","AAA05","8","480000","160000","320000","2020-03-16 13:24:18"
"2950","36","20200316115811","PC","AAA02","19","285000","43700","241300","2020-03-16 11:58:11"
"2951","87","20200316110059","PC","AAA02","1","15000","2300","12700","2020-03-16 11:00:59"
"2952","15","20200316100731","Shop","AAA04","21","168000","8400","159600","2020-03-16 10:07:31"
"2953","7","20200316091951","Shop","AAA05","2","120000","40000","80000","2020-03-16 09:19:51"
"2954","70","20200313060133","Shop","AAA02","8","120000","18400","101600","2020-03-13 06:01:33"
"2955","53","20200312100351","Shop","AAA03","8","136000","24000","112000","2020-03-12 22:03:51"
"2956","99","20200312010758","Shop","AAA02","1","15000","2300","12700","2020-03-12 13:07:58"
"2957","32","20200312113415","Shop","AAA01","3","30000","6000","24000","2020-03-12 11:34:15"
"2958","10","20200312104026","Mobile","AAA01","16","160000","32000","128000","2020-03-12 10:40:26"
"2959","79","20200312074451","Mobile","AAA03","12","204000","36000","168000","2020-03-12 07:44:51"
"2960","97","20200311101000","PC","AAA03","7","119000","21000","98000","2020-03-11 22:10:00"
"2961","13","20200311075922","PC","AAA03","4","68000","12000","56000","2020-03-11 19:59:22"
"2962","95","20200311041348","Mobile","AAA05","1","60000","20000","40000","2020-03-11 16:13:48"
"2963","7","20200311025702","Mobile","AAA01","1","10000","2000","8000","2020-03-11 14:57:02"
"2964","77","20200311013251","Mobile","AAA05","1","60000","20000","40000","2020-03-11 13:32:51"
"2965","100","20200311125805","PC","AAA03","1","17000","3000","14000","2020-03-11 12:58:05"
"2966","44","20200311122533","Shop","AAA02","4","60000","9200","50800","2020-03-11 12:25:33"
"2967","10","20200311114957","Shop","AAA02","8","120000","18400","101600","2020-03-11 11:49:57"
"2968","43","20200311103352","Mobile","AAA03","8","136000","24000","112000","2020-03-11 10:33:52"
"2969","79","20200311072303","Shop","AAA03","1","17000","3000","14000","2020-03-11 07:23:03"
"2970","28","20200310013354","PC","AAA01","11","110000","22000","88000","2020-03-10 13:33:54"
"2971","11","20200310110838","Shop","AAA04","11","88000","4400","83600","2020-03-10 11:08:38"
"2972","67","20200310085507","Shop","AAA04","6","48000","2400","45600","2020-03-10 08:55:07"
"2973","96","20200309110652","Mobile","AAA04","11","88000","4400","83600","2020-03-09 23:06:52"
"2974","32","20200309021248","Shop","AAA02","5","75000","11500","63500","2020-03-09 14:12:48"
"2975","71","20200309011046","Shop","AAA01","7","70000","14000","56000","2020-03-09 13:10:46"
"2976","22","20200309110709","Mobile","AAA02","9","135000","20700","114300","2020-03-09 11:07:09"
"2977","13","20200309095008","PC","AAA02","7","105000","16100","88900","2020-03-09 09:50:08"
"2978","22","20200307053639","Shop","AAA01","3","30000","6000","24000","2020-03-07 05:36:39"
"2979","68","20200306104216","Mobile","AAA01","8","80000","16000","64000","2020-03-06 10:42:16"
"2980","94","20200306090450","Mobile","AAA01","11","110000","22000","88000","2020-03-06 09:04:50"
"2981","70","20200306073003","Mobile","AAA01","8","80000","16000","64000","2020-03-06 07:30:03"
"2982","45","20200305102159","Shop","AAA01","3","30000","6000","24000","2020-03-05 22:21:59"
"2983","86","20200305062909","PC","AAA01","11","110000","22000","88000","2020-03-05 18:29:09"
"2984","93","20200305022345","Mobile","AAA01","1","10000","2000","8000","2020-03-05 14:23:45"
"2985","20","20200305013305","Shop","AAA01","1","10000","2000","8000","2020-03-05 13:33:05"
"2986","87","20200305013151","Mobile","AAA04","5","40000","2000","38000","2020-03-05 13:31:51"
"2987","88","20200305120641","Shop","AAA03","8","136000","24000","112000","2020-03-05 12:06:41"
"2988","43","20200305102052","Mobile","AAA01","10","100000","20000","80000","2020-03-05 10:20:52"
"2989","70","20200305094331","Mobile","AAA05","20","1200000","400000","800000","2020-03-05 09:43:31"
"2990","44","20200305092216","Mobile","AAA02","6","90000","13800","76200","2020-03-05 09:22:16"
"2991","83","20200305090015","Mobile","AAA03","9","153000","27000","126000","2020-03-05 09:00:15"
"2992","7","20200305073944","Mobile","AAA03","9","153000","27000","126000","2020-03-05 07:39:44"
"2993","22","20200304072023","Mobile","AAA03","5","85000","15000","70000","2020-03-04 19:20:23"
"2994","34","20200304023608","Mobile","AAA05","13","780000","260000","520000","2020-03-04 14:36:08"
"2995","88","20200304010754","PC","AAA03","5","85000","15000","70000","2020-03-04 13:07:54"
"2996","84","20200304114920","Shop","AAA03","4","68000","12000","56000","2020-03-04 11:49:20"
"2997","84","20200304112321","PC","AAA03","4","68000","12000","56000","2020-03-04 11:23:21"
"2998","92","20200304094353","Mobile","AAA05","5","300000","100000","200000","2020-03-04 09:43:53"
"2999","83","20200304084207","Shop","AAA05","22","1320000","440000","880000","2020-03-04 08:42:07"
"3000","19","20200304073731","PC","AAA02","8","120000","18400","101600","2020-03-04 07:37:31"
"3001","63","20200303070037","PC","AAA02","2","30000","4600","25400","2020-03-03 19:00:37"
"3002","55","20200303020545","Shop","AAA05","7","420000","140000","280000","2020-03-03 14:05:45"
"3003","83","20200303014917","Shop","AAA04","9","72000","3600","68400","2020-03-03 13:49:17"
"3004","30","20200303125501","PC","AAA03","3","51000","9000","42000","2020-03-03 12:55:01"
"3005","19","20200303122505","PC","AAA04","8","64000","3200","60800","2020-03-03 12:25:05"
"3006","78","20200303114059","PC","AAA02","2","30000","4600","25400","2020-03-03 11:40:59"
"3007","57","20200303102136","Shop","AAA05","1","60000","20000","40000","2020-03-03 10:21:36"
"3008","68","20200303092227","Shop","AAA05","1","60000","20000","40000","2020-03-03 09:22:27"
"3009","80","20200302105819","Shop","AAA01","7","70000","14000","56000","2020-03-02 22:58:19"
"3010","78","20200302064810","Shop","AAA02","2","30000","4600","25400","2020-03-02 18:48:10"
"3011","46","20200302034501","Mobile","AAA04","9","72000","3600","68400","2020-03-02 15:45:01"
"3012","60","20200302015608","Mobile","AAA03","3","51000","9000","42000","2020-03-02 13:56:08"
"3013","84","20200302123846","Shop","AAA04","3","24000","1200","22800","2020-03-02 12:38:46"
"3014","95","20200302115955","Mobile","AAA05","1","60000","20000","40000","2020-03-02 11:59:55"
"3015","68","20200302104608","Mobile","AAA01","4","40000","8000","32000","2020-03-02 10:46:08"
"3016","10","20200302100707","PC","AAA01","4","40000","8000","32000","2020-03-02 10:07:07"
"3017","44","20200302093404","Mobile","AAA02","5","75000","11500","63500","2020-03-02 09:34:04"
"3018","12","20200229120808","Shop","AAA02","5","75000","11500","63500","2020-02-29 00:08:08"
"3019","92","20200228054548","PC","AAA01","10","100000","20000","80000","2020-02-28 05:45:48"
"3020","37","20200227061401","PC","AAA03","21","357000","63000","294000","2020-02-27 18:14:01"
"3021","55","20200227015822","Mobile","AAA04","7","56000","2800","53200","2020-02-27 13:58:22"
"3022","46","20200227125752","Shop","AAA02","10","150000","23000","127000","2020-02-27 12:57:52"
"3023","30","20200227115212","Mobile","AAA03","9","153000","27000","126000","2020-02-27 11:52:12"
"3024","47","20200227101008","Shop","AAA01","14","140000","28000","112000","2020-02-27 10:10:08"
"3025","47","20200227085226","Mobile","AAA01","13","130000","26000","104000","2020-02-27 08:52:26"
"3026","23","20200227080506","Mobile","AAA04","5","40000","2000","38000","2020-02-27 08:05:06"
"3027","68","20200227061907","Shop","AAA05","9","540000","180000","360000","2020-02-27 06:19:07"
"3028","59","20200226104817","PC","AAA05","3","180000","60000","120000","2020-02-26 22:48:17"
"3029","100","20200226061009","Mobile","AAA02","1","15000","2300","12700","2020-02-26 18:10:09"
"3030","92","20200226012232","Mobile","AAA02","9","135000","20700","114300","2020-02-26 13:22:32"
"3031","40","20200226114439","PC","AAA05","3","180000","60000","120000","2020-02-26 11:44:39"
"3032","70","20200226103116","PC","AAA04","17","136000","6800","129200","2020-02-26 10:31:16"
"3033","25","20200226092039","Shop","AAA03","9","153000","27000","126000","2020-02-26 09:20:39"
"3034","62","20200226074233","Mobile","AAA04","8","64000","3200","60800","2020-02-26 07:42:33"
"3035","33","20200225102802","Shop","AAA04","13","104000","5200","98800","2020-02-25 22:28:02"
"3036","62","20200225081119","Mobile","AAA01","10","100000","20000","80000","2020-02-25 20:11:19"
"3037","25","20200225034606","Mobile","AAA05","14","840000","280000","560000","2020-02-25 15:46:06"
"3038","100","20200225031353","Shop","AAA05","2","120000","40000","80000","2020-02-25 15:13:53"
"3039","4","20200225021241","Shop","AAA02","4","60000","9200","50800","2020-02-25 14:12:41"
"3040","58","20200225111158","PC","AAA01","6","60000","12000","48000","2020-02-25 11:11:58"
"3041","25","20200225101858","Shop","AAA05","3","180000","60000","120000","2020-02-25 10:18:58"
"3042","56","20200225092954","PC","AAA03","4","68000","12000","56000","2020-02-25 09:29:54"
"3043","6","20200225091741","Mobile","AAA01","3","30000","6000","24000","2020-02-25 09:17:41"
"3044","76","20200225082908","Mobile","AAA02","8","120000","18400","101600","2020-02-25 08:29:08"
"3045","28","20200225074919","Mobile","AAA05","11","660000","220000","440000","2020-02-25 07:49:19"
"3046","36","20200224043505","PC","AAA05","9","540000","180000","360000","2020-02-24 16:35:05"
"3047","88","20200224030740","Shop","AAA04","10","80000","4000","76000","2020-02-24 15:07:40"
"3048","32","20200224020527","Shop","AAA05","5","300000","100000","200000","2020-02-24 14:05:27"
"3049","51","20200224123146","Shop","AAA02","9","135000","20700","114300","2020-02-24 12:31:46"
"3050","60","20200224112406","Mobile","AAA05","2","120000","40000","80000","2020-02-24 11:24:06"
"3051","58","20200224101220","Shop","AAA03","5","85000","15000","70000","2020-02-24 10:12:20"
"3052","21","20200224091718","Mobile","AAA04","1","8000","400","7600","2020-02-24 09:17:18"
"3053","3","20200222011143","Mobile","AAA04","19","152000","7600","144400","2020-02-22 01:11:43"
"3054","22","20200221020113","Mobile","AAA05","4","240000","80000","160000","2020-02-21 14:01:13"
"3055","55","20200221010132","Mobile","AAA04","5","40000","2000","38000","2020-02-21 13:01:32"
"3056","59","20200221115402","Mobile","AAA03","8","136000","24000","112000","2020-02-21 11:54:02"
"3057","65","20200221110833","PC","AAA05","12","720000","240000","480000","2020-02-21 11:08:33"
"3058","64","20200221102728","Shop","AAA03","2","34000","6000","28000","2020-02-21 10:27:28"
"3059","61","20200221091939","Mobile","AAA02","7","105000","16100","88900","2020-02-21 09:19:39"
"3060","30","20200221085455","PC","AAA01","15","150000","30000","120000","2020-02-21 08:54:55"
"3061","92","20200221072334","PC","AAA01","6","60000","12000","48000","2020-02-21 07:23:34"
"3062","95","20200220111325","PC","AAA04","3","24000","1200","22800","2020-02-20 23:13:25"
"3063","57","20200220051344","Shop","AAA01","4","40000","8000","32000","2020-02-20 17:13:44"
"3064","44","20200220035924","PC","AAA04","3","24000","1200","22800","2020-02-20 15:59:24"
"3065","83","20200220030908","Shop","AAA02","19","285000","43700","241300","2020-02-20 15:09:08"
"3066","13","20200220020302","PC","AAA01","3","30000","6000","24000","2020-02-20 14:03:02"
"3067","75","20200220010000","PC","AAA03","1","17000","3000","14000","2020-02-20 13:00:00"
"3068","7","20200220111741","Shop","AAA05","4","240000","80000","160000","2020-02-20 11:17:41"
"3069","95","20200220104528","Mobile","AAA05","6","360000","120000","240000","2020-02-20 10:45:28"
"3070","60","20200220092856","Shop","AAA02","4","60000","9200","50800","2020-02-20 09:28:56"
"3071","60","20200220081349","Shop","AAA05","12","720000","240000","480000","2020-02-20 08:13:49"
"3072","48","20200220070228","Mobile","AAA05","4","240000","80000","160000","2020-02-20 07:02:28"
"3073","69","20200220060017","Mobile","AAA04","4","32000","1600","30400","2020-02-20 06:00:17"
"3074","60","20200219042633","PC","AAA05","1","60000","20000","40000","2020-02-19 16:26:33"
"3075","3","20200219034354","Shop","AAA05","4","240000","80000","160000","2020-02-19 15:43:54"
"3076","59","20200219010434","PC","AAA02","8","120000","18400","101600","2020-02-19 13:04:34"
"3077","70","20200219082602","Mobile","AAA03","9","153000","27000","126000","2020-02-19 08:26:02"
"3078","8","20200218060330","PC","AAA03","1","17000","3000","14000","2020-02-18 18:03:30"
"3079","94","20200218011811","Mobile","AAA03","16","272000","48000","224000","2020-02-18 13:18:11"
"3080","92","20200218120222","PC","AAA01","8","80000","16000","64000","2020-02-18 12:02:22"
"3081","25","20200218093611","Mobile","AAA05","11","660000","220000","440000","2020-02-18 09:36:11"
"3082","57","20200218090712","PC","AAA01","7","70000","14000","56000","2020-02-18 09:07:12"
"3083","94","20200218082957","PC","AAA01","7","70000","14000","56000","2020-02-18 08:29:57"
"3084","18","20200218071814","Shop","AAA05","2","120000","40000","80000","2020-02-18 07:18:14"
"3085","53","20200217102628","PC","AAA04","8","64000","3200","60800","2020-02-17 22:26:28"
"3086","24","20200217065100","Shop","AAA01","12","120000","24000","96000","2020-02-17 18:51:00"
"3087","77","20200217050008","Mobile","AAA01","1","10000","2000","8000","2020-02-17 17:00:08"
"3088","84","20200217040329","PC","AAA04","4","32000","1600","30400","2020-02-17 16:03:29"
"3089","1","20200217013627","PC","AAA03","9","153000","27000","126000","2020-02-17 13:36:27"
"3090","52","20200217124431","Mobile","AAA02","4","60000","9200","50800","2020-02-17 12:44:31"
"3091","94","20200217113657","Mobile","AAA01","23","230000","46000","184000","2020-02-17 11:36:57"
"3092","7","20200217102127","Shop","AAA05","13","780000","260000","520000","2020-02-17 10:21:27"
"3093","100","20200217092032","Shop","AAA01","7","70000","14000","56000","2020-02-17 09:20:32"
"3094","59","20200215105911","PC","AAA04","3","24000","1200","22800","2020-02-15 10:59:11"
"3095","4","20200215045941","Shop","AAA03","5","85000","15000","70000","2020-02-15 04:59:41"
"3096","10","20200214090900","Shop","AAA01","7","70000","14000","56000","2020-02-14 21:09:00"
"3097","75","20200214063853","Mobile","AAA02","6","90000","13800","76200","2020-02-14 18:38:53"
"3098","98","20200214014023","PC","AAA02","1","15000","2300","12700","2020-02-14 13:40:23"
"3099","58","20200214124830","PC","AAA02","7","105000","16100","88900","2020-02-14 12:48:30"
"3100","73","20200214113045","PC","AAA03","7","119000","21000","98000","2020-02-14 11:30:45"
"3101","6","20200214104932","Shop","AAA04","4","32000","1600","30400","2020-02-14 10:49:32"
"3102","42","20200214094355","Mobile","AAA02","5","75000","11500","63500","2020-02-14 09:43:55"
"3103","93","20200214071441","Mobile","AAA02","8","120000","18400","101600","2020-02-14 07:14:41"
"3104","12","20200213070502","PC","AAA02","9","135000","20700","114300","2020-02-13 19:05:02"
"3105","22","20200213044343","PC","AAA04","4","32000","1600","30400","2020-02-13 16:43:43"
"3106","6","20200213035211","PC","AAA01","2","20000","4000","16000","2020-02-13 15:52:11"
"3107","68","20200213024639","Shop","AAA05","8","480000","160000","320000","2020-02-13 14:46:39"
"3108","81","20200213010650","PC","AAA01","1","10000","2000","8000","2020-02-13 13:06:50"
"3109","70","20200213115513","Shop","AAA03","10","170000","30000","140000","2020-02-13 11:55:13"
"3110","73","20200213100124","PC","AAA03","1","17000","3000","14000","2020-02-13 10:01:24"
"3111","11","20200213091152","PC","AAA05","9","540000","180000","360000","2020-02-13 09:11:52"
"3112","36","20200212081101","Mobile","AAA05","8","480000","160000","320000","2020-02-12 20:11:01"
"3113","66","20200212044606","Shop","AAA03","4","68000","12000","56000","2020-02-12 16:46:06"
"3114","62","20200212034309","Shop","AAA01","5","50000","10000","40000","2020-02-12 15:43:09"
"3115","58","20200212024558","Shop","AAA03","11","187000","33000","154000","2020-02-12 14:45:58"
"3116","40","20200212014233","Shop","AAA02","8","120000","18400","101600","2020-02-12 13:42:33"
"3117","90","20200212113829","Shop","AAA05","1","60000","20000","40000","2020-02-12 11:38:29"
"3118","19","20200212094651","PC","AAA03","4","68000","12000","56000","2020-02-12 09:46:51"
"3119","46","20200212084613","Mobile","AAA02","3","45000","6900","38100","2020-02-12 08:46:13"
"3120","62","20200212071442","PC","AAA05","1","60000","20000","40000","2020-02-12 07:14:42"
"3121","36","20200211115733","PC","AAA03","9","153000","27000","126000","2020-02-11 23:57:33"
"3122","41","20200211104838","Shop","AAA03","14","238000","42000","196000","2020-02-11 10:48:38"
"3123","30","20200211082059","PC","AAA05","16","960000","320000","640000","2020-02-11 08:20:59"
"3124","47","20200211065331","Shop","AAA03","9","153000","27000","126000","2020-02-11 06:53:31"
"3125","90","20200210101856","Mobile","AAA02","8","120000","18400","101600","2020-02-10 22:18:56"
"3126","16","20200210063942","Mobile","AAA03","18","306000","54000","252000","2020-02-10 18:39:42"
"3127","39","20200210042139","Shop","AAA03","3","51000","9000","42000","2020-02-10 16:21:39"
"3128","33","20200210033447","PC","AAA03","5","85000","15000","70000","2020-02-10 15:34:47"
"3129","66","20200210022331","PC","AAA02","4","60000","9200","50800","2020-02-10 14:23:31"
"3130","77","20200210013835","Mobile","AAA01","2","20000","4000","16000","2020-02-10 13:38:35"
"3131","8","20200210121656","Shop","AAA04","6","48000","2400","45600","2020-02-10 12:16:56"
"3132","74","20200210110831","Mobile","AAA02","3","45000","6900","38100","2020-02-10 11:08:31"
"3133","73","20200210095914","PC","AAA01","2","20000","4000","16000","2020-02-10 09:59:14"
"3134","24","20200206102626","Mobile","AAA03","14","238000","42000","196000","2020-02-06 22:26:26"
"3135","86","20200206064807","Shop","AAA04","3","24000","1200","22800","2020-02-06 18:48:07"
"3136","57","20200206034937","PC","AAA02","2","30000","4600","25400","2020-02-06 15:49:37"
"3137","92","20200206025800","Mobile","AAA05","3","180000","60000","120000","2020-02-06 14:58:00"
"3138","80","20200206011611","PC","AAA01","1","10000","2000","8000","2020-02-06 13:16:11"
"3139","64","20200206122805","Shop","AAA03","5","85000","15000","70000","2020-02-06 12:28:05"
"3140","33","20200206110949","Mobile","AAA05","5","300000","100000","200000","2020-02-06 11:09:49"
"3141","26","20200206094826","Mobile","AAA04","13","104000","5200","98800","2020-02-06 09:48:26"
"3142","97","20200206083035","Shop","AAA01","2","20000","4000","16000","2020-02-06 08:30:35"
"3143","25","20200206074404","Mobile","AAA03","7","119000","21000","98000","2020-02-06 07:44:04"
"3144","68","20200205092828","PC","AAA02","1","15000","2300","12700","2020-02-05 21:28:28"
"3145","74","20200205065801","Shop","AAA03","4","68000","12000","56000","2020-02-05 18:58:01"
"3146","63","20200205124533","Shop","AAA04","13","104000","5200","98800","2020-02-05 12:45:33"
"3147","37","20200205121805","PC","AAA04","1","8000","400","7600","2020-02-05 12:18:05"
"3148","58","20200205095157","Shop","AAA01","6","60000","12000","48000","2020-02-05 09:51:57"
"3149","27","20200205081932","Shop","AAA02","11","165000","25300","139700","2020-02-05 08:19:32"
"3150","13","20200204034931","Mobile","AAA04","1","8000","400","7600","2020-02-04 15:49:31"
"3151","100","20200204013952","PC","AAA04","4","32000","1600","30400","2020-02-04 13:39:52"
"3152","54","20200204124655","Shop","AAA05","13","780000","260000","520000","2020-02-04 12:46:55"
"3153","93","20200204112638","PC","AAA02","8","120000","18400","101600","2020-02-04 11:26:38"
"3154","37","20200204093938","Mobile","AAA04","2","16000","800","15200","2020-02-04 09:39:38"
"3155","90","20200204074419","Mobile","AAA01","10","100000","20000","80000","2020-02-04 07:44:19"
"3156","46","20200203021046","Mobile","AAA05","8","480000","160000","320000","2020-02-03 14:10:46"
"3157","54","20200203115648","PC","AAA05","7","420000","140000","280000","2020-02-03 11:56:48"
"3158","83","20200203100123","PC","AAA03","27","459000","81000","378000","2020-02-03 10:01:23"
"3159","53","20200203092801","PC","AAA05","7","420000","140000","280000","2020-02-03 09:28:01"
"3160","72","20200201030744","Shop","AAA02","6","90000","13800","76200","2020-02-01 03:07:44"
"3161","91","20200131035952","PC","AAA05","2","120000","40000","80000","2020-01-31 15:59:52"
"3162","25","20200131022811","PC","AAA02","6","90000","13800","76200","2020-01-31 14:28:11"
"3163","93","20200131124431","PC","AAA03","8","136000","24000","112000","2020-01-31 12:44:31"
"3164","33","20200131105222","PC","AAA05","1","60000","20000","40000","2020-01-31 10:52:22"
"3165","24","20200131093903","Mobile","AAA02","1","15000","2300","12700","2020-01-31 09:39:03"
"3166","97","20200131083707","PC","AAA03","15","255000","45000","210000","2020-01-31 08:37:07"
"3167","25","20200131072747","Shop","AAA02","13","195000","29900","165100","2020-01-31 07:27:47"
"3168","2","20200130110508","Mobile","AAA05","4","240000","80000","160000","2020-01-30 23:05:08"
"3169","75","20200130024432","PC","AAA01","9","90000","18000","72000","2020-01-30 14:44:32"
"3170","99","20200130115935","PC","AAA01","1","10000","2000","8000","2020-01-30 11:59:35"
"3171","8","20200130085803","PC","AAA04","3","24000","1200","22800","2020-01-30 08:58:03"
"3172","52","20200130072715","PC","AAA04","6","48000","2400","45600","2020-01-30 07:27:15"
"3173","44","20200129102406","Mobile","AAA04","12","96000","4800","91200","2020-01-29 10:24:06"
"3174","53","20200129093154","Mobile","AAA02","1","15000","2300","12700","2020-01-29 09:31:54"
"3175","8","20200129064041","Mobile","AAA02","3","45000","6900","38100","2020-01-29 06:40:41"
"3176","13","20200128095130","Shop","AAA04","2","16000","800","15200","2020-01-28 21:51:30"
"3177","66","20200128125603","PC","AAA03","8","136000","24000","112000","2020-01-28 12:56:03"
"3178","35","20200128115113","Mobile","AAA01","5","50000","10000","40000","2020-01-28 11:51:13"
"3179","86","20200128104549","Mobile","AAA02","1","15000","2300","12700","2020-01-28 10:45:49"
"3180","47","20200128091451","Shop","AAA05","6","360000","120000","240000","2020-01-28 09:14:51"
"3181","55","20200128083652","PC","AAA05","2","120000","40000","80000","2020-01-28 08:36:52"
"3182","82","20200128065823","Mobile","AAA01","3","30000","6000","24000","2020-01-28 06:58:23"
"3183","32","20200127105014","PC","AAA02","6","90000","13800","76200","2020-01-27 22:50:14"
"3184","18","20200127082327","Shop","AAA03","11","187000","33000","154000","2020-01-27 20:23:27"
"3185","89","20200127050025","Mobile","AAA03","18","306000","54000","252000","2020-01-27 17:00:25"
"3186","1","20200127042126","Mobile","AAA05","9","540000","180000","360000","2020-01-27 16:21:26"
"3187","94","20200127030409","PC","AAA05","6","360000","120000","240000","2020-01-27 15:04:09"
"3188","9","20200127015458","PC","AAA01","4","40000","8000","32000","2020-01-27 13:54:58"
"3189","68","20200127012103","Shop","AAA04","13","104000","5200","98800","2020-01-27 13:21:03"
"3190","100","20200127114605","PC","AAA02","4","60000","9200","50800","2020-01-27 11:46:05"
"3191","36","20200127102125","PC","AAA03","19","323000","57000","266000","2020-01-27 10:21:25"
"3192","62","20200127085331","PC","AAA05","3","180000","60000","120000","2020-01-27 08:53:31"
"3193","94","20200123072450","Shop","AAA03","14","238000","42000","196000","2020-01-23 07:24:50"
"3194","100","20200122083909","Shop","AAA05","6","360000","120000","240000","2020-01-22 20:39:09"
"3195","80","20200122052429","Shop","AAA03","11","187000","33000","154000","2020-01-22 17:24:29"
"3196","53","20200122034605","Shop","AAA03","5","85000","15000","70000","2020-01-22 15:46:05"
"3197","64","20200122025453","Shop","AAA04","5","40000","2000","38000","2020-01-22 14:54:53"
"3198","21","20200122011110","Mobile","AAA05","10","600000","200000","400000","2020-01-22 13:11:10"
"3199","42","20200122105640","PC","AAA02","13","195000","29900","165100","2020-01-22 10:56:40"
"3200","83","20200122102240","Shop","AAA03","21","357000","63000","294000","2020-01-22 10:22:40"
"3201","12","20200122093344","Mobile","AAA04","7","56000","2800","53200","2020-01-22 09:33:44"
"3202","81","20200122085315","PC","AAA04","4","32000","1600","30400","2020-01-22 08:53:15"
"3203","33","20200122073828","Shop","AAA04","3","24000","1200","22800","2020-01-22 07:38:28"
"3204","96","20200121044248","Shop","AAA03","19","323000","57000","266000","2020-01-21 16:42:48"
"3205","4","20200121033219","Shop","AAA01","9","90000","18000","72000","2020-01-21 15:32:19"
"3206","92","20200121024152","Mobile","AAA02","7","105000","16100","88900","2020-01-21 14:41:52"
"3207","69","20200121014402","PC","AAA05","5","300000","100000","200000","2020-01-21 13:44:02"
"3208","7","20200121110115","PC","AAA05","5","300000","100000","200000","2020-01-21 11:01:15"
"3209","59","20200121094844","PC","AAA01","10","100000","20000","80000","2020-01-21 09:48:44"
"3210","23","20200121085625","Mobile","AAA04","2","16000","800","15200","2020-01-21 08:56:25"
"3211","37","20200121071547","PC","AAA03","20","340000","60000","280000","2020-01-21 07:15:47"
"3212","92","20200120010620","Shop","AAA05","11","660000","220000","440000","2020-01-20 13:06:20"
"3213","33","20200120120137","Mobile","AAA01","1","10000","2000","8000","2020-01-20 12:01:37"
"3214","94","20200120100723","PC","AAA04","3","24000","1200","22800","2020-01-20 10:07:23"
"3215","85","20200120090109","Shop","AAA02","12","180000","27600","152400","2020-01-20 09:01:09"
"3216","5","20200117085431","Mobile","AAA05","11","660000","220000","440000","2020-01-17 08:54:31"
"3217","27","20200117072235","PC","AAA03","7","119000","21000","98000","2020-01-17 07:22:35"
"3218","100","20200116064920","Shop","AAA04","6","48000","2400","45600","2020-01-16 18:49:20"
"3219","37","20200116041542","Shop","AAA04","14","112000","5600","106400","2020-01-16 16:15:42"
"3220","84","20200116021941","Mobile","AAA03","8","136000","24000","112000","2020-01-16 14:19:41"
"3221","100","20200116012751","Mobile","AAA03","4","68000","12000","56000","2020-01-16 13:27:51"
"3222","97","20200116124008","PC","AAA04","6","48000","2400","45600","2020-01-16 12:40:08"
"3223","73","20200116092546","Mobile","AAA05","11","660000","220000","440000","2020-01-16 09:25:46"
"3224","53","20200116081230","Mobile","AAA04","2","16000","800","15200","2020-01-16 08:12:30"
"3225","87","20200116070039","PC","AAA04","5","40000","2000","38000","2020-01-16 07:00:39"
"3226","33","20200115033905","PC","AAA05","6","360000","120000","240000","2020-01-15 15:39:05"
"3227","69","20200115030017","Shop","AAA04","4","32000","1600","30400","2020-01-15 15:00:17"
"3228","49","20200115014341","Mobile","AAA04","1","8000","400","7600","2020-01-15 13:43:41"
"3229","50","20200115125312","PC","AAA04","1","8000","400","7600","2020-01-15 12:53:12"
"3230","80","20200115115101","Shop","AAA02","8","120000","18400","101600","2020-01-15 11:51:01"
"3231","63","20200115102202","Shop","AAA03","7","119000","21000","98000","2020-01-15 10:22:02"
"3232","86","20200115092206","PC","AAA05","2","120000","40000","80000","2020-01-15 09:22:06"
"3233","81","20200115082319","PC","AAA04","8","64000","3200","60800","2020-01-15 08:23:19"
"3234","83","20200115070741","Mobile","AAA01","27","270000","54000","216000","2020-01-15 07:07:41"
"3235","76","20200114084812","Shop","AAA02","1","15000","2300","12700","2020-01-14 20:48:12"
"3236","63","20200114053403","Mobile","AAA05","5","300000","100000","200000","2020-01-14 17:34:03"
"3237","34","20200114034109","PC","AAA05","6","360000","120000","240000","2020-01-14 15:41:09"
"3238","70","20200114021724","PC","AAA01","16","160000","32000","128000","2020-01-14 14:17:24"
"3239","8","20200114013043","Shop","AAA03","1","17000","3000","14000","2020-01-14 13:30:43"
"3240","40","20200114105612","Shop","AAA04","7","56000","2800","53200","2020-01-14 10:56:12"
"3241","63","20200114092639","Mobile","AAA02","3","45000","6900","38100","2020-01-14 09:26:39"
"3242","78","20200114075708","PC","AAA03","8","136000","24000","112000","2020-01-14 07:57:08"
"3243","76","20200113072816","Mobile","AAA01","8","80000","16000","64000","2020-01-13 19:28:16"
"3244","94","20200113025841","Mobile","AAA05","16","960000","320000","640000","2020-01-13 14:58:41"
"3245","6","20200113021013","Shop","AAA03","4","68000","12000","56000","2020-01-13 14:10:13"
"3246","5","20200113112413","Mobile","AAA01","10","100000","20000","80000","2020-01-13 11:24:13"
"3247","74","20200113095815","Mobile","AAA01","2","20000","4000","16000","2020-01-13 09:58:15"
"3248","99","20200109075709","Mobile","AAA02","4","60000","9200","50800","2020-01-09 07:57:09"
"3249","50","20200108051050","PC","AAA03","7","119000","21000","98000","2020-01-08 17:10:50"
"3250","85","20200108031354","Mobile","AAA02","5","75000","11500","63500","2020-01-08 15:13:54"
"3251","79","20200108015713","Shop","AAA04","7","56000","2800","53200","2020-01-08 13:57:13"
"3252","39","20200108121558","PC","AAA04","9","72000","3600","68400","2020-01-08 12:15:58"
"3253","84","20200108110941","Shop","AAA03","1","17000","3000","14000","2020-01-08 11:09:41"
"3254","93","20200108094827","Shop","AAA04","3","24000","1200","22800","2020-01-08 09:48:27"
"3255","56","20200108090544","Mobile","AAA05","12","720000","240000","480000","2020-01-08 09:05:44"
"3256","70","20200108063212","Shop","AAA05","8","480000","160000","320000","2020-01-08 06:32:12"
"3257","94","20200107075314","PC","AAA01","15","150000","30000","120000","2020-01-07 19:53:14"
"3258","74","20200107024620","Mobile","AAA05","5","300000","100000","200000","2020-01-07 14:46:20"
"3259","45","20200107015557","PC","AAA04","1","8000","400","7600","2020-01-07 13:55:57"
"3260","36","20200107124442","Shop","AAA02","14","210000","32200","177800","2020-01-07 12:44:42"
"3261","34","20200107114220","Mobile","AAA05","6","360000","120000","240000","2020-01-07 11:42:20"
"3262","83","20200107102102","Mobile","AAA03","16","272000","48000","224000","2020-01-07 10:21:02"
"3263","10","20200107085344","Shop","AAA05","14","840000","280000","560000","2020-01-07 08:53:44"
"3264","33","20200107074518","PC","AAA03","3","51000","9000","42000","2020-01-07 07:45:18"
"3265","96","20200106095254","Mobile","AAA01","3","30000","6000","24000","2020-01-06 21:52:54"
"3266","81","20200106081656","Shop","AAA05","1","60000","20000","40000","2020-01-06 20:16:56"
"3267","79","20200106061415","PC","AAA01","5","50000","10000","40000","2020-01-06 18:14:15"
"3268","38","20200106121346","Shop","AAA02","5","75000","11500","63500","2020-01-06 12:13:46"
"3269","80","20200106094647","Shop","AAA04","8","64000","3200","60800","2020-01-06 09:46:47"
"3270","4","20200104043042","PC","AAA04","3","24000","1200","22800","2020-01-04 16:30:42"
"3271","41","20200102113159","Shop","AAA02","10","150000","23000","127000","2020-01-02 23:31:59"
"3272","80","20200102044832","Mobile","AAA01","11","110000","22000","88000","2020-01-02 04:48:32"
"3273","62","20200101025039","Shop","AAA05","14","840000","280000","560000","2020-01-01 14:50:39"
"3274","72","20200101125900","Mobile","AAA01","4","40000","8000","32000","2020-01-01 12:59:00"
"3275","20","20200101114434","Mobile","AAA05","4","240000","80000","160000","2020-01-01 11:44:34"
"3276","97","20200101072941","PC","AAA03","12","204000","36000","168000","2020-01-01 07:29:41"
"3277","87","20191231050404","PC","AAA01","8","80000","16000","64000","2019-12-31 17:04:04"
"3278","37","20191231035107","Mobile","AAA01","4","40000","8000","32000","2019-12-31 15:51:07"
"3279","87","20191231023903","Mobile","AAA01","2","20000","4000","16000","2019-12-31 14:39:03"
"3280","55","20191231125706","Mobile","AAA05","12","720000","240000","480000","2019-12-31 12:57:06"
"3281","42","20191231111536","PC","AAA01","10","100000","20000","80000","2019-12-31 11:15:36"
"3282","92","20191231081802","PC","AAA04","10","80000","4000","76000","2019-12-31 08:18:02"
"3283","21","20191231074920","PC","AAA03","8","136000","24000","112000","2019-12-31 07:49:20"
"3284","98","20191231120020","Mobile","AAA03","1","17000","3000","14000","2019-12-31 00:00:20"
"3285","14","20191230050147","Mobile","AAA03","5","85000","15000","70000","2019-12-30 17:01:47"
"3286","14","20191230034825","Mobile","AAA04","10","80000","4000","76000","2019-12-30 15:48:25"
"3287","15","20191230023739","Mobile","AAA01","13","130000","26000","104000","2019-12-30 14:37:39"
"3288","3","20191230013512","PC","AAA03","10","170000","30000","140000","2019-12-30 13:35:12"
"3289","8","20191230113140","Mobile","AAA02","19","285000","43700","241300","2019-12-30 11:31:40"
"3290","93","20191230095647","Mobile","AAA03","7","119000","21000","98000","2019-12-30 09:56:47"
"3291","67","20191225082344","Mobile","AAA03","10","170000","30000","140000","2019-12-25 08:23:44"
"3292","76","20191225071133","Mobile","AAA01","4","40000","8000","32000","2019-12-25 07:11:33"
"3293","68","20191225014300","Mobile","AAA05","7","420000","140000","280000","2019-12-25 01:43:00"
"3294","40","20191224071050","Mobile","AAA04","1","8000","400","7600","2019-12-24 19:10:50"
"3295","46","20191224044453","Shop","AAA02","9","135000","20700","114300","2019-12-24 16:44:53"
"3296","80","20191224033550","Mobile","AAA02","6","90000","13800","76200","2019-12-24 15:35:50"
"3297","62","20191224022325","PC","AAA05","10","600000","200000","400000","2019-12-24 14:23:25"
"3298","56","20191224015424","Shop","AAA04","9","72000","3600","68400","2019-12-24 13:54:24"
"3299","57","20191224124346","Shop","AAA02","2","30000","4600","25400","2019-12-24 12:43:46"
"3300","82","20191224113251","PC","AAA02","2","30000","4600","25400","2019-12-24 11:32:51"
"3301","68","20191224102426","Shop","AAA03","1","17000","3000","14000","2019-12-24 10:24:26"
"3302","40","20191224093637","Shop","AAA05","7","420000","140000","280000","2019-12-24 09:36:37"
"3303","44","20191224084553","Mobile","AAA01","3","30000","6000","24000","2019-12-24 08:45:53"
"3304","14","20191224074249","Mobile","AAA01","3","30000","6000","24000","2019-12-24 07:42:49"
"3305","49","20191223062800","PC","AAA02","3","45000","6900","38100","2019-12-23 18:28:00"
"3306","79","20191223024513","Mobile","AAA04","6","48000","2400","45600","2019-12-23 14:45:13"
"3307","46","20191223012403","PC","AAA05","6","360000","120000","240000","2019-12-23 13:24:03"
"3308","97","20191223115705","PC","AAA03","1","17000","3000","14000","2019-12-23 11:57:05"
"3309","65","20191223104659","PC","AAA03","9","153000","27000","126000","2019-12-23 10:46:59"
"3310","75","20191223102402","Mobile","AAA05","1","60000","20000","40000","2019-12-23 10:24:02"
"3311","99","20191223085711","Shop","AAA05","1","60000","20000","40000","2019-12-23 08:57:11"
"3312","4","20191220021430","Shop","AAA05","3","180000","60000","120000","2019-12-20 02:14:30"
"3313","80","20191219023937","Mobile","AAA01","2","20000","4000","16000","2019-12-19 14:39:37"
"3314","10","20191219011849","Shop","AAA02","14","210000","32200","177800","2019-12-19 13:18:49"
"3315","73","20191219114412","PC","AAA04","8","64000","3200","60800","2019-12-19 11:44:12"
"3316","33","20191219101532","Mobile","AAA03","1","17000","3000","14000","2019-12-19 10:15:32"
"3317","3","20191219090303","PC","AAA04","7","56000","2800","53200","2019-12-19 09:03:03"
"3318","58","20191219074107","Shop","AAA03","5","85000","15000","70000","2019-12-19 07:41:07"
"3319","94","20191219122733","Mobile","AAA05","17","1020000","340000","680000","2019-12-19 00:27:33"
"3320","75","20191218014836","Shop","AAA01","4","40000","8000","32000","2019-12-18 13:48:36"
"3321","71","20191218120942","Shop","AAA04","2","16000","800","15200","2019-12-18 12:09:42"
"3322","37","20191218111108","PC","AAA02","11","165000","25300","139700","2019-12-18 11:11:08"
"3323","93","20191218093418","Mobile","AAA02","4","60000","9200","50800","2019-12-18 09:34:18"
"3324","65","20191218082526","Mobile","AAA04","7","56000","2800","53200","2019-12-18 08:25:26"
"3325","72","20191218081736","PC","AAA03","10","170000","30000","140000","2019-12-18 08:17:36"
"3326","22","20191218070012","Shop","AAA02","4","60000","9200","50800","2019-12-18 07:00:12"
"3327","97","20191217051902","Shop","AAA03","2","34000","6000","28000","2019-12-17 17:19:02"
"3328","98","20191217042214","PC","AAA04","3","24000","1200","22800","2019-12-17 16:22:14"
"3329","78","20191217025748","Mobile","AAA02","2","30000","4600","25400","2019-12-17 14:57:48"
"3330","29","20191217013822","PC","AAA04","15","120000","6000","114000","2019-12-17 13:38:22"
"3331","67","20191217122456","Mobile","AAA05","7","420000","140000","280000","2019-12-17 12:24:56"
"3332","73","20191217112454","Shop","AAA03","3","51000","9000","42000","2019-12-17 11:24:54"
"3333","46","20191217103058","Mobile","AAA02","7","105000","16100","88900","2019-12-17 10:30:58"
"3334","85","20191217082028","Shop","AAA05","6","360000","120000","240000","2019-12-17 08:20:28"
"3335","48","20191217072935","Shop","AAA05","9","540000","180000","360000","2019-12-17 07:29:35"
"3336","38","20191216102308","Mobile","AAA01","5","50000","10000","40000","2019-12-16 22:23:08"
"3337","36","20191216073248","Shop","AAA02","17","255000","39100","215900","2019-12-16 19:32:48"
"3338","32","20191216034004","Mobile","AAA04","5","40000","2000","38000","2019-12-16 15:40:04"
"3339","52","20191216023015","Shop","AAA05","1","60000","20000","40000","2019-12-16 14:30:15"
"3340","74","20191216093319","PC","AAA01","6","60000","12000","48000","2019-12-16 09:33:19"
"3341","20","20191214010503","Mobile","AAA05","4","240000","80000","160000","2019-12-14 13:05:03"
"3342","48","20191213110548","Shop","AAA05","1","60000","20000","40000","2019-12-13 23:05:48"
"3343","17","20191213111232","Mobile","AAA05","5","300000","100000","200000","2019-12-13 11:12:32"
"3344","51","20191213103445","Shop","AAA02","2","30000","4600","25400","2019-12-13 10:34:45"
"3345","18","20191213092051","Shop","AAA03","5","85000","15000","70000","2019-12-13 09:20:51"
"3346","25","20191213080016","Mobile","AAA01","12","120000","24000","96000","2019-12-13 08:00:16"
"3347","9","20191213063411","PC","AAA01","1","10000","2000","8000","2019-12-13 06:34:11"
"3348","21","20191213120225","PC","AAA02","3","45000","6900","38100","2019-12-13 00:02:25"
"3349","40","20191212061729","PC","AAA03","4","68000","12000","56000","2019-12-12 18:17:29"
"3350","67","20191212022940","PC","AAA05","9","540000","180000","360000","2019-12-12 14:29:40"
"3351","85","20191212012158","Shop","AAA05","12","720000","240000","480000","2019-12-12 13:21:58"
"3352","62","20191212121011","PC","AAA03","7","119000","21000","98000","2019-12-12 12:10:11"
"3353","2","20191212090849","Mobile","AAA02","4","60000","9200","50800","2019-12-12 09:08:49"
"3354","18","20191212075855","Mobile","AAA02","12","180000","27600","152400","2019-12-12 07:58:55"
"3355","49","20191211122241","PC","AAA01","16","160000","32000","128000","2019-12-11 12:22:41"
"3356","94","20191211111651","Mobile","AAA03","7","119000","21000","98000","2019-12-11 11:16:51"
"3357","43","20191211095846","Mobile","AAA04","18","144000","7200","136800","2019-12-11 09:58:46"
"3358","73","20191211090706","Mobile","AAA05","11","660000","220000","440000","2019-12-11 09:07:06"
"3359","28","20191211080427","PC","AAA02","8","120000","18400","101600","2019-12-11 08:04:27"
"3360","33","20191211063855","Shop","AAA04","2","16000","800","15200","2019-12-11 06:38:55"
"3361","80","20191210060525","PC","AAA03","7","119000","21000","98000","2019-12-10 18:05:25"
"3362","66","20191210023713","PC","AAA02","4","60000","9200","50800","2019-12-10 14:37:13"
"3363","66","20191210112528","Mobile","AAA02","6","90000","13800","76200","2019-12-10 11:25:28"
"3364","47","20191210104520","PC","AAA04","2","16000","800","15200","2019-12-10 10:45:20"
"3365","28","20191210085836","PC","AAA01","14","140000","28000","112000","2019-12-10 08:58:36"
"3366","37","20191209063609","Mobile","AAA01","5","50000","10000","40000","2019-12-09 18:36:09"
"3367","20","20191209041441","Mobile","AAA03","5","85000","15000","70000","2019-12-09 16:14:41"
"3368","21","20191209032421","Mobile","AAA02","4","60000","9200","50800","2019-12-09 15:24:21"
"3369","40","20191209123100","Shop","AAA02","9","135000","20700","114300","2019-12-09 12:31:00"
"3370","73","20191209110104","Mobile","AAA02","12","180000","27600","152400","2019-12-09 11:01:04"
"3371","48","20191209093953","Mobile","AAA05","5","300000","100000","200000","2019-12-09 09:39:53"
"3372","77","20191206085105","Shop","AAA05","1","60000","20000","40000","2019-12-06 08:51:05"
"3373","6","20191206071641","Shop","AAA01","5","50000","10000","40000","2019-12-06 07:16:41"
"3374","92","20191205080214","Shop","AAA05","6","360000","120000","240000","2019-12-05 20:02:14"
"3375","27","20191205053846","PC","AAA01","2","20000","4000","16000","2019-12-05 17:38:46"
"3376","12","20191205043340","Shop","AAA02","2","30000","4600","25400","2019-12-05 16:33:40"
"3377","22","20191205035852","Shop","AAA05","3","180000","60000","120000","2019-12-05 15:58:52"
"3378","25","20191205013819","PC","AAA02","6","90000","13800","76200","2019-12-05 13:38:19"
"3379","64","20191205122630","PC","AAA05","4","240000","80000","160000","2019-12-05 12:26:30"
"3380","61","20191205110522","Shop","AAA05","1","60000","20000","40000","2019-12-05 11:05:22"
"3381","8","20191205101323","PC","AAA04","5","40000","2000","38000","2019-12-05 10:13:23"
"3382","67","20191205083246","Shop","AAA01","14","140000","28000","112000","2019-12-05 08:32:46"
"3383","66","20191205072351","Mobile","AAA01","8","80000","16000","64000","2019-12-05 07:23:51"
"3384","11","20191204093423","Shop","AAA01","13","130000","26000","104000","2019-12-04 21:34:23"
"3385","44","20191204034654","Shop","AAA05","6","360000","120000","240000","2019-12-04 15:46:54"
"3386","61","20191204023630","Mobile","AAA01","5","50000","10000","40000","2019-12-04 14:36:30"
"3387","24","20191204013844","Mobile","AAA03","9","153000","27000","126000","2019-12-04 13:38:44"
"3388","94","20191204125612","PC","AAA01","12","120000","24000","96000","2019-12-04 12:56:12"
"3389","10","20191204111253","Mobile","AAA01","10","100000","20000","80000","2019-12-04 11:12:53"
"3390","65","20191204101346","Shop","AAA01","11","110000","22000","88000","2019-12-04 10:13:46"
"3391","82","20191204090027","Mobile","AAA04","5","40000","2000","38000","2019-12-04 09:00:27"
"3392","33","20191204084027","Mobile","AAA03","2","34000","6000","28000","2019-12-04 08:40:27"
"3393","8","20191204083626","Mobile","AAA02","4","60000","9200","50800","2019-12-04 08:36:26"
"3394","78","20191203033748","Shop","AAA01","11","110000","22000","88000","2019-12-03 15:37:48"
"3395","63","20191203020602","PC","AAA05","6","360000","120000","240000","2019-12-03 14:06:02"
"3396","34","20191203103406","PC","AAA02","1","15000","2300","12700","2019-12-03 10:34:06"
"3397","14","20191203091818","PC","AAA04","5","40000","2000","38000","2019-12-03 09:18:18"
"3398","91","20191203085119","Mobile","AAA02","1","15000","2300","12700","2019-12-03 08:51:19"
"3399","34","20191203074204","Mobile","AAA03","16","272000","48000","224000","2019-12-03 07:42:04"
"3400","81","20191202025610","PC","AAA01","2","20000","4000","16000","2019-12-02 14:56:10"
"3401","12","20191202114733","Mobile","AAA03","1","17000","3000","14000","2019-12-02 11:47:33"
"3402","18","20191202104432","Mobile","AAA01","5","50000","10000","40000","2019-12-02 10:44:32"
"3403","21","20191202091957","Shop","AAA05","3","180000","60000","120000","2019-12-02 09:19:57"
"3404","46","20191129050315","Shop","AAA05","11","660000","220000","440000","2019-11-29 05:03:15"
"3405","42","20191128044458","Mobile","AAA05","2","120000","40000","80000","2019-11-28 16:44:58"
"3406","45","20191128033359","PC","AAA04","1","8000","400","7600","2019-11-28 15:33:59"
"3407","36","20191128015245","PC","AAA03","12","204000","36000","168000","2019-11-28 13:52:45"
"3408","66","20191128124748","Mobile","AAA05","10","600000","200000","400000","2019-11-28 12:47:48"
"3409","5","20191128114624","Shop","AAA05","15","900000","300000","600000","2019-11-28 11:46:24"
"3410","19","20191128093816","Shop","AAA01","5","50000","10000","40000","2019-11-28 09:38:16"
"3411","25","20191128084629","Shop","AAA02","10","150000","23000","127000","2019-11-28 08:46:29"
"3412","54","20191128061733","Shop","AAA03","3","51000","9000","42000","2019-11-28 06:17:33"
"3413","83","20191127085125","PC","AAA04","7","56000","2800","53200","2019-11-27 20:51:25"
"3414","14","20191127044601","Mobile","AAA03","7","119000","21000","98000","2019-11-27 16:46:01"
"3415","8","20191127040000","PC","AAA01","8","80000","16000","64000","2019-11-27 16:00:00"
"3416","40","20191127021825","PC","AAA03","6","102000","18000","84000","2019-11-27 14:18:25"
"3417","42","20191127121322","PC","AAA01","14","140000","28000","112000","2019-11-27 12:13:22"
"3418","1","20191127112323","Mobile","AAA03","4","68000","12000","56000","2019-11-27 11:23:23"
"3419","11","20191127085810","Mobile","AAA03","7","119000","21000","98000","2019-11-27 08:58:10"
"3420","100","20191127072727","Mobile","AAA03","2","34000","6000","28000","2019-11-27 07:27:27"
"3421","13","20191127033845","PC","AAA03","4","68000","12000","56000","2019-11-27 03:38:45"
"3422","78","20191126031610","PC","AAA02","9","135000","20700","114300","2019-11-26 15:16:10"
"3423","15","20191126013438","Shop","AAA04","2","16000","800","15200","2019-11-26 13:34:38"
"3424","60","20191126114240","PC","AAA03","9","153000","27000","126000","2019-11-26 11:42:40"
"3425","13","20191126102302","PC","AAA02","3","45000","6900","38100","2019-11-26 10:23:02"
"3426","8","20191126085421","Shop","AAA05","11","660000","220000","440000","2019-11-26 08:54:21"
"3427","74","20191126074851","Mobile","AAA01","9","90000","18000","72000","2019-11-26 07:48:51"
"3428","29","20191125051342","PC","AAA04","5","40000","2000","38000","2019-11-25 17:13:42"
"3429","10","20191125040053","PC","AAA01","8","80000","16000","64000","2019-11-25 16:00:53"
"3430","71","20191125023142","Shop","AAA01","2","20000","4000","16000","2019-11-25 14:31:42"
"3431","57","20191125020253","Mobile","AAA04","4","32000","1600","30400","2019-11-25 14:02:53"
"3432","40","20191125125233","Shop","AAA03","11","187000","33000","154000","2019-11-25 12:52:33"
"3433","25","20191125101402","PC","AAA03","6","102000","18000","84000","2019-11-25 10:14:02"
"3434","11","20191125091221","Shop","AAA04","11","88000","4400","83600","2019-11-25 09:12:21"
"3435","35","20191122071359","Mobile","AAA02","2","30000","4600","25400","2019-11-22 19:13:59"
"3436","35","20191122051844","Mobile","AAA03","9","153000","27000","126000","2019-11-22 17:18:44"
"3437","38","20191122011217","PC","AAA02","13","195000","29900","165100","2019-11-22 13:12:17"
"3438","42","20191122112853","Mobile","AAA02","11","165000","25300","139700","2019-11-22 11:28:53"
"3439","28","20191122100709","PC","AAA03","11","187000","33000","154000","2019-11-22 10:07:09"
"3440","32","20191122092607","Mobile","AAA02","3","45000","6900","38100","2019-11-22 09:26:07"
"3441","10","20191122083917","Shop","AAA04","8","64000","3200","60800","2019-11-22 08:39:17"
"3442","2","20191122035557","Mobile","AAA02","1","15000","2300","12700","2019-11-22 03:55:57"
"3443","55","20191121062154","Shop","AAA04","8","64000","3200","60800","2019-11-21 18:21:54"
"3444","24","20191121012110","Mobile","AAA03","13","221000","39000","182000","2019-11-21 13:21:10"
"3445","51","20191121121628","Mobile","AAA04","10","80000","4000","76000","2019-11-21 12:16:28"
"3446","23","20191121113421","PC","AAA02","8","120000","18400","101600","2019-11-21 11:34:21"
"3447","54","20191121100046","Mobile","AAA03","11","187000","33000","154000","2019-11-21 10:00:46"
"3448","6","20191121083927","Mobile","AAA05","3","180000","60000","120000","2019-11-21 08:39:27"
"3449","47","20191121072941","PC","AAA02","12","180000","27600","152400","2019-11-21 07:29:41"
"3450","64","20191120101558","PC","AAA01","6","60000","12000","48000","2019-11-20 22:15:58"
"3451","7","20191120061844","Mobile","AAA02","6","90000","13800","76200","2019-11-20 18:18:44"
"3452","5","20191120123409","PC","AAA01","7","70000","14000","56000","2019-11-20 12:34:09"
"3453","97","20191120111743","Shop","AAA02","6","90000","13800","76200","2019-11-20 11:17:43"
"3454","68","20191120103311","Mobile","AAA01","10","100000","20000","80000","2019-11-20 10:33:11"
"3455","64","20191120093135","PC","AAA05","4","240000","80000","160000","2019-11-20 09:31:35"
"3456","14","20191120084317","PC","AAA05","6","360000","120000","240000","2019-11-20 08:43:17"
"3457","25","20191120073852","Shop","AAA05","8","480000","160000","320000","2019-11-20 07:38:52"
"3458","78","20191119022109","Mobile","AAA03","8","136000","24000","112000","2019-11-19 14:21:09"
"3459","34","20191119013313","PC","AAA01","8","80000","16000","64000","2019-11-19 13:33:13"
"3460","38","20191119121428","Shop","AAA05","7","420000","140000","280000","2019-11-19 12:14:28"
"3461","33","20191119104806","Shop","AAA04","4","32000","1600","30400","2019-11-19 10:48:06"
"3462","74","20191119091541","Mobile","AAA05","2","120000","40000","80000","2019-11-19 09:15:41"
"3463","97","20191119065157","Mobile","AAA02","4","60000","9200","50800","2019-11-19 06:51:57"
"3464","62","20191118071614","PC","AAA04","11","88000","4400","83600","2019-11-18 19:16:14"
"3465","88","20191118023527","PC","AAA03","1","17000","3000","14000","2019-11-18 14:35:27"
"3466","10","20191118123929","Shop","AAA02","8","120000","18400","101600","2019-11-18 12:39:29"
"3467","28","20191118120959","Mobile","AAA03","11","187000","33000","154000","2019-11-18 12:09:59"
"3468","89","20191118102312","Shop","AAA04","9","72000","3600","68400","2019-11-18 10:23:12"
"3469","68","20191118091013","Shop","AAA01","3","30000","6000","24000","2019-11-18 09:10:13"
"3470","3","20191114100410","Shop","AAA05","13","780000","260000","520000","2019-11-14 10:04:10"
"3471","38","20191114093048","Shop","AAA04","8","64000","3200","60800","2019-11-14 09:30:48"
"3472","70","20191114082038","Mobile","AAA01","21","210000","42000","168000","2019-11-14 08:20:38"
"3473","96","20191114071738","Mobile","AAA04","13","104000","5200","98800","2019-11-14 07:17:38"
"3474","52","20191113041737","PC","AAA05","1","60000","20000","40000","2019-11-13 16:17:37"
"3475","76","20191113023007","Shop","AAA03","5","85000","15000","70000","2019-11-13 14:30:07"
"3476","54","20191113123727","Mobile","AAA03","1","17000","3000","14000","2019-11-13 12:37:27"
"3477","3","20191113110206","Mobile","AAA02","12","180000","27600","152400","2019-11-13 11:02:06"
"3478","15","20191113094510","Shop","AAA03","19","323000","57000","266000","2019-11-13 09:45:10"
"3479","81","20191113083438","PC","AAA05","2","120000","40000","80000","2019-11-13 08:34:38"
"3480","45","20191113074725","Mobile","AAA03","7","119000","21000","98000","2019-11-13 07:47:25"
"3481","10","20191112110609","Shop","AAA02","9","135000","20700","114300","2019-11-12 11:06:09"
"3482","68","20191112085558","Mobile","AAA04","1","8000","400","7600","2019-11-12 08:55:58"
"3483","34","20191112071523","Shop","AAA03","10","170000","30000","140000","2019-11-12 07:15:23"
"3484","5","20191111031536","Shop","AAA05","10","600000","200000","400000","2019-11-11 15:15:36"
"3485","81","20191111123544","PC","AAA05","4","240000","80000","160000","2019-11-11 12:35:44"
"3486","50","20191111112652","Shop","AAA03","8","136000","24000","112000","2019-11-11 11:26:52"
"3487","46","20191111102437","Mobile","AAA05","8","480000","160000","320000","2019-11-11 10:24:37"
"3488","96","20191111093337","Shop","AAA03","3","51000","9000","42000","2019-11-11 09:33:37"
"3489","26","20191106015351","PC","AAA03","7","119000","21000","98000","2019-11-06 13:53:51"
"3490","78","20191106121921","PC","AAA01","4","40000","8000","32000","2019-11-06 12:19:21"
"3491","79","20191106103933","Shop","AAA02","15","225000","34500","190500","2019-11-06 10:39:33"
"3492","56","20191106075142","Shop","AAA03","6","102000","18000","84000","2019-11-06 07:51:42"
"3493","60","20191105034937","PC","AAA01","9","90000","18000","72000","2019-11-05 15:49:37"
"3494","96","20191105030459","Mobile","AAA04","15","120000","6000","114000","2019-11-05 15:04:59"
"3495","72","20191105014356","Shop","AAA04","7","56000","2800","53200","2019-11-05 13:43:56"
"3496","6","20191105124454","PC","AAA02","5","75000","11500","63500","2019-11-05 12:44:54"
"3497","27","20191105123834","Shop","AAA03","8","136000","24000","112000","2019-11-05 12:38:34"
"3498","16","20191105090612","PC","AAA01","13","130000","26000","104000","2019-11-05 09:06:12"
"3499","68","20191105081016","Shop","AAA05","3","180000","60000","120000","2019-11-05 08:10:16"
"3500","48","20191105071358","Mobile","AAA05","1","60000","20000","40000","2019-11-05 07:13:58"
"3501","10","20191104095004","Mobile","AAA05","14","840000","280000","560000","2019-11-04 21:50:04"
"3502","10","20191104063934","Shop","AAA03","17","289000","51000","238000","2019-11-04 18:39:34"
"3503","32","20191104113126","Mobile","AAA03","3","51000","9000","42000","2019-11-04 11:31:26"
"3504","18","20191104093002","Shop","AAA02","2","30000","4600","25400","2019-11-04 09:30:02"
"3505","14","20191101025904","Shop","AAA04","4","32000","1600","30400","2019-11-01 14:59:04"
"3506","15","20191101012408","PC","AAA03","15","255000","45000","210000","2019-11-01 13:24:08"
"3507","21","20191101123721","Mobile","AAA03","3","51000","9000","42000","2019-11-01 12:37:21"
"3508","6","20191101083447","Mobile","AAA04","4","32000","1600","30400","2019-11-01 08:34:47"
"3509","85","20191101071627","Shop","AAA01","19","190000","38000","152000","2019-11-01 07:16:27"
"3510","58","20191101125016","Mobile","AAA03","1","17000","3000","14000","2019-11-01 00:50:16"
"3511","44","20191031123423","Shop","AAA01","7","70000","14000","56000","2019-10-31 12:34:23"
"3512","36","20191031110728","Shop","AAA02","7","105000","16100","88900","2019-10-31 11:07:28"
"3513","37","20191031095001","Mobile","AAA05","7","420000","140000","280000","2019-10-31 09:50:01"
"3514","34","20191031082021","Shop","AAA01","13","130000","26000","104000","2019-10-31 08:20:21"
"3515","97","20191030055612","PC","AAA04","5","40000","2000","38000","2019-10-30 17:56:12"
"3516","37","20191030044820","Mobile","AAA03","9","153000","27000","126000","2019-10-30 16:48:20"
"3517","64","20191030033540","Mobile","AAA04","16","128000","6400","121600","2019-10-30 15:35:40"
"3518","11","20191030021724","Shop","AAA03","9","153000","27000","126000","2019-10-30 14:17:24"
"3519","58","20191030124515","PC","AAA02","1","15000","2300","12700","2019-10-30 12:45:15"
"3520","15","20191030112206","PC","AAA05","2","120000","40000","80000","2019-10-30 11:22:06"
"3521","96","20191030100958","Shop","AAA04","5","40000","2000","38000","2019-10-30 10:09:58"
"3522","50","20191030091526","PC","AAA02","7","105000","16100","88900","2019-10-30 09:15:26"
"3523","71","20191030082233","Mobile","AAA01","5","50000","10000","40000","2019-10-30 08:22:33"
"3524","66","20191030071331","Shop","AAA04","5","40000","2000","38000","2019-10-30 07:13:31"
"3525","65","20191029054841","Shop","AAA02","1","15000","2300","12700","2019-10-29 17:48:41"
"3526","90","20191029043005","PC","AAA01","3","30000","6000","24000","2019-10-29 16:30:05"
"3527","24","20191029030605","Shop","AAA03","5","85000","15000","70000","2019-10-29 15:06:05"
"3528","54","20191029014345","Mobile","AAA05","5","300000","100000","200000","2019-10-29 13:43:45"
"3529","24","20191029123437","Shop","AAA05","3","180000","60000","120000","2019-10-29 12:34:37"
"3530","60","20191029095209","Shop","AAA02","10","150000","23000","127000","2019-10-29 09:52:09"
"3531","13","20191029090000","PC","AAA02","2","30000","4600","25400","2019-10-29 09:00:00"
"3532","4","20191029070249","PC","AAA04","3","24000","1200","22800","2019-10-29 07:02:49"
"3533","47","20191028061104","Shop","AAA05","6","360000","120000","240000","2019-10-28 18:11:04"
"3534","67","20191028030737","PC","AAA03","6","102000","18000","84000","2019-10-28 15:07:37"
"3535","48","20191028012627","PC","AAA05","5","300000","100000","200000","2019-10-28 13:26:27"
"3536","58","20191028010803","Shop","AAA03","10","170000","30000","140000","2019-10-28 13:08:03"
"3537","26","20191028113855","Mobile","AAA05","1","60000","20000","40000","2019-10-28 11:38:55"
"3538","83","20191028092759","Shop","AAA05","1","60000","20000","40000","2019-10-28 09:27:59"
"3539","92","20191026121210","PC","AAA04","7","56000","2800","53200","2019-10-26 00:12:10"
"3540","2","20191025125408","Mobile","AAA03","3","51000","9000","42000","2019-10-25 12:54:08"
"3541","88","20191025113120","Shop","AAA02","6","90000","13800","76200","2019-10-25 11:31:20"
"3542","76","20191025102350","Mobile","AAA04","7","56000","2800","53200","2019-10-25 10:23:50"
"3543","47","20191025090350","Shop","AAA03","10","170000","30000","140000","2019-10-25 09:03:50"
"3544","11","20191025074713","Shop","AAA04","14","112000","5600","106400","2019-10-25 07:47:13"
"3545","86","20191024104534","Mobile","AAA04","9","72000","3600","68400","2019-10-24 22:45:34"
"3546","78","20191024053510","PC","AAA03","10","170000","30000","140000","2019-10-24 17:35:10"
"3547","65","20191024042704","Shop","AAA01","9","90000","18000","72000","2019-10-24 16:27:04"
"3548","13","20191024033225","PC","AAA04","10","80000","4000","76000","2019-10-24 15:32:25"
"3549","40","20191024015159","Mobile","AAA03","3","51000","9000","42000","2019-10-24 13:51:59"
"3550","5","20191024123951","Mobile","AAA02","5","75000","11500","63500","2019-10-24 12:39:51"
"3551","46","20191024113955","Mobile","AAA04","13","104000","5200","98800","2019-10-24 11:39:55"
"3552","93","20191024104058","Mobile","AAA02","1","15000","2300","12700","2019-10-24 10:40:58"
"3553","45","20191024071908","Mobile","AAA01","6","60000","12000","48000","2019-10-24 07:19:08"
"3554","33","20191023080741","Shop","AAA04","7","56000","2800","53200","2019-10-23 20:07:41"
"3555","79","20191023032827","Shop","AAA01","3","30000","6000","24000","2019-10-23 15:28:27"
"3556","39","20191023023117","Mobile","AAA03","5","85000","15000","70000","2019-10-23 14:31:17"
"3557","60","20191023021406","PC","AAA01","1","10000","2000","8000","2019-10-23 14:14:06"
"3558","19","20191023121850","Mobile","AAA04","9","72000","3600","68400","2019-10-23 12:18:50"
"3559","50","20191023111902","Shop","AAA02","7","105000","16100","88900","2019-10-23 11:19:02"
"3560","26","20191023094456","Mobile","AAA03","4","68000","12000","56000","2019-10-23 09:44:56"
"3561","74","20191023070358","PC","AAA01","7","70000","14000","56000","2019-10-23 07:03:58"
"3562","44","20191022071308","Shop","AAA04","1","8000","400","7600","2019-10-22 19:13:08"
"3563","77","20191022041131","PC","AAA05","3","180000","60000","120000","2019-10-22 16:11:31"
"3564","14","20191022035102","Mobile","AAA04","10","80000","4000","76000","2019-10-22 15:51:02"
"3565","17","20191022014034","PC","AAA04","5","40000","2000","38000","2019-10-22 13:40:34"
"3566","70","20191022124917","PC","AAA05","13","780000","260000","520000","2019-10-22 12:49:17"
"3567","17","20191022114905","Mobile","AAA01","10","100000","20000","80000","2019-10-22 11:49:05"
"3568","53","20191022104621","PC","AAA02","1","15000","2300","12700","2019-10-22 10:46:21"
"3569","12","20191022082547","Shop","AAA05","3","180000","60000","120000","2019-10-22 08:25:47"
"3570","21","20191022070305","Mobile","AAA02","12","180000","27600","152400","2019-10-22 07:03:05"
"3571","100","20191021034207","Mobile","AAA01","5","50000","10000","40000","2019-10-21 15:42:07"
"3572","1","20191021123629","Shop","AAA02","1","15000","2300","12700","2019-10-21 12:36:29"
"3573","62","20191021113357","PC","AAA02","5","75000","11500","63500","2019-10-21 11:33:57"
"3574","44","20191021095928","Shop","AAA03","4","68000","12000","56000","2019-10-21 09:59:28"
"3575","14","20191017014110","Mobile","AAA02","2","30000","4600","25400","2019-10-17 01:41:10"
"3576","46","20191016010931","Shop","AAA03","15","255000","45000","210000","2019-10-16 13:09:31"
"3577","77","20191016112820","Mobile","AAA02","4","60000","9200","50800","2019-10-16 11:28:20"
"3578","88","20191016103711","Mobile","AAA05","3","180000","60000","120000","2019-10-16 10:37:11"
"3579","65","20191016091622","Shop","AAA04","1","8000","400","7600","2019-10-16 09:16:22"
"3580","7","20191016083721","PC","AAA01","10","100000","20000","80000","2019-10-16 08:37:21"
"3581","73","20191016073632","PC","AAA03","7","119000","21000","98000","2019-10-16 07:36:32"
"3582","31","20191015010930","PC","AAA03","11","187000","33000","154000","2019-10-15 13:09:30"
"3583","74","20191015121010","Shop","AAA02","9","135000","20700","114300","2019-10-15 12:10:10"
"3584","58","20191015102305","PC","AAA05","2","120000","40000","80000","2019-10-15 10:23:05"
"3585","51","20191015090811","Mobile","AAA01","2","20000","4000","16000","2019-10-15 09:08:11"
"3586","56","20191015082946","PC","AAA04","4","32000","1600","30400","2019-10-15 08:29:46"
"3587","12","20191015070608","Mobile","AAA04","3","24000","1200","22800","2019-10-15 07:06:08"
"3588","53","20191014030917","Shop","AAA01","4","40000","8000","32000","2019-10-14 15:09:17"
"3589","4","20191014020519","Mobile","AAA04","3","24000","1200","22800","2019-10-14 14:05:19"
"3590","77","20191014125631","Mobile","AAA03","2","34000","6000","28000","2019-10-14 12:56:31"
"3591","87","20191014111331","Shop","AAA01","5","50000","10000","40000","2019-10-14 11:13:31"
"3592","50","20191014093847","PC","AAA03","13","221000","39000","182000","2019-10-14 09:38:47"
"3593","11","20191010104051","Shop","AAA05","10","600000","200000","400000","2019-10-10 22:40:51"
"3594","46","20191010042739","Mobile","AAA01","5","50000","10000","40000","2019-10-10 16:27:39"
"3595","96","20191010032701","Mobile","AAA03","13","221000","39000","182000","2019-10-10 15:27:01"
"3596","37","20191010021253","PC","AAA01","9","90000","18000","72000","2019-10-10 14:12:53"
"3597","94","20191010011116","Mobile","AAA01","10","100000","20000","80000","2019-10-10 13:11:16"
"3598","87","20191010115200","Mobile","AAA04","1","8000","400","7600","2019-10-10 11:52:00"
"3599","14","20191010105955","Shop","AAA05","1","60000","20000","40000","2019-10-10 10:59:55"
"3600","71","20191010101302","Mobile","AAA05","8","480000","160000","320000","2019-10-10 10:13:02"
"3601","44","20191010081855","PC","AAA04","2","16000","800","15200","2019-10-10 08:18:55"
"3602","21","20191010070303","PC","AAA03","1","17000","3000","14000","2019-10-10 07:03:03"
"3603","98","20191009104426","Shop","AAA02","5","75000","11500","63500","2019-10-09 22:44:26"
"3604","5","20191009080545","PC","AAA04","5","40000","2000","38000","2019-10-09 20:05:45"
"3605","53","20191009054305","Shop","AAA01","2","20000","4000","16000","2019-10-09 17:43:05"
"3606","32","20191009050305","Mobile","AAA03","16","272000","48000","224000","2019-10-09 17:03:05"
"3607","40","20191009040216","Shop","AAA04","1","8000","400","7600","2019-10-09 16:02:16"
"3608","60","20191009023941","PC","AAA02","2","30000","4600","25400","2019-10-09 14:39:41"
"3609","72","20191009013913","Mobile","AAA01","3","30000","6000","24000","2019-10-09 13:39:13"
"3610","17","20191009120507","PC","AAA02","5","75000","11500","63500","2019-10-09 12:05:07"
"3611","63","20191009084800","PC","AAA01","1","10000","2000","8000","2019-10-09 08:48:00"
"3612","65","20191009071927","Shop","AAA03","2","34000","6000","28000","2019-10-09 07:19:27"
"3613","64","20191008084340","Shop","AAA02","16","240000","36800","203200","2019-10-08 20:43:40"
"3614","81","20191008061323","Shop","AAA01","14","140000","28000","112000","2019-10-08 18:13:23"
"3615","80","20191008033350","Mobile","AAA01","12","120000","24000","96000","2019-10-08 15:33:50"
"3616","82","20191008030946","Mobile","AAA05","4","240000","80000","160000","2019-10-08 15:09:46"
"3617","79","20191008015429","Mobile","AAA03","5","85000","15000","70000","2019-10-08 13:54:29"
"3618","76","20191008112346","PC","AAA03","6","102000","18000","84000","2019-10-08 11:23:46"
"3619","27","20191008100545","PC","AAA03","10","170000","30000","140000","2019-10-08 10:05:45"
"3620","14","20191007072155","Mobile","AAA05","6","360000","120000","240000","2019-10-07 19:21:55"
"3621","25","20191007024654","Mobile","AAA04","2","16000","800","15200","2019-10-07 14:46:54"
"3622","93","20191007014023","PC","AAA02","5","75000","11500","63500","2019-10-07 13:40:23"
"3623","81","20191007121846","Shop","AAA04","8","64000","3200","60800","2019-10-07 12:18:46"
"3624","19","20191003024137","PC","AAA02","3","45000","6900","38100","2019-10-03 14:41:37"
"3625","68","20191003011730","Mobile","AAA03","9","153000","27000","126000","2019-10-03 13:17:30"
"3626","83","20191003115119","Shop","AAA03","12","204000","36000","168000","2019-10-03 11:51:19"
"3627","76","20191003100238","PC","AAA04","6","48000","2400","45600","2019-10-03 10:02:38"
"3628","21","20191003085505","PC","AAA05","6","360000","120000","240000","2019-10-03 08:55:05"
"3629","100","20191003072205","PC","AAA02","1","15000","2300","12700","2019-10-03 07:22:05"
"3630","64","20191002121559","Mobile","AAA03","6","102000","18000","84000","2019-10-02 12:15:59"
"3631","20","20191002113852","Mobile","AAA01","6","60000","12000","48000","2019-10-02 11:38:52"
"3632","24","20191002095549","Mobile","AAA01","10","100000","20000","80000","2019-10-02 09:55:49"
"3633","98","20191002090541","Shop","AAA03","5","85000","15000","70000","2019-10-02 09:05:41"
"3634","33","20191001072845","Mobile","AAA01","3","30000","6000","24000","2019-10-01 19:28:45"
"3635","97","20191001043723","PC","AAA04","8","64000","3200","60800","2019-10-01 16:37:23"
"3636","51","20191001040405","Mobile","AAA02","10","150000","23000","127000","2019-10-01 16:04:05"
"3637","30","20191001025242","PC","AAA02","2","30000","4600","25400","2019-10-01 14:52:42"
"3638","34","20191001124119","Shop","AAA01","4","40000","8000","32000","2019-10-01 12:41:19"
"3639","13","20191001120524","Shop","AAA01","3","30000","6000","24000","2019-10-01 12:05:24"
"3640","51","20191001111310","Shop","AAA05","3","180000","60000","120000","2019-10-01 11:13:10"
"3641","22","20191001104302","PC","AAA05","8","480000","160000","320000","2019-10-01 10:43:02"
"3642","64","20191001093739","Shop","AAA04","4","32000","1600","30400","2019-10-01 09:37:39"
"3643","14","20191001084411","Shop","AAA05","5","300000","100000","200000","2019-10-01 08:44:11"
"3644","63","20190930065910","Mobile","AAA05","1","60000","20000","40000","2019-09-30 18:59:10"
"3645","63","20190930035559","Shop","AAA04","10","80000","4000","76000","2019-09-30 15:55:59"
"3646","100","20190930031901","Shop","AAA01","6","60000","12000","48000","2019-09-30 15:19:01"
"3647","2","20190930023210","PC","AAA01","4","40000","8000","32000","2019-09-30 14:32:10"
"3648","99","20190930123354","Mobile","AAA03","4","68000","12000","56000","2019-09-30 12:33:54"
"3649","59","20190930083727","PC","AAA02","4","60000","9200","50800","2019-09-30 08:37:27"
"3650","20","20190927015040","PC","AAA03","6","102000","18000","84000","2019-09-27 01:50:40"
"3651","81","20190926115215","Mobile","AAA02","5","75000","11500","63500","2019-09-26 11:52:15"
"3652","41","20190926102456","PC","AAA02","4","60000","9200","50800","2019-09-26 10:24:56"
"3653","38","20190926092118","Shop","AAA01","12","120000","24000","96000","2019-09-26 09:21:18"
"3654","68","20190926073528","Mobile","AAA04","9","72000","3600","68400","2019-09-26 07:35:28"
"3655","36","20190926125907","Shop","AAA01","15","150000","30000","120000","2019-09-26 00:59:07"
"3656","4","20190925120336","Mobile","AAA02","2","30000","4600","25400","2019-09-25 12:03:36"
"3657","62","20190925094908","Mobile","AAA03","13","221000","39000","182000","2019-09-25 09:49:08"
"3658","25","20190925075058","PC","AAA02","14","210000","32200","177800","2019-09-25 07:50:58"
"3659","26","20190925010243","PC","AAA04","3","24000","1200","22800","2019-09-25 01:02:43"
"3660","74","20190924125638","Mobile","AAA02","9","135000","20700","114300","2019-09-24 12:56:38"
"3661","46","20190924114543","PC","AAA04","2","16000","800","15200","2019-09-24 11:45:43"
"3662","64","20190924094930","Shop","AAA03","9","153000","27000","126000","2019-09-24 09:49:30"
"3663","45","20190924085103","Mobile","AAA02","4","60000","9200","50800","2019-09-24 08:51:03"
"3664","32","20190924074333","Shop","AAA02","9","135000","20700","114300","2019-09-24 07:43:33"
"3665","65","20190923090751","Mobile","AAA03","12","204000","36000","168000","2019-09-23 21:07:51"
"3666","10","20190923063927","PC","AAA02","20","300000","46000","254000","2019-09-23 18:39:27"
"3667","96","20190923034118","Shop","AAA05","5","300000","100000","200000","2019-09-23 15:41:18"
"3668","67","20190923020359","PC","AAA04","1","8000","400","7600","2019-09-23 14:03:59"
"3669","40","20190923120350","PC","AAA05","11","660000","220000","440000","2019-09-23 12:03:50"
"3670","87","20190923105450","Mobile","AAA02","2","30000","4600","25400","2019-09-23 10:54:50"
"3671","93","20190923100855","Shop","AAA04","8","64000","3200","60800","2019-09-23 10:08:55"
"3672","28","20190923085515","Mobile","AAA04","7","56000","2800","53200","2019-09-23 08:55:15"
"3673","25","20190919072207","PC","AAA02","9","135000","20700","114300","2019-09-19 07:22:07"
"3674","99","20190918085458","Mobile","AAA02","1","15000","2300","12700","2019-09-18 20:54:58"
"3675","63","20190918051745","PC","AAA02","2","30000","4600","25400","2019-09-18 17:17:45"
"3676","19","20190918032043","Mobile","AAA03","4","68000","12000","56000","2019-09-18 15:20:43"
"3677","83","20190918013237","Shop","AAA02","3","45000","6900","38100","2019-09-18 13:32:37"
"3678","12","20190918124128","Shop","AAA02","7","105000","16100","88900","2019-09-18 12:41:28"
"3679","37","20190918113457","Mobile","AAA05","12","720000","240000","480000","2019-09-18 11:34:57"
"3680","93","20190918095903","Mobile","AAA02","8","120000","18400","101600","2019-09-18 09:59:03"
"3681","69","20190918090136","PC","AAA01","6","60000","12000","48000","2019-09-18 09:01:36"
"3682","68","20190917024436","PC","AAA03","6","102000","18000","84000","2019-09-17 14:44:36"
"3683","17","20190917012024","Mobile","AAA04","6","48000","2400","45600","2019-09-17 13:20:24"
"3684","97","20190917125347","PC","AAA05","10","600000","200000","400000","2019-09-17 12:53:47"
"3685","54","20190917110642","PC","AAA04","7","56000","2800","53200","2019-09-17 11:06:42"
"3686","44","20190917101641","Shop","AAA02","14","210000","32200","177800","2019-09-17 10:16:41"
"3687","7","20190917091252","Shop","AAA04","10","80000","4000","76000","2019-09-17 09:12:52"
"3688","77","20190917080331","PC","AAA01","3","30000","6000","24000","2019-09-17 08:03:31"
"3689","63","20190917071307","Shop","AAA02","7","105000","16100","88900","2019-09-17 07:13:07"
"3690","74","20190917015058","PC","AAA02","3","45000","6900","38100","2019-09-17 01:50:58"
"3691","30","20190916012311","Mobile","AAA01","4","40000","8000","32000","2019-09-16 13:23:11"
"3692","70","20190916121018","Mobile","AAA03","5","85000","15000","70000","2019-09-16 12:10:18"
"3693","45","20190916102630","PC","AAA03","9","153000","27000","126000","2019-09-16 10:26:30"
"3694","45","20190913093006","PC","AAA04","3","24000","1200","22800","2019-09-13 09:30:06"
"3695","91","20190913082306","Mobile","AAA04","2","16000","800","15200","2019-09-13 08:23:06"
"3696","36","20190912074401","Mobile","AAA01","10","100000","20000","80000","2019-09-12 19:44:01"
"3697","52","20190912032134","Mobile","AAA01","2","20000","4000","16000","2019-09-12 15:21:34"
"3698","26","20190912123156","Mobile","AAA03","3","51000","9000","42000","2019-09-12 12:31:56"
"3699","100","20190912102225","PC","AAA04","4","32000","1600","30400","2019-09-12 10:22:25"
"3700","84","20190912082625","PC","AAA01","5","50000","10000","40000","2019-09-12 08:26:25"
"3701","31","20190912070015","PC","AAA04","11","88000","4400","83600","2019-09-12 07:00:15"
"3702","42","20190911112949","Shop","AAA04","14","112000","5600","106400","2019-09-11 23:29:49"
"3703","45","20190911053930","Mobile","AAA05","3","180000","60000","120000","2019-09-11 17:39:30"
"3704","54","20190911045705","PC","AAA03","6","102000","18000","84000","2019-09-11 16:57:05"
"3705","70","20190911032221","Mobile","AAA04","1","8000","400","7600","2019-09-11 15:22:21"
"3706","4","20190911012038","Mobile","AAA01","3","30000","6000","24000","2019-09-11 13:20:38"
"3707","7","20190911123137","Mobile","AAA01","4","40000","8000","32000","2019-09-11 12:31:37"
"3708","15","20190911105032","PC","AAA05","9","540000","180000","360000","2019-09-11 10:50:32"
"3709","47","20190911095448","Mobile","AAA03","8","136000","24000","112000","2019-09-11 09:54:48"
"3710","30","20190911085140","Mobile","AAA03","8","136000","24000","112000","2019-09-11 08:51:40"
"3711","37","20190910100422","Shop","AAA03","10","170000","30000","140000","2019-09-10 22:04:22"
"3712","33","20190910061128","Shop","AAA05","3","180000","60000","120000","2019-09-10 18:11:28"
"3713","96","20190910022545","Mobile","AAA04","9","72000","3600","68400","2019-09-10 14:25:45"
"3714","99","20190910125920","Mobile","AAA05","4","240000","80000","160000","2019-09-10 12:59:20"
"3715","4","20190910115956","Shop","AAA01","1","10000","2000","8000","2019-09-10 11:59:56"
"3716","84","20190910111313","PC","AAA01","5","50000","10000","40000","2019-09-10 11:13:13"
"3717","89","20190910095653","Shop","AAA04","6","48000","2400","45600","2019-09-10 09:56:53"
"3718","88","20190910073308","Shop","AAA02","8","120000","18400","101600","2019-09-10 07:33:08"
"3719","39","20190909033633","Mobile","AAA04","5","40000","2000","38000","2019-09-09 15:36:33"
"3720","27","20190909012227","Shop","AAA04","11","88000","4400","83600","2019-09-09 13:22:27"
"3721","17","20190909112752","Shop","AAA03","1","17000","3000","14000","2019-09-09 11:27:52"
"3722","56","20190909090309","PC","AAA03","1","17000","3000","14000","2019-09-09 09:03:09"
"3723","62","20190905094718","PC","AAA04","3","24000","1200","22800","2019-09-05 21:47:18"
"3724","27","20190905050245","Shop","AAA05","10","600000","200000","400000","2019-09-05 17:02:45"
"3725","72","20190905033256","Mobile","AAA04","4","32000","1600","30400","2019-09-05 15:32:56"
"3726","48","20190905010847","Shop","AAA05","12","720000","240000","480000","2019-09-05 13:08:47"
"3727","38","20190905102326","PC","AAA04","7","56000","2800","53200","2019-09-05 10:23:26"
"3728","64","20190905083621","Shop","AAA05","16","960000","320000","640000","2019-09-05 08:36:21"
"3729","22","20190904014557","Shop","AAA01","1","10000","2000","8000","2019-09-04 13:45:57"
"3730","74","20190904125620","PC","AAA04","4","32000","1600","30400","2019-09-04 12:56:20"
"3731","28","20190904105623","PC","AAA04","8","64000","3200","60800","2019-09-04 10:56:23"
"3732","1","20190904094841","Shop","AAA02","4","60000","9200","50800","2019-09-04 09:48:41"
"3733","15","20190904074804","PC","AAA04","7","56000","2800","53200","2019-09-04 07:48:04"
"3734","54","20190903093802","Mobile","AAA02","4","60000","9200","50800","2019-09-03 21:38:02"
"3735","47","20190903063158","PC","AAA04","6","48000","2400","45600","2019-09-03 18:31:58"
"3736","89","20190903014448","PC","AAA01","8","80000","16000","64000","2019-09-03 13:44:48"
"3737","87","20190903113349","Shop","AAA02","5","75000","11500","63500","2019-09-03 11:33:49"
"3738","56","20190903102337","Shop","AAA01","5","50000","10000","40000","2019-09-03 10:23:37"
"3739","69","20190903091252","Mobile","AAA05","4","240000","80000","160000","2019-09-03 09:12:52"
"3740","41","20190903081643","PC","AAA02","8","120000","18400","101600","2019-09-03 08:16:43"
"3741","45","20190903072148","PC","AAA02","5","75000","11500","63500","2019-09-03 07:21:48"
"3742","23","20190902081959","Shop","AAA03","3","51000","9000","42000","2019-09-02 20:19:59"
"3743","3","20190902071843","Shop","AAA05","16","960000","320000","640000","2019-09-02 19:18:43"
"3744","96","20190902053246","Shop","AAA05","7","420000","140000","280000","2019-09-02 17:32:46"
"3745","52","20190902041457","Mobile","AAA03","5","85000","15000","70000","2019-09-02 16:14:57"
"3746","34","20190902030013","PC","AAA05","1","60000","20000","40000","2019-09-02 15:00:13"
"3747","8","20190902022139","Shop","AAA02","6","90000","13800","76200","2019-09-02 14:21:39"
"3748","23","20190902123335","PC","AAA05","6","360000","120000","240000","2019-09-02 12:33:35"
"3749","40","20190902101239","PC","AAA04","2","16000","800","15200","2019-09-02 10:12:39"
"3750","84","20190830011239","Mobile","AAA04","2","16000","800","15200","2019-08-30 13:12:39"
"3751","1","20190830090032","Shop","AAA02","4","60000","9200","50800","2019-08-30 09:00:32"
"3752","91","20190830080841","Shop","AAA01","5","50000","10000","40000","2019-08-30 08:08:41"
"3753","16","20190830062744","Mobile","AAA04","12","96000","4800","91200","2019-08-30 06:27:44"
"3754","64","20190830043209","Mobile","AAA05","6","360000","120000","240000","2019-08-30 04:32:09"
"3755","96","20190829084424","PC","AAA03","15","255000","45000","210000","2019-08-29 20:44:24"
"3756","81","20190829054831","Mobile","AAA03","4","68000","12000","56000","2019-08-29 17:48:31"
"3757","25","20190829041041","Shop","AAA01","1","10000","2000","8000","2019-08-29 16:10:41"
"3758","92","20190829031836","Mobile","AAA05","1","60000","20000","40000","2019-08-29 15:18:36"
"3759","65","20190829015830","Mobile","AAA01","2","20000","4000","16000","2019-08-29 13:58:30"
"3760","90","20190829105106","PC","AAA02","2","30000","4600","25400","2019-08-29 10:51:06"
"3761","81","20190829091728","PC","AAA02","6","90000","13800","76200","2019-08-29 09:17:28"
"3762","75","20190829074620","PC","AAA03","5","85000","15000","70000","2019-08-29 07:46:20"
"3763","13","20190828052553","Shop","AAA04","5","40000","2000","38000","2019-08-28 17:25:53"
"3764","64","20190828042133","Mobile","AAA04","1","8000","400","7600","2019-08-28 16:21:33"
"3765","66","20190828025740","PC","AAA04","4","32000","1600","30400","2019-08-28 14:57:40"
"3766","40","20190828012754","Shop","AAA05","1","60000","20000","40000","2019-08-28 13:27:54"
"3767","86","20190828120757","PC","AAA03","3","51000","9000","42000","2019-08-28 12:07:57"
"3768","61","20190828105502","PC","AAA01","6","60000","12000","48000","2019-08-28 10:55:02"
"3769","58","20190828083612","Shop","AAA05","5","300000","100000","200000","2019-08-28 08:36:12"
"3770","49","20190828064908","Mobile","AAA03","7","119000","21000","98000","2019-08-28 06:49:08"
"3771","13","20190827062622","PC","AAA05","1","60000","20000","40000","2019-08-27 18:26:22"
"3772","43","20190827013251","Mobile","AAA04","8","64000","3200","60800","2019-08-27 13:32:51"
"3773","64","20190827123423","Shop","AAA01","2","20000","4000","16000","2019-08-27 12:34:23"
"3774","13","20190827121455","PC","AAA03","3","51000","9000","42000","2019-08-27 12:14:55"
"3775","97","20190827111244","PC","AAA02","1","15000","2300","12700","2019-08-27 11:12:44"
"3776","37","20190827095540","Mobile","AAA04","14","112000","5600","106400","2019-08-27 09:55:40"
"3777","30","20190827073451","Shop","AAA04","15","120000","6000","114000","2019-08-27 07:34:51"
"3778","73","20190826032015","Mobile","AAA02","3","45000","6900","38100","2019-08-26 15:20:15"
"3779","88","20190826024625","Mobile","AAA02","6","90000","13800","76200","2019-08-26 14:46:25"
"3780","68","20190826124233","Mobile","AAA01","1","10000","2000","8000","2019-08-26 12:42:33"
"3781","7","20190826115455","PC","AAA01","7","70000","14000","56000","2019-08-26 11:54:55"
"3782","91","20190826104437","Shop","AAA05","1","60000","20000","40000","2019-08-26 10:44:37"
"3783","45","20190826093655","Mobile","AAA03","1","17000","3000","14000","2019-08-26 09:36:55"
"3784","79","20190824073816","Mobile","AAA05","1","60000","20000","40000","2019-08-24 07:38:16"
"3785","39","20190824012831","PC","AAA02","9","135000","20700","114300","2019-08-24 01:28:31"
"3786","32","20190823082658","Shop","AAA01","10","100000","20000","80000","2019-08-23 08:26:58"
"3787","93","20190823071714","Shop","AAA05","2","120000","40000","80000","2019-08-23 07:17:14"
"3788","84","20190823022706","PC","AAA02","4","60000","9200","50800","2019-08-23 02:27:06"
"3789","99","20190822010750","Shop","AAA01","4","40000","8000","32000","2019-08-22 13:07:50"
"3790","79","20190822113258","Shop","AAA04","8","64000","3200","60800","2019-08-22 11:32:58"
"3791","8","20190822104745","PC","AAA03","8","136000","24000","112000","2019-08-22 10:47:45"
"3792","44","20190822092133","PC","AAA03","4","68000","12000","56000","2019-08-22 09:21:33"
"3793","55","20190822081707","PC","AAA02","11","165000","25300","139700","2019-08-22 08:17:07"
"3794","56","20190822070527","Shop","AAA01","6","60000","12000","48000","2019-08-22 07:05:27"
"3795","91","20190821010128","Shop","AAA04","6","48000","2400","45600","2019-08-21 13:01:28"
"3796","8","20190821110307","PC","AAA02","6","90000","13800","76200","2019-08-21 11:03:07"
"3797","70","20190821095358","Mobile","AAA04","27","216000","10800","205200","2019-08-21 09:53:58"
"3798","17","20190821084221","PC","AAA04","6","48000","2400","45600","2019-08-21 08:42:21"
"3799","100","20190820045907","Mobile","AAA03","12","204000","36000","168000","2019-08-20 16:59:07"
"3800","59","20190820035631","Mobile","AAA01","1","10000","2000","8000","2019-08-20 15:56:31"
"3801","46","20190820125319","Shop","AAA02","12","180000","27600","152400","2019-08-20 12:53:19"
"3802","16","20190820110258","Mobile","AAA03","8","136000","24000","112000","2019-08-20 11:02:58"
"3803","29","20190820091807","PC","AAA05","8","480000","160000","320000","2019-08-20 09:18:07"
"3804","28","20190820081250","Mobile","AAA05","5","300000","100000","200000","2019-08-20 08:12:50"
"3805","100","20190820070057","Shop","AAA05","3","180000","60000","120000","2019-08-20 07:00:57"
"3806","44","20190820030057","Mobile","AAA05","8","480000","160000","320000","2019-08-20 03:00:57"
"3807","61","20190819044213","Mobile","AAA01","1","10000","2000","8000","2019-08-19 16:42:13"
"3808","4","20190819022034","Mobile","AAA01","4","40000","8000","32000","2019-08-19 14:20:34"
"3809","2","20190819123411","PC","AAA04","12","96000","4800","91200","2019-08-19 12:34:11"
"3810","74","20190819105110","Mobile","AAA03","6","102000","18000","84000","2019-08-19 10:51:10"
"3811","90","20190819091845","Shop","AAA01","2","20000","4000","16000","2019-08-19 09:18:45"
"3812","38","20190816012813","Shop","AAA03","6","102000","18000","84000","2019-08-16 13:28:13"
"3813","47","20190816112337","Mobile","AAA03","2","34000","6000","28000","2019-08-16 11:23:37"
"3814","69","20190816103524","PC","AAA01","6","60000","12000","48000","2019-08-16 10:35:24"
"3815","69","20190816083316","PC","AAA03","1","17000","3000","14000","2019-08-16 08:33:16"
"3816","64","20190816072353","Shop","AAA02","12","180000","27600","152400","2019-08-16 07:23:53"
"3817","71","20190816030747","Mobile","AAA04","10","80000","4000","76000","2019-08-16 03:07:47"
"3818","45","20190815034301","Shop","AAA03","1","17000","3000","14000","2019-08-15 15:43:01"
"3819","3","20190815022255","Mobile","AAA04","17","136000","6800","129200","2019-08-15 14:22:55"
"3820","34","20190815012030","Mobile","AAA03","17","289000","51000","238000","2019-08-15 13:20:30"
"3821","52","20190815123235","PC","AAA04","1","8000","400","7600","2019-08-15 12:32:35"
"3822","1","20190815082822","Shop","AAA03","3","51000","9000","42000","2019-08-15 08:28:22"
"3823","21","20190815072225","PC","AAA03","6","102000","18000","84000","2019-08-15 07:22:25"
"3824","33","20190814080606","PC","AAA02","8","120000","18400","101600","2019-08-14 20:06:06"
"3825","92","20190814015042","Mobile","AAA04","2","16000","800","15200","2019-08-14 13:50:42"
"3826","96","20190814125844","Shop","AAA02","2","30000","4600","25400","2019-08-14 12:58:44"
"3827","40","20190814103201","Shop","AAA04","11","88000","4400","83600","2019-08-14 10:32:01"
"3828","45","20190814084441","PC","AAA03","7","119000","21000","98000","2019-08-14 08:44:41"
"3829","99","20190814074001","Shop","AAA04","6","48000","2400","45600","2019-08-14 07:40:01"
"3830","71","20190813094312","Mobile","AAA02","3","45000","6900","38100","2019-08-13 21:43:12"
"3831","79","20190813071127","Mobile","AAA04","13","104000","5200","98800","2019-08-13 19:11:27"
"3832","91","20190813032740","PC","AAA02","3","45000","6900","38100","2019-08-13 15:27:40"
"3833","52","20190813013905","Shop","AAA02","2","30000","4600","25400","2019-08-13 13:39:05"
"3834","49","20190813123857","PC","AAA03","12","204000","36000","168000","2019-08-13 12:38:57"
"3835","47","20190813113108","PC","AAA04","14","112000","5600","106400","2019-08-13 11:31:08"
"3836","41","20190813102202","PC","AAA03","11","187000","33000","154000","2019-08-13 10:22:02"
"3837","21","20190813090626","Mobile","AAA01","11","110000","22000","88000","2019-08-13 09:06:26"
"3838","42","20190813074552","Shop","AAA01","13","130000","26000","104000","2019-08-13 07:45:52"
"3839","5","20190812102906","PC","AAA02","7","105000","16100","88900","2019-08-12 22:29:06"
"3840","82","20190812060127","PC","AAA05","2","120000","40000","80000","2019-08-12 18:01:27"
"3841","54","20190812015205","Mobile","AAA03","4","68000","12000","56000","2019-08-12 13:52:05"
"3842","2","20190812125313","Mobile","AAA05","4","240000","80000","160000","2019-08-12 12:53:13"
"3843","34","20190812113808","Shop","AAA02","8","120000","18400","101600","2019-08-12 11:38:08"
"3844","46","20190812101606","Mobile","AAA03","13","221000","39000","182000","2019-08-12 10:16:06"
"3845","20","20190810094505","Mobile","AAA05","7","420000","140000","280000","2019-08-10 21:45:05"
"3846","70","20190809061218","Shop","AAA02","6","90000","13800","76200","2019-08-09 18:12:18"
"3847","26","20190809021244","Mobile","AAA03","7","119000","21000","98000","2019-08-09 14:12:44"
"3848","83","20190809110728","Shop","AAA01","6","60000","12000","48000","2019-08-09 11:07:28"
"3849","72","20190809090509","PC","AAA02","6","90000","13800","76200","2019-08-09 09:05:09"
"3850","41","20190809080444","Shop","AAA02","4","60000","9200","50800","2019-08-09 08:04:44"
"3851","6","20190809065028","Mobile","AAA01","9","90000","18000","72000","2019-08-09 06:50:28"
"3852","7","20190808042322","Mobile","AAA05","9","540000","180000","360000","2019-08-08 04:23:22"
"3853","83","20190807044244","Shop","AAA05","15","900000","300000","600000","2019-08-07 16:42:44"
"3854","19","20190807032555","PC","AAA05","4","240000","80000","160000","2019-08-07 15:25:55"
"3855","44","20190807121132","Shop","AAA01","8","80000","16000","64000","2019-08-07 12:11:32"
"3856","14","20190807112846","Shop","AAA03","11","187000","33000","154000","2019-08-07 11:28:46"
"3857","74","20190807093905","PC","AAA05","5","300000","100000","200000","2019-08-07 09:39:05"
"3858","67","20190807084241","Mobile","AAA02","5","75000","11500","63500","2019-08-07 08:42:41"
"3859","95","20190807065557","Shop","AAA01","5","50000","10000","40000","2019-08-07 06:55:57"
"3860","44","20190806031306","Shop","AAA05","5","300000","100000","200000","2019-08-06 15:13:06"
"3861","24","20190806013426","Mobile","AAA01","5","50000","10000","40000","2019-08-06 13:34:26"
"3862","34","20190806112250","Mobile","AAA01","8","80000","16000","64000","2019-08-06 11:22:50"
"3863","84","20190806103026","Mobile","AAA02","4","60000","9200","50800","2019-08-06 10:30:26"
"3864","87","20190806093739","Mobile","AAA04","9","72000","3600","68400","2019-08-06 09:37:39"
"3865","63","20190806082734","PC","AAA03","1","17000","3000","14000","2019-08-06 08:27:34"
"3866","51","20190806071633","Mobile","AAA05","5","300000","100000","200000","2019-08-06 07:16:33"
"3867","74","20190805074254","PC","AAA05","2","120000","40000","80000","2019-08-05 19:42:54"
"3868","62","20190805042305","Shop","AAA05","14","840000","280000","560000","2019-08-05 16:23:05"
"3869","73","20190805023233","Shop","AAA04","2","16000","800","15200","2019-08-05 14:32:33"
"3870","59","20190805122906","PC","AAA01","3","30000","6000","24000","2019-08-05 12:29:06"
"3871","34","20190805105924","PC","AAA03","7","119000","21000","98000","2019-08-05 10:59:24"
"3872","44","20190805094555","Mobile","AAA05","7","420000","140000","280000","2019-08-05 09:45:55"
"3873","24","20190801101503","Mobile","AAA04","4","32000","1600","30400","2019-08-01 22:15:03"
"3874","49","20190801010807","PC","AAA02","7","105000","16100","88900","2019-08-01 13:08:07"
"3875","37","20190801114316","Mobile","AAA04","11","88000","4400","83600","2019-08-01 11:43:16"
"3876","24","20190801095215","Mobile","AAA01","3","30000","6000","24000","2019-08-01 09:52:15"
"3877","66","20190801081038","Mobile","AAA05","10","600000","200000","400000","2019-08-01 08:10:38"
"3878","42","20190801072801","Mobile","AAA01","8","80000","16000","64000","2019-08-01 07:28:01"
"3879","98","20190731104230","Shop","AAA03","4","68000","12000","56000","2019-07-31 22:42:30"
"3880","98","20190731064918","Mobile","AAA03","3","51000","9000","42000","2019-07-31 18:49:18"
"3881","90","20190731030614","PC","AAA01","2","20000","4000","16000","2019-07-31 15:06:14"
"3882","69","20190731015341","PC","AAA01","7","70000","14000","56000","2019-07-31 13:53:41"
"3883","65","20190731123336","PC","AAA01","11","110000","22000","88000","2019-07-31 12:33:36"
"3884","59","20190731104643","Mobile","AAA03","5","85000","15000","70000","2019-07-31 10:46:43"
"3885","14","20190731101050","Shop","AAA04","2","16000","800","15200","2019-07-31 10:10:50"
"3886","8","20190731085908","Mobile","AAA01","18","180000","36000","144000","2019-07-31 08:59:08"
"3887","69","20190731075656","Shop","AAA01","4","40000","8000","32000","2019-07-31 07:56:56"
"3888","20","20190730105033","Mobile","AAA04","1","8000","400","7600","2019-07-30 22:50:33"
"3889","65","20190730072145","Mobile","AAA02","1","15000","2300","12700","2019-07-30 19:21:45"
"3890","12","20190730043446","Mobile","AAA01","12","120000","24000","96000","2019-07-30 16:34:46"
"3891","83","20190730031253","Shop","AAA02","6","90000","13800","76200","2019-07-30 15:12:53"
"3892","2","20190730022854","PC","AAA02","1","15000","2300","12700","2019-07-30 14:28:54"
"3893","6","20190730123635","PC","AAA03","8","136000","24000","112000","2019-07-30 12:36:35"
"3894","95","20190730111248","Shop","AAA05","5","300000","100000","200000","2019-07-30 11:12:48"
"3895","23","20190730103358","Shop","AAA02","3","45000","6900","38100","2019-07-30 10:33:58"
"3896","10","20190730095809","Shop","AAA04","8","64000","3200","60800","2019-07-30 09:58:09"
"3897","94","20190730051051","Shop","AAA02","5","75000","11500","63500","2019-07-30 05:10:51"
"3898","58","20190729073452","Shop","AAA01","11","110000","22000","88000","2019-07-29 19:34:52"
"3899","49","20190729044100","Shop","AAA04","8","64000","3200","60800","2019-07-29 16:41:00"
"3900","87","20190729032250","Shop","AAA01","3","30000","6000","24000","2019-07-29 15:22:50"
"3901","57","20190729013856","Shop","AAA02","1","15000","2300","12700","2019-07-29 13:38:56"
"3902","18","20190729123932","Mobile","AAA04","3","24000","1200","22800","2019-07-29 12:39:32"
"3903","93","20190729121652","Shop","AAA01","1","10000","2000","8000","2019-07-29 12:16:52"
"3904","96","20190729103430","PC","AAA01","3","30000","6000","24000","2019-07-29 10:34:30"
"3905","85","20190729092608","PC","AAA05","4","240000","80000","160000","2019-07-29 09:26:08"
"3906","53","20190727064332","Mobile","AAA03","7","119000","21000","98000","2019-07-27 06:43:32"
"3907","78","20190726070229","Mobile","AAA01","5","50000","10000","40000","2019-07-26 19:02:29"
"3908","61","20190726053118","Mobile","AAA03","3","51000","9000","42000","2019-07-26 17:31:18"
"3909","82","20190726050528","Shop","AAA01","10","100000","20000","80000","2019-07-26 17:05:28"
"3910","41","20190726043022","PC","AAA05","3","180000","60000","120000","2019-07-26 16:30:22"
"3911","92","20190726031342","PC","AAA01","9","90000","18000","72000","2019-07-26 15:13:42"
"3912","67","20190726023514","Mobile","AAA02","11","165000","25300","139700","2019-07-26 14:35:14"
"3913","23","20190726015434","Shop","AAA01","9","90000","18000","72000","2019-07-26 13:54:34"
"3914","79","20190726124033","PC","AAA02","4","60000","9200","50800","2019-07-26 12:40:33"
"3915","9","20190726115728","Shop","AAA03","1","17000","3000","14000","2019-07-26 11:57:28"
"3916","88","20190726103154","Shop","AAA03","10","170000","30000","140000","2019-07-26 10:31:54"
"3917","82","20190726090731","Shop","AAA05","6","360000","120000","240000","2019-07-26 09:07:31"
"3918","16","20190726075159","PC","AAA03","8","136000","24000","112000","2019-07-26 07:51:59"
"3919","22","20190725090605","Mobile","AAA01","7","70000","14000","56000","2019-07-25 21:06:05"
"3920","38","20190725052412","Mobile","AAA04","5","40000","2000","38000","2019-07-25 17:24:12"
"3921","12","20190725040824","Shop","AAA01","2","20000","4000","16000","2019-07-25 16:08:24"
"3922","31","20190725030519","Shop","AAA03","10","170000","30000","140000","2019-07-25 15:05:19"
"3923","65","20190725011107","Mobile","AAA05","6","360000","120000","240000","2019-07-25 13:11:07"
"3924","70","20190725110700","Mobile","AAA01","25","250000","50000","200000","2019-07-25 11:07:00"
"3925","30","20190725095350","Shop","AAA01","1","10000","2000","8000","2019-07-25 09:53:50"
"3926","96","20190725084430","PC","AAA01","9","90000","18000","72000","2019-07-25 08:44:30"
"3927","94","20190725073427","PC","AAA02","11","165000","25300","139700","2019-07-25 07:34:27"
"3928","51","20190724083207","Mobile","AAA05","15","900000","300000","600000","2019-07-24 20:32:07"
"3929","81","20190724035545","PC","AAA05","1","60000","20000","40000","2019-07-24 15:55:45"
"3930","97","20190724030938","Mobile","AAA03","7","119000","21000","98000","2019-07-24 15:09:38"
"3931","22","20190724013512","Mobile","AAA02","6","90000","13800","76200","2019-07-24 13:35:12"
"3932","73","20190724124739","PC","AAA02","8","120000","18400","101600","2019-07-24 12:47:39"
"3933","72","20190724110934","Shop","AAA02","6","90000","13800","76200","2019-07-24 11:09:34"
"3934","87","20190724085313","PC","AAA03","4","68000","12000","56000","2019-07-24 08:53:13"
"3935","2","20190724040930","Mobile","AAA05","8","480000","160000","320000","2019-07-24 04:09:30"
"3936","55","20190723073453","Mobile","AAA03","5","85000","15000","70000","2019-07-23 19:34:53"
"3937","84","20190723034253","Mobile","AAA04","4","32000","1600","30400","2019-07-23 15:42:53"
"3938","20","20190723021132","Shop","AAA01","6","60000","12000","48000","2019-07-23 14:11:32"
"3939","3","20190723122843","Shop","AAA01","11","110000","22000","88000","2019-07-23 12:28:43"
"3940","82","20190723111830","PC","AAA01","6","60000","12000","48000","2019-07-23 11:18:30"
"3941","24","20190723093129","PC","AAA03","6","102000","18000","84000","2019-07-23 09:31:29"
"3942","37","20190723080614","PC","AAA02","9","135000","20700","114300","2019-07-23 08:06:14"
"3943","26","20190723062134","Shop","AAA04","7","56000","2800","53200","2019-07-23 06:21:34"
"3944","84","20190722074325","PC","AAA04","5","40000","2000","38000","2019-07-22 19:43:25"
"3945","28","20190722014550","PC","AAA02","3","45000","6900","38100","2019-07-22 13:45:50"
"3946","21","20190722123627","PC","AAA02","11","165000","25300","139700","2019-07-22 12:36:27"
"3947","77","20190722115228","Shop","AAA01","1","10000","2000","8000","2019-07-22 11:52:28"
"3948","24","20190722104616","Mobile","AAA05","14","840000","280000","560000","2019-07-22 10:46:16"
"3949","88","20190722095507","Mobile","AAA02","2","30000","4600","25400","2019-07-22 09:55:07"
"3950","95","20190720055701","Shop","AAA03","2","34000","6000","28000","2019-07-20 05:57:01"
"3951","88","20190719114240","Shop","AAA04","3","24000","1200","22800","2019-07-19 11:42:40"
"3952","71","20190719095920","Shop","AAA04","5","40000","2000","38000","2019-07-19 09:59:20"
"3953","60","20190719092015","Shop","AAA03","1","17000","3000","14000","2019-07-19 09:20:15"
"3954","1","20190719073314","Shop","AAA04","14","112000","5600","106400","2019-07-19 07:33:14"
"3955","83","20190719120927","PC","AAA03","17","289000","51000","238000","2019-07-19 00:09:27"
"3956","85","20190718100353","PC","AAA03","4","68000","12000","56000","2019-07-18 22:03:53"
"3957","64","20190718050853","Shop","AAA04","12","96000","4800","91200","2019-07-18 17:08:53"
"3958","30","20190718032052","Mobile","AAA05","9","540000","180000","360000","2019-07-18 15:20:52"
"3959","29","20190718022402","PC","AAA05","8","480000","160000","320000","2019-07-18 14:24:02"
"3960","34","20190718022007","Mobile","AAA03","1","17000","3000","14000","2019-07-18 14:20:07"
"3961","80","20190718014112","Mobile","AAA05","4","240000","80000","160000","2019-07-18 13:41:12"
"3962","40","20190718120325","PC","AAA04","2","16000","800","15200","2019-07-18 12:03:25"
"3963","84","20190718104946","Shop","AAA02","1","15000","2300","12700","2019-07-18 10:49:46"
"3964","40","20190718070143","Shop","AAA01","8","80000","16000","64000","2019-07-18 07:01:43"
"3965","29","20190717044940","PC","AAA01","9","90000","18000","72000","2019-07-17 16:49:40"
"3966","85","20190717032446","Shop","AAA01","3","30000","6000","24000","2019-07-17 15:24:46"
"3967","74","20190717013253","PC","AAA01","8","80000","16000","64000","2019-07-17 13:32:53"
"3968","27","20190717124300","PC","AAA02","16","240000","36800","203200","2019-07-17 12:43:00"
"3969","89","20190717113810","PC","AAA03","11","187000","33000","154000","2019-07-17 11:38:10"
"3970","17","20190717090555","PC","AAA02","2","30000","4600","25400","2019-07-17 09:05:55"
"3971","11","20190717075117","Mobile","AAA02","6","90000","13800","76200","2019-07-17 07:51:17"
"3972","41","20190717013130","Shop","AAA04","7","56000","2800","53200","2019-07-17 01:31:30"
"3973","14","20190716105528","PC","AAA01","4","40000","8000","32000","2019-07-16 10:55:28"
"3974","12","20190716093422","PC","AAA02","4","60000","9200","50800","2019-07-16 09:34:22"
"3975","97","20190716081644","Shop","AAA03","2","34000","6000","28000","2019-07-16 08:16:44"
"3976","11","20190716071839","Mobile","AAA05","6","360000","120000","240000","2019-07-16 07:18:39"
"3977","100","20190715065402","Shop","AAA04","8","64000","3200","60800","2019-07-15 18:54:02"
"3978","30","20190715041438","Shop","AAA01","7","70000","14000","56000","2019-07-15 16:14:38"
"3979","100","20190715030033","Shop","AAA01","3","30000","6000","24000","2019-07-15 15:00:33"
"3980","98","20190715012716","Shop","AAA01","1","10000","2000","8000","2019-07-15 13:27:16"
"3981","57","20190715120504","Mobile","AAA02","9","135000","20700","114300","2019-07-15 12:05:04"
"3982","43","20190715110000","Mobile","AAA03","15","255000","45000","210000","2019-07-15 11:00:00"
"3983","24","20190715100526","Mobile","AAA01","2","20000","4000","16000","2019-07-15 10:05:26"
"3984","45","20190715083854","Shop","AAA04","9","72000","3600","68400","2019-07-15 08:38:54"
"3985","32","20190713023729","PC","AAA01","19","190000","38000","152000","2019-07-13 02:37:29"
"3986","22","20190712085013","PC","AAA03","10","170000","30000","140000","2019-07-12 08:50:13"
"3987","15","20190712080039","Shop","AAA04","11","88000","4400","83600","2019-07-12 08:00:39"
"3988","65","20190712063640","Shop","AAA01","11","110000","22000","88000","2019-07-12 06:36:40"
"3989","34","20190711035233","Mobile","AAA04","5","40000","2000","38000","2019-07-11 15:52:33"
"3990","2","20190711024631","Mobile","AAA02","4","60000","9200","50800","2019-07-11 14:46:31"
"3991","44","20190711124027","PC","AAA03","1","17000","3000","14000","2019-07-11 12:40:27"
"3992","58","20190711120043","Mobile","AAA04","5","40000","2000","38000","2019-07-11 12:00:43"
"3993","40","20190711101445","PC","AAA05","3","180000","60000","120000","2019-07-11 10:14:45"
"3994","26","20190711072645","Mobile","AAA02","2","30000","4600","25400","2019-07-11 07:26:45"
"3995","36","20190710035325","Mobile","AAA04","14","112000","5600","106400","2019-07-10 15:53:25"
"3996","75","20190710025719","Mobile","AAA01","4","40000","8000","32000","2019-07-10 14:57:19"
"3997","27","20190710022432","Shop","AAA03","8","136000","24000","112000","2019-07-10 14:24:32"
"3998","81","20190710013102","PC","AAA03","2","34000","6000","28000","2019-07-10 13:31:02"
"3999","62","20190710122457","PC","AAA02","15","225000","34500","190500","2019-07-10 12:24:57"
"4000","13","20190710111152","Mobile","AAA05","7","420000","140000","280000","2019-07-10 11:11:52"
"4001","66","20190710074324","Mobile","AAA04","2","16000","800","15200","2019-07-10 07:43:24"
"4002","63","20190709071835","Mobile","AAA01","1","10000","2000","8000","2019-07-09 19:18:35"
"4003","64","20190709032427","Mobile","AAA05","9","540000","180000","360000","2019-07-09 15:24:27"
"4004","42","20190709012254","Mobile","AAA04","16","128000","6400","121600","2019-07-09 13:22:54"
"4005","62","20190709093612","Mobile","AAA05","4","240000","80000","160000","2019-07-09 09:36:12"
"4006","13","20190709071125","Shop","AAA01","3","30000","6000","24000","2019-07-09 07:11:25"
"4007","51","20190708064225","Shop","AAA02","8","120000","18400","101600","2019-07-08 18:42:25"
"4008","72","20190708125632","PC","AAA03","3","51000","9000","42000","2019-07-08 12:56:32"
"4009","45","20190708114952","PC","AAA05","5","300000","100000","200000","2019-07-08 11:49:52"
"4010","26","20190708091356","PC","AAA03","1","17000","3000","14000","2019-07-08 09:13:56"
"4011","8","20190706073623","PC","AAA03","12","204000","36000","168000","2019-07-06 19:36:23"
"4012","25","20190705084147","PC","AAA04","9","72000","3600","68400","2019-07-05 20:41:47"
"4013","93","20190705060504","PC","AAA04","5","40000","2000","38000","2019-07-05 18:05:04"
"4014","63","20190705012720","Mobile","AAA02","1","15000","2300","12700","2019-07-05 13:27:20"
"4015","35","20190705124648","PC","AAA02","2","30000","4600","25400","2019-07-05 12:46:48"
"4016","82","20190705095950","Mobile","AAA03","11","187000","33000","154000","2019-07-05 09:59:50"
"4017","77","20190705090404","PC","AAA01","1","10000","2000","8000","2019-07-05 09:04:04"
"4018","16","20190705074442","Mobile","AAA01","16","160000","32000","128000","2019-07-05 07:44:42"
"4019","72","20190704124126","Mobile","AAA04","5","40000","2000","38000","2019-07-04 12:41:26"
"4020","11","20190704111709","PC","AAA05","1","60000","20000","40000","2019-07-04 11:17:09"
"4021","8","20190704084638","PC","AAA01","10","100000","20000","80000","2019-07-04 08:46:38"
"4022","64","20190704075922","PC","AAA02","3","45000","6900","38100","2019-07-04 07:59:22"
"4023","20","20190703083110","Shop","AAA03","6","102000","18000","84000","2019-07-03 20:31:10"
"4024","32","20190703021437","Mobile","AAA04","17","136000","6800","129200","2019-07-03 14:14:37"
"4025","84","20190703011940","PC","AAA03","2","34000","6000","28000","2019-07-03 13:19:40"
"4026","21","20190703124010","PC","AAA03","13","221000","39000","182000","2019-07-03 12:40:10"
"4027","54","20190703111319","Shop","AAA05","5","300000","100000","200000","2019-07-03 11:13:19"
"4028","32","20190703100919","PC","AAA04","23","184000","9200","174800","2019-07-03 10:09:19"
"4029","49","20190703093037","Mobile","AAA02","18","270000","41400","228600","2019-07-03 09:30:37"
"4030","54","20190703073015","PC","AAA04","2","16000","800","15200","2019-07-03 07:30:15"
"4031","49","20190702071416","Mobile","AAA05","8","480000","160000","320000","2019-07-02 19:14:16"
"4032","32","20190702035545","Mobile","AAA03","3","51000","9000","42000","2019-07-02 15:55:45"
"4033","79","20190702025338","Mobile","AAA03","13","221000","39000","182000","2019-07-02 14:53:38"
"4034","21","20190702014914","Shop","AAA01","10","100000","20000","80000","2019-07-02 13:49:14"
"4035","17","20190702110924","PC","AAA05","7","420000","140000","280000","2019-07-02 11:09:24"
"4036","47","20190702101956","Shop","AAA04","19","152000","7600","144400","2019-07-02 10:19:56"
"4037","97","20190702093306","Mobile","AAA01","5","50000","10000","40000","2019-07-02 09:33:06"
"4038","80","20190702091405","Mobile","AAA05","1","60000","20000","40000","2019-07-02 09:14:05"
"4039","40","20190702080914","Shop","AAA02","6","90000","13800","76200","2019-07-02 08:09:14"
"4040","61","20190702063053","Mobile","AAA03","11","187000","33000","154000","2019-07-02 06:30:53"
"4041","49","20190701075121","Mobile","AAA02","10","150000","23000","127000","2019-07-01 19:51:21"
"4042","93","20190701033011","Shop","AAA02","2","30000","4600","25400","2019-07-01 15:30:11"
"4043","93","20190701020630","PC","AAA05","3","180000","60000","120000","2019-07-01 14:06:30"
"4044","46","20190701010129","Shop","AAA02","7","105000","16100","88900","2019-07-01 13:01:29"
"4045","82","20190701113739","PC","AAA04","5","40000","2000","38000","2019-07-01 11:37:39"
"4046","90","20190701102331","Shop","AAA02","2","30000","4600","25400","2019-07-01 10:23:31"
"4047","10","20190701090940","Shop","AAA04","18","144000","7200","136800","2019-07-01 09:09:40"
"4048","72","20190627114946","PC","AAA03","9","153000","27000","126000","2019-06-27 11:49:46"
"4049","66","20190627105323","Mobile","AAA01","1","10000","2000","8000","2019-06-27 10:53:23"
"4050","41","20190627095325","Shop","AAA05","5","300000","100000","200000","2019-06-27 09:53:25"
"4051","79","20190627085812","Shop","AAA01","5","50000","10000","40000","2019-06-27 08:58:12"
"4052","100","20190627074845","PC","AAA02","6","90000","13800","76200","2019-06-27 07:48:45"
"4053","83","20190626021314","Mobile","AAA02","7","105000","16100","88900","2019-06-26 14:13:14"
"4054","30","20190626020542","PC","AAA02","3","45000","6900","38100","2019-06-26 14:05:42"
"4055","27","20190626125538","Shop","AAA02","8","120000","18400","101600","2019-06-26 12:55:38"
"4056","63","20190626120733","Shop","AAA01","6","60000","12000","48000","2019-06-26 12:07:33"
"4057","91","20190626095613","Shop","AAA02","2","30000","4600","25400","2019-06-26 09:56:13"
"4058","12","20190626091533","Shop","AAA05","1","60000","20000","40000","2019-06-26 09:15:33"
"4059","14","20190625112917","Mobile","AAA05","5","300000","100000","200000","2019-06-25 23:29:17"
"4060","59","20190625090158","Shop","AAA01","4","40000","8000","32000","2019-06-25 09:01:58"
"4061","68","20190625082626","Shop","AAA05","2","120000","40000","80000","2019-06-25 08:26:26"
"4062","72","20190624064119","Mobile","AAA05","2","120000","40000","80000","2019-06-24 18:41:19"
"4063","24","20190624120455","PC","AAA01","5","50000","10000","40000","2019-06-24 12:04:55"
"4064","47","20190624094259","Shop","AAA04","1","8000","400","7600","2019-06-24 09:42:59"
"4065","34","20190623013416","Shop","AAA02","6","90000","13800","76200","2019-06-23 13:34:16"
"4066","2","20190621043427","Mobile","AAA01","14","140000","28000","112000","2019-06-21 16:34:27"
"4067","2","20190621031021","Mobile","AAA05","1","60000","20000","40000","2019-06-21 15:10:21"
"4068","60","20190621125202","PC","AAA04","8","64000","3200","60800","2019-06-21 12:52:02"
"4069","17","20190621110523","Mobile","AAA05","6","360000","120000","240000","2019-06-21 11:05:23"
"4070","43","20190621095949","PC","AAA02","4","60000","9200","50800","2019-06-21 09:59:49"
"4071","69","20190621083814","Shop","AAA01","5","50000","10000","40000","2019-06-21 08:38:14"
"4072","85","20190621071728","Mobile","AAA05","6","360000","120000","240000","2019-06-21 07:17:28"
"4073","9","20190621020819","PC","AAA04","2","16000","800","15200","2019-06-21 02:08:19"
"4074","94","20190620043414","Mobile","AAA04","10","80000","4000","76000","2019-06-20 16:34:14"
"4075","44","20190620025627","Shop","AAA04","5","40000","2000","38000","2019-06-20 14:56:27"
"4076","21","20190620015834","Shop","AAA05","4","240000","80000","160000","2019-06-20 13:58:34"
"4077","54","20190620124819","Mobile","AAA02","1","15000","2300","12700","2019-06-20 12:48:19"
"4078","42","20190620105139","Shop","AAA05","6","360000","120000","240000","2019-06-20 10:51:39"
"4079","85","20190620083059","Mobile","AAA02","11","165000","25300","139700","2019-06-20 08:30:59"
"4080","2","20190620073750","PC","AAA02","8","120000","18400","101600","2019-06-20 07:37:50"
"4081","92","20190620043343","PC","AAA02","1","15000","2300","12700","2019-06-20 04:33:43"
"4082","20","20190619101314","Shop","AAA03","5","85000","15000","70000","2019-06-19 22:13:14"
"4083","19","20190619061505","PC","AAA02","9","135000","20700","114300","2019-06-19 18:15:05"
"4084","99","20190619112827","Mobile","AAA01","3","30000","6000","24000","2019-06-19 11:28:27"
"4085","36","20190619103040","Shop","AAA04","4","32000","1600","30400","2019-06-19 10:30:40"
"4086","38","20190619084912","PC","AAA05","2","120000","40000","80000","2019-06-19 08:49:12"
"4087","83","20190619065835","PC","AAA01","6","60000","12000","48000","2019-06-19 06:58:35"
"4088","60","20190618085029","PC","AAA01","4","40000","8000","32000","2019-06-18 20:50:29"
"4089","59","20190618035439","Mobile","AAA01","7","70000","14000","56000","2019-06-18 15:54:39"
"4090","97","20190618011055","Mobile","AAA03","5","85000","15000","70000","2019-06-18 13:10:55"
"4091","21","20190618095810","PC","AAA04","10","80000","4000","76000","2019-06-18 09:58:10"
"4092","41","20190618085643","PC","AAA01","8","80000","16000","64000","2019-06-18 08:56:43"
"4093","83","20190618071706","PC","AAA01","7","70000","14000","56000","2019-06-18 07:17:06"
"4094","64","20190617065511","Shop","AAA02","7","105000","16100","88900","2019-06-17 18:55:11"
"4095","58","20190617040934","Shop","AAA05","7","420000","140000","280000","2019-06-17 16:09:34"
"4096","3","20190617113851","Mobile","AAA04","14","112000","5600","106400","2019-06-17 11:38:51"
"4097","67","20190614095804","Shop","AAA05","2","120000","40000","80000","2019-06-14 09:58:04"
"4098","58","20190614074933","Mobile","AAA01","7","70000","14000","56000","2019-06-14 07:49:33"
"4099","82","20190613061328","Shop","AAA03","14","238000","42000","196000","2019-06-13 18:13:28"
"4100","90","20190613043802","Mobile","AAA05","4","240000","80000","160000","2019-06-13 16:38:02"
"4101","33","20190613033200","PC","AAA04","3","24000","1200","22800","2019-06-13 15:32:00"
"4102","23","20190613024129","Mobile","AAA05","6","360000","120000","240000","2019-06-13 14:41:29"
"4103","84","20190613124328","Mobile","AAA03","9","153000","27000","126000","2019-06-13 12:43:28"
"4104","46","20190613113518","Shop","AAA02","6","90000","13800","76200","2019-06-13 11:35:18"
"4105","51","20190613101134","Mobile","AAA04","4","32000","1600","30400","2019-06-13 10:11:34"
"4106","3","20190613085152","Shop","AAA05","24","1440000","480000","960000","2019-06-13 08:51:52"
"4107","93","20190613074144","Mobile","AAA05","6","360000","120000","240000","2019-06-13 07:41:44"
"4108","50","20190613121532","PC","AAA04","11","88000","4400","83600","2019-06-13 00:15:32"
"4109","76","20190612010010","Mobile","AAA04","11","88000","4400","83600","2019-06-12 13:00:10"
"4110","68","20190612120117","Mobile","AAA05","11","660000","220000","440000","2019-06-12 12:01:17"
"4111","19","20190612103007","Shop","AAA02","6","90000","13800","76200","2019-06-12 10:30:07"
"4112","86","20190612090007","Mobile","AAA03","6","102000","18000","84000","2019-06-12 09:00:07"
"4113","6","20190612074221","Mobile","AAA02","2","30000","4600","25400","2019-06-12 07:42:21"
"4114","59","20190612123501","Mobile","AAA03","2","34000","6000","28000","2019-06-12 00:35:01"
"4115","93","20190611102028","Mobile","AAA05","9","540000","180000","360000","2019-06-11 10:20:28"
"4116","73","20190611093239","Mobile","AAA03","1","17000","3000","14000","2019-06-11 09:32:39"
"4117","20","20190611081018","PC","AAA02","2","30000","4600","25400","2019-06-11 08:10:18"
"4118","80","20190611063758","PC","AAA04","6","48000","2400","45600","2019-06-11 06:37:58"
"4119","76","20190610095026","Shop","AAA02","8","120000","18400","101600","2019-06-10 09:50:26"
"4120","15","20190607034232","PC","AAA05","17","1020000","340000","680000","2019-06-07 03:42:32"
"4121","86","20190606044217","Mobile","AAA03","5","85000","15000","70000","2019-06-06 16:42:17"
"4122","52","20190606033956","Shop","AAA02","2","30000","4600","25400","2019-06-06 15:39:56"
"4123","75","20190606015334","Shop","AAA04","1","8000","400","7600","2019-06-06 13:53:34"
"4124","69","20190606124147","Shop","AAA03","1","17000","3000","14000","2019-06-06 12:41:47"
"4125","5","20190606112733","Shop","AAA04","18","144000","7200","136800","2019-06-06 11:27:33"
"4126","92","20190606095526","Shop","AAA05","5","300000","100000","200000","2019-06-06 09:55:26"
"4127","33","20190605044717","Mobile","AAA04","1","8000","400","7600","2019-06-05 16:47:17"
"4128","10","20190605032720","PC","AAA04","5","40000","2000","38000","2019-06-05 15:27:20"
"4129","40","20190605021058","Shop","AAA01","2","20000","4000","16000","2019-06-05 14:10:58"
"4130","3","20190605010408","PC","AAA04","10","80000","4000","76000","2019-06-05 13:04:08"
"4131","56","20190605115805","Mobile","AAA05","7","420000","140000","280000","2019-06-05 11:58:05"
"4132","22","20190605102013","PC","AAA02","2","30000","4600","25400","2019-06-05 10:20:13"
"4133","89","20190605090557","Shop","AAA04","20","160000","8000","152000","2019-06-05 09:05:57"
"4134","66","20190605080240","Mobile","AAA02","6","90000","13800","76200","2019-06-05 08:02:40"
"4135","79","20190605063244","Mobile","AAA04","12","96000","4800","91200","2019-06-05 06:32:44"
"4136","34","20190604083416","Mobile","AAA02","11","165000","25300","139700","2019-06-04 20:34:16"
"4137","42","20190604061923","Shop","AAA01","15","150000","30000","120000","2019-06-04 18:19:23"
"4138","24","20190604010607","Mobile","AAA02","6","90000","13800","76200","2019-06-04 13:06:07"
"4139","90","20190604094908","Shop","AAA02","1","15000","2300","12700","2019-06-04 09:49:08"
"4140","34","20190604083318","Mobile","AAA02","6","90000","13800","76200","2019-06-04 08:33:18"
"4141","53","20190603085213","Shop","AAA03","7","119000","21000","98000","2019-06-03 20:52:13"
"4142","49","20190603044347","PC","AAA05","15","900000","300000","600000","2019-06-03 16:43:47"
"4143","91","20190603025553","Mobile","AAA03","4","68000","12000","56000","2019-06-03 14:55:53"
"4144","48","20190603011000","PC","AAA04","1","8000","400","7600","2019-06-03 13:10:00"
"4145","10","20190603121754","PC","AAA05","13","780000","260000","520000","2019-06-03 12:17:54"
"4146","8","20190603093615","Mobile","AAA05","6","360000","120000","240000","2019-06-03 09:36:15"
"4147","24","20190530082957","Mobile","AAA01","5","50000","10000","40000","2019-05-30 20:29:57"
"4148","17","20190530062850","Mobile","AAA02","6","90000","13800","76200","2019-05-30 18:28:50"
"4149","92","20190530043100","Mobile","AAA02","2","30000","4600","25400","2019-05-30 16:31:00"
"4150","72","20190530034616","Shop","AAA03","1","17000","3000","14000","2019-05-30 15:46:16"
"4151","76","20190530022851","Shop","AAA03","11","187000","33000","154000","2019-05-30 14:28:51"
"4152","63","20190530124950","Shop","AAA04","6","48000","2400","45600","2019-05-30 12:49:50"
"4153","70","20190530115215","Mobile","AAA04","9","72000","3600","68400","2019-05-30 11:52:15"
"4154","21","20190530102055","Mobile","AAA01","7","70000","14000","56000","2019-05-30 10:20:55"
"4155","37","20190530090018","PC","AAA02","17","255000","39100","215900","2019-05-30 09:00:18"
"4156","10","20190530075405","Mobile","AAA05","10","600000","200000","400000","2019-05-30 07:54:05"
"4157","8","20190529054713","Shop","AAA03","6","102000","18000","84000","2019-05-29 17:47:13"
"4158","10","20190529040824","Mobile","AAA05","2","120000","40000","80000","2019-05-29 16:08:24"
"4159","64","20190529031127","Shop","AAA04","5","40000","2000","38000","2019-05-29 15:11:27"
"4160","2","20190529015929","PC","AAA03","1","17000","3000","14000","2019-05-29 13:59:29"
"4161","1","20190529010355","Shop","AAA02","5","75000","11500","63500","2019-05-29 13:03:55"
"4162","96","20190529114503","Shop","AAA05","8","480000","160000","320000","2019-05-29 11:45:03"
"4163","65","20190529105138","PC","AAA03","8","136000","24000","112000","2019-05-29 10:51:38"
"4164","21","20190529100542","Mobile","AAA03","6","102000","18000","84000","2019-05-29 10:05:42"
"4165","61","20190529085108","Mobile","AAA04","1","8000","400","7600","2019-05-29 08:51:08"
"4166","97","20190529072042","Mobile","AAA05","5","300000","100000","200000","2019-05-29 07:20:42"
"4167","95","20190528034218","PC","AAA02","5","75000","11500","63500","2019-05-28 15:42:18"
"4168","73","20190528015325","PC","AAA03","10","170000","30000","140000","2019-05-28 13:53:25"
"4169","76","20190528120224","Mobile","AAA02","2","30000","4600","25400","2019-05-28 12:02:24"
"4170","44","20190528084141","PC","AAA05","3","180000","60000","120000","2019-05-28 08:41:41"
"4171","34","20190528065854","PC","AAA02","12","180000","27600","152400","2019-05-28 06:58:54"
"4172","94","20190527032013","PC","AAA03","6","102000","18000","84000","2019-05-27 15:20:13"
"4173","1","20190527020512","Mobile","AAA05","9","540000","180000","360000","2019-05-27 14:05:12"
"4174","22","20190527114352","Shop","AAA02","3","45000","6900","38100","2019-05-27 11:43:52"
"4175","23","20190527104252","PC","AAA02","3","45000","6900","38100","2019-05-27 10:42:52"
"4176","12","20190522111029","Shop","AAA03","3","51000","9000","42000","2019-05-22 11:10:29"
"4177","83","20190522101223","Shop","AAA03","11","187000","33000","154000","2019-05-22 10:12:23"
"4178","80","20190522094252","Mobile","AAA01","13","130000","26000","104000","2019-05-22 09:42:52"
"4179","39","20190522075511","PC","AAA04","5","40000","2000","38000","2019-05-22 07:55:11"
"4180","91","20190521073713","Mobile","AAA03","7","119000","21000","98000","2019-05-21 19:37:13"
"4181","15","20190521041255","Mobile","AAA03","14","238000","42000","196000","2019-05-21 16:12:55"
"4182","73","20190521115405","Shop","AAA04","12","96000","4800","91200","2019-05-21 11:54:05"
"4183","28","20190521110430","Shop","AAA01","6","60000","12000","48000","2019-05-21 11:04:30"
"4184","34","20190521085033","Mobile","AAA02","3","45000","6900","38100","2019-05-21 08:50:33"
"4185","18","20190520062715","PC","AAA03","5","85000","15000","70000","2019-05-20 18:27:15"
"4186","93","20190520024430","Shop","AAA01","5","50000","10000","40000","2019-05-20 14:44:30"
"4187","42","20190520121128","Shop","AAA03","3","51000","9000","42000","2019-05-20 12:11:28"
"4188","23","20190520112014","Mobile","AAA05","12","720000","240000","480000","2019-05-20 11:20:14"
"4189","99","20190520101043","Mobile","AAA05","3","180000","60000","120000","2019-05-20 10:10:43"
"4190","17","20190520090800","PC","AAA03","8","136000","24000","112000","2019-05-20 09:08:00"
"4191","25","20190516031216","PC","AAA03","14","238000","42000","196000","2019-05-16 15:12:16"
"4192","87","20190516020958","PC","AAA03","2","34000","6000","28000","2019-05-16 14:09:58"
"4193","30","20190516012049","Shop","AAA05","2","120000","40000","80000","2019-05-16 13:20:49"
"4194","8","20190516110636","PC","AAA02","3","45000","6900","38100","2019-05-16 11:06:36"
"4195","39","20190516095105","Shop","AAA05","3","180000","60000","120000","2019-05-16 09:51:05"
"4196","70","20190516082702","Shop","AAA02","13","195000","29900","165100","2019-05-16 08:27:02"
"4197","52","20190516073116","PC","AAA01","6","60000","12000","48000","2019-05-16 07:31:16"
"4198","99","20190515061833","Shop","AAA03","3","51000","9000","42000","2019-05-15 18:18:33"
"4199","25","20190515012959","Shop","AAA04","5","40000","2000","38000","2019-05-15 13:29:59"
"4200","59","20190515123353","PC","AAA02","8","120000","18400","101600","2019-05-15 12:33:53"
"4201","55","20190515114753","Mobile","AAA02","11","165000","25300","139700","2019-05-15 11:47:53"
"4202","96","20190515101529","Mobile","AAA01","3","30000","6000","24000","2019-05-15 10:15:29"
"4203","2","20190515083545","PC","AAA04","5","40000","2000","38000","2019-05-15 08:35:45"
"4204","92","20190515070139","Shop","AAA04","5","40000","2000","38000","2019-05-15 07:01:39"
"4205","40","20190514055708","Shop","AAA02","4","60000","9200","50800","2019-05-14 17:57:08"
"4206","36","20190514042613","PC","AAA01","13","130000","26000","104000","2019-05-14 16:26:13"
"4207","58","20190514030332","PC","AAA03","7","119000","21000","98000","2019-05-14 15:03:32"
"4208","55","20190514123902","PC","AAA04","13","104000","5200","98800","2019-05-14 12:39:02"
"4209","19","20190514113243","PC","AAA04","6","48000","2400","45600","2019-05-14 11:32:43"
"4210","78","20190514095915","Shop","AAA02","3","45000","6900","38100","2019-05-14 09:59:15"
"4211","20","20190514090739","Shop","AAA02","3","45000","6900","38100","2019-05-14 09:07:39"
"4212","80","20190514080627","PC","AAA03","6","102000","18000","84000","2019-05-14 08:06:27"
"4213","58","20190514075858","Shop","AAA04","7","56000","2800","53200","2019-05-14 07:58:58"
"4214","66","20190513031317","Shop","AAA01","3","30000","6000","24000","2019-05-13 15:13:17"
"4215","5","20190513015735","PC","AAA01","15","150000","30000","120000","2019-05-13 13:57:35"
"4216","60","20190513115619","Mobile","AAA01","1","10000","2000","8000","2019-05-13 11:56:19"
"4217","16","20190513101255","PC","AAA04","10","80000","4000","76000","2019-05-13 10:12:55"
"4218","58","20190513092835","Mobile","AAA02","2","30000","4600","25400","2019-05-13 09:28:35"
"4219","9","20190509030034","Mobile","AAA02","4","60000","9200","50800","2019-05-09 15:00:34"
"4220","91","20190509122949","PC","AAA01","4","40000","8000","32000","2019-05-09 12:29:49"
"4221","85","20190509112018","Shop","AAA05","3","180000","60000","120000","2019-05-09 11:20:18"
"4222","50","20190509085123","PC","AAA05","18","1080000","360000","720000","2019-05-09 08:51:23"
"4223","46","20190509080035","PC","AAA01","13","130000","26000","104000","2019-05-09 08:00:35"
"4224","68","20190509065640","Shop","AAA02","6","90000","13800","76200","2019-05-09 06:56:40"
"4225","68","20190508014247","Shop","AAA02","5","75000","11500","63500","2019-05-08 13:42:47"
"4226","15","20190508120359","Mobile","AAA05","6","360000","120000","240000","2019-05-08 12:03:59"
"4227","42","20190508105258","PC","AAA03","4","68000","12000","56000","2019-05-08 10:52:58"
"4228","57","20190508075509","Shop","AAA02","2","30000","4600","25400","2019-05-08 07:55:09"
"4229","21","20190508031254","PC","AAA03","8","136000","24000","112000","2019-05-08 03:12:54"
"4230","52","20190507112410","PC","AAA02","1","15000","2300","12700","2019-05-07 23:24:10"
"4231","66","20190507092242","Mobile","AAA02","6","90000","13800","76200","2019-05-07 09:22:42"
"4232","8","20190507072706","Shop","AAA03","4","68000","12000","56000","2019-05-07 07:27:06"
"4233","84","20190507125837","Mobile","AAA04","1","8000","400","7600","2019-05-07 00:58:37"
"4234","73","20190506071721","Mobile","AAA04","10","80000","4000","76000","2019-05-06 07:17:21"
"4235","6","20190503024452","Mobile","AAA03","2","34000","6000","28000","2019-05-03 14:44:52"
"4236","93","20190503124919","PC","AAA02","8","120000","18400","101600","2019-05-03 12:49:19"
"4237","83","20190503112259","Shop","AAA05","23","1380000","460000","920000","2019-05-03 11:22:59"
"4238","72","20190503103213","Mobile","AAA01","3","30000","6000","24000","2019-05-03 10:32:13"
"4239","24","20190503091800","Mobile","AAA04","4","32000","1600","30400","2019-05-03 09:18:00"
"4240","43","20190503081728","Mobile","AAA02","23","345000","52900","292100","2019-05-03 08:17:28"
"4241","50","20190503072957","PC","AAA02","8","120000","18400","101600","2019-05-03 07:29:57"
"4242","27","20190503124543","Mobile","AAA01","10","100000","20000","80000","2019-05-03 00:45:43"
"4243","5","20190502011003","Mobile","AAA04","11","88000","4400","83600","2019-05-02 13:10:03"
"4244","38","20190502114030","Shop","AAA02","6","90000","13800","76200","2019-05-02 11:40:30"
"4245","8","20190502102953","Mobile","AAA04","6","48000","2400","45600","2019-05-02 10:29:53"
"4246","25","20190502085737","Mobile","AAA01","13","130000","26000","104000","2019-05-02 08:57:37"
"4247","2","20190502080035","Mobile","AAA05","1","60000","20000","40000","2019-05-02 08:00:35"
"4248","50","20190502070452","Mobile","AAA04","15","120000","6000","114000","2019-05-02 07:04:52"
"4249","54","20190501113859","PC","AAA03","1","17000","3000","14000","2019-05-01 23:38:59"
"4250","24","20190501015309","Mobile","AAA02","9","135000","20700","114300","2019-05-01 13:53:09"
"4251","5","20190501125325","PC","AAA05","1","60000","20000","40000","2019-05-01 12:53:25"
"4252","9","20190501115832","Shop","AAA05","2","120000","40000","80000","2019-05-01 11:58:32"
"4253","29","20190501103949","PC","AAA02","12","180000","27600","152400","2019-05-01 10:39:49"
"4254","19","20190501093054","Mobile","AAA05","3","180000","60000","120000","2019-05-01 09:30:54"
"4255","52","20190501074932","Mobile","AAA03","3","51000","9000","42000","2019-05-01 07:49:32"
"4256","80","20190430095408","Mobile","AAA05","4","240000","80000","160000","2019-04-30 21:54:08"
"4257","73","20190430072722","PC","AAA01","3","30000","6000","24000","2019-04-30 19:27:22"
"4258","46","20190430033719","Mobile","AAA01","2","20000","4000","16000","2019-04-30 15:37:19"
"4259","49","20190430023051","Shop","AAA05","15","900000","300000","600000","2019-04-30 14:30:51"
"4260","11","20190430121939","PC","AAA01","4","40000","8000","32000","2019-04-30 12:19:39"
"4261","56","20190430111041","Shop","AAA01","12","120000","24000","96000","2019-04-30 11:10:41"
"4262","48","20190430102150","Mobile","AAA05","4","240000","80000","160000","2019-04-30 10:21:50"
"4263","68","20190430093339","Mobile","AAA04","6","48000","2400","45600","2019-04-30 09:33:39"
"4264","35","20190430082513","Shop","AAA02","5","75000","11500","63500","2019-04-30 08:25:13"
"4265","19","20190430065215","PC","AAA03","2","34000","6000","28000","2019-04-30 06:52:15"
"4266","75","20190429074034","PC","AAA02","4","60000","9200","50800","2019-04-29 19:40:34"
"4267","84","20190429025946","Shop","AAA02","6","90000","13800","76200","2019-04-29 14:59:46"
"4268","35","20190429012119","Shop","AAA03","2","34000","6000","28000","2019-04-29 13:21:19"
"4269","51","20190429122613","Mobile","AAA04","9","72000","3600","68400","2019-04-29 12:26:13"
"4270","18","20190429112512","Shop","AAA04","6","48000","2400","45600","2019-04-29 11:25:12"
"4271","93","20190429100726","PC","AAA03","6","102000","18000","84000","2019-04-29 10:07:26"
"4272","17","20190429091141","Shop","AAA01","4","40000","8000","32000","2019-04-29 09:11:41"
"4273","49","20190425111028","Shop","AAA05","10","600000","200000","400000","2019-04-25 23:10:28"
"4274","70","20190425085746","PC","AAA05","24","1440000","480000","960000","2019-04-25 08:57:46"
"4275","43","20190425071918","Mobile","AAA02","9","135000","20700","114300","2019-04-25 07:19:18"
"4276","68","20190424072154","PC","AAA05","4","240000","80000","160000","2019-04-24 19:21:54"
"4277","5","20190424040321","PC","AAA04","9","72000","3600","68400","2019-04-24 16:03:21"
"4278","3","20190424013801","Mobile","AAA01","23","230000","46000","184000","2019-04-24 13:38:01"
"4279","61","20190424125825","Mobile","AAA01","3","30000","6000","24000","2019-04-24 12:58:25"
"4280","32","20190424115705","Shop","AAA04","5","40000","2000","38000","2019-04-24 11:57:05"
"4281","27","20190424103711","Mobile","AAA05","9","540000","180000","360000","2019-04-24 10:37:11"
"4282","37","20190424092655","PC","AAA05","5","300000","100000","200000","2019-04-24 09:26:55"
"4283","40","20190424085103","PC","AAA01","9","90000","18000","72000","2019-04-24 08:51:03"
"4284","25","20190424072852","Mobile","AAA03","7","119000","21000","98000","2019-04-24 07:28:52"
"4285","80","20190423112811","Shop","AAA03","6","102000","18000","84000","2019-04-23 23:28:11"
"4286","89","20190423105132","Shop","AAA01","5","50000","10000","40000","2019-04-23 10:51:32"
"4287","85","20190423090501","Shop","AAA04","2","16000","800","15200","2019-04-23 09:05:01"
"4288","19","20190423072313","Shop","AAA03","4","68000","12000","56000","2019-04-23 07:23:13"
"4289","13","20190422111327","Shop","AAA01","1","10000","2000","8000","2019-04-22 23:13:27"
"4290","70","20190422092626","Mobile","AAA03","10","170000","30000","140000","2019-04-22 09:26:26"
"4291","30","20190419011929","Shop","AAA02","5","75000","11500","63500","2019-04-19 13:19:29"
"4292","30","20190419120554","Shop","AAA01","20","200000","40000","160000","2019-04-19 12:05:54"
"4293","80","20190419105211","PC","AAA04","1","8000","400","7600","2019-04-19 10:52:11"
"4294","10","20190419095736","PC","AAA05","5","300000","100000","200000","2019-04-19 09:57:36"
"4295","49","20190419081423","Shop","AAA05","7","420000","140000","280000","2019-04-19 08:14:23"
"4296","6","20190419071219","Shop","AAA03","6","102000","18000","84000","2019-04-19 07:12:19"
"4297","33","20190418070305","Mobile","AAA01","2","20000","4000","16000","2019-04-18 19:03:05"
"4298","98","20190418031436","Mobile","AAA03","2","34000","6000","28000","2019-04-18 15:14:36"
"4299","48","20190418013849","Mobile","AAA01","16","160000","32000","128000","2019-04-18 13:38:49"
"4300","21","20190418104802","Mobile","AAA04","3","24000","1200","22800","2019-04-18 10:48:02"
"4301","16","20190418090043","Shop","AAA01","7","70000","14000","56000","2019-04-18 09:00:43"
"4302","74","20190418082834","Shop","AAA02","3","45000","6900","38100","2019-04-18 08:28:34"
"4303","63","20190417103110","Mobile","AAA01","1","10000","2000","8000","2019-04-17 22:31:10"
"4304","5","20190417070324","Shop","AAA01","12","120000","24000","96000","2019-04-17 19:03:24"
"4305","90","20190417024016","PC","AAA01","7","70000","14000","56000","2019-04-17 14:40:16"
"4306","11","20190417014519","PC","AAA05","13","780000","260000","520000","2019-04-17 13:45:19"
"4307","51","20190417122110","Shop","AAA03","8","136000","24000","112000","2019-04-17 12:21:10"
"4308","74","20190417110210","Mobile","AAA04","4","32000","1600","30400","2019-04-17 11:02:10"
"4309","30","20190417085900","Mobile","AAA02","5","75000","11500","63500","2019-04-17 08:59:00"
"4310","20","20190417072934","Shop","AAA03","4","68000","12000","56000","2019-04-17 07:29:34"
"4311","66","20190416112649","Shop","AAA01","8","80000","16000","64000","2019-04-16 23:26:49"
"4312","75","20190416071544","Shop","AAA05","1","60000","20000","40000","2019-04-16 07:15:44"
"4313","87","20190415032753","Shop","AAA03","3","51000","9000","42000","2019-04-15 15:27:53"
"4314","39","20190415030427","PC","AAA05","13","780000","260000","520000","2019-04-15 15:04:27"
"4315","54","20190415020344","Shop","AAA01","1","10000","2000","8000","2019-04-15 14:03:44"
"4316","56","20190415122542","Shop","AAA02","15","225000","34500","190500","2019-04-15 12:25:42"
"4317","26","20190415110616","Shop","AAA02","6","90000","13800","76200","2019-04-15 11:06:16"
"4318","5","20190415093730","PC","AAA01","5","50000","10000","40000","2019-04-15 09:37:30"
"4319","90","20190411085733","Shop","AAA04","3","24000","1200","22800","2019-04-11 08:57:33"
"4320","16","20190411065048","PC","AAA02","12","180000","27600","152400","2019-04-11 06:50:48"
"4321","73","20190410110403","PC","AAA05","10","600000","200000","400000","2019-04-10 23:04:03"
"4322","26","20190410022231","Mobile","AAA02","4","60000","9200","50800","2019-04-10 14:22:31"
"4323","2","20190410013053","PC","AAA04","7","56000","2800","53200","2019-04-10 13:30:53"
"4324","5","20190410120458","Shop","AAA05","10","600000","200000","400000","2019-04-10 12:04:58"
"4325","72","20190410102814","PC","AAA01","12","120000","24000","96000","2019-04-10 10:28:14"
"4326","85","20190410091503","PC","AAA02","8","120000","18400","101600","2019-04-10 09:15:03"
"4327","46","20190410081318","PC","AAA02","9","135000","20700","114300","2019-04-10 08:13:18"
"4328","7","20190410064859","Shop","AAA01","7","70000","14000","56000","2019-04-10 06:48:59"
"4329","9","20190409065250","PC","AAA02","6","90000","13800","76200","2019-04-09 18:52:50"
"4330","20","20190409033700","Shop","AAA05","3","180000","60000","120000","2019-04-09 15:37:00"
"4331","73","20190409013248","Shop","AAA03","7","119000","21000","98000","2019-04-09 13:32:48"
"4332","58","20190409125040","Shop","AAA02","10","150000","23000","127000","2019-04-09 12:50:40"
"4333","71","20190409111236","PC","AAA03","13","221000","39000","182000","2019-04-09 11:12:36"
"4334","100","20190409095930","Mobile","AAA05","2","120000","40000","80000","2019-04-09 09:59:30"
"4335","10","20190409083308","PC","AAA03","19","323000","57000","266000","2019-04-09 08:33:08"
"4336","49","20190409064749","PC","AAA04","5","40000","2000","38000","2019-04-09 06:47:49"
"4337","46","20190408085003","Shop","AAA03","15","255000","45000","210000","2019-04-08 20:50:03"
"4338","40","20190408043841","Shop","AAA01","6","60000","12000","48000","2019-04-08 16:38:41"
"4339","34","20190408024854","Mobile","AAA02","12","180000","27600","152400","2019-04-08 14:48:54"
"4340","49","20190408011312","Shop","AAA04","1","8000","400","7600","2019-04-08 13:13:12"
"4341","11","20190408114628","PC","AAA03","6","102000","18000","84000","2019-04-08 11:46:28"
"4342","64","20190408084301","PC","AAA02","13","195000","29900","165100","2019-04-08 08:43:01"
"4343","32","20190404021416","PC","AAA03","10","170000","30000","140000","2019-04-04 14:14:16"
"4344","40","20190404123828","PC","AAA03","1","17000","3000","14000","2019-04-04 12:38:28"
"4345","64","20190404110146","Mobile","AAA02","9","135000","20700","114300","2019-04-04 11:01:46"
"4346","86","20190404102237","Mobile","AAA02","3","45000","6900","38100","2019-04-04 10:22:37"
"4347","43","20190404092645","Mobile","AAA05","6","360000","120000","240000","2019-04-04 09:26:45"
"4348","22","20190404075554","Mobile","AAA02","9","135000","20700","114300","2019-04-04 07:55:54"
"4349","86","20190403103734","Shop","AAA01","1","10000","2000","8000","2019-04-03 22:37:34"
"4350","53","20190403045710","Shop","AAA02","3","45000","6900","38100","2019-04-03 16:57:10"
"4351","86","20190403035730","PC","AAA04","1","8000","400","7600","2019-04-03 15:57:30"
"4352","78","20190403012116","PC","AAA04","8","64000","3200","60800","2019-04-03 13:21:16"
"4353","48","20190403123249","PC","AAA03","6","102000","18000","84000","2019-04-03 12:32:49"
"4354","19","20190403115325","Shop","AAA01","1","10000","2000","8000","2019-04-03 11:53:25"
"4355","65","20190403110352","PC","AAA03","6","102000","18000","84000","2019-04-03 11:03:52"
"4356","43","20190403094430","Mobile","AAA04","11","88000","4400","83600","2019-04-03 09:44:30"
"4357","88","20190403083152","Mobile","AAA01","1","10000","2000","8000","2019-04-03 08:31:52"
"4358","29","20190402073531","PC","AAA05","2","120000","40000","80000","2019-04-02 19:35:31"
"4359","78","20190402015301","Shop","AAA04","6","48000","2400","45600","2019-04-02 13:53:01"
"4360","37","20190402125203","Shop","AAA02","7","105000","16100","88900","2019-04-02 12:52:03"
"4361","85","20190402112253","PC","AAA02","6","90000","13800","76200","2019-04-02 11:22:53"
"4362","58","20190402101248","Shop","AAA02","1","15000","2300","12700","2019-04-02 10:12:48"
"4363","4","20190402093837","Shop","AAA03","5","85000","15000","70000","2019-04-02 09:38:37"
"4364","82","20190402082545","PC","AAA01","1","10000","2000","8000","2019-04-02 08:25:45"
"4365","85","20190402073952","Mobile","AAA02","13","195000","29900","165100","2019-04-02 07:39:52"
"4366","68","20190401100805","Mobile","AAA02","4","60000","9200","50800","2019-04-01 22:08:05"
"4367","49","20190401062603","Shop","AAA05","2","120000","40000","80000","2019-04-01 18:26:03"
"4368","5","20190401053721","Mobile","AAA05","5","300000","100000","200000","2019-04-01 17:37:21"
"4369","97","20190401041930","Shop","AAA05","10","600000","200000","400000","2019-04-01 16:19:30"
"4370","82","20190401033946","Shop","AAA01","15","150000","30000","120000","2019-04-01 15:39:46"
"4371","39","20190401012504","Mobile","AAA05","3","180000","60000","120000","2019-04-01 13:25:04"
"4372","47","20190401114321","PC","AAA05","13","780000","260000","520000","2019-04-01 11:43:21"
"4373","62","20190401103949","PC","AAA01","8","80000","16000","64000","2019-04-01 10:39:49"
"4374","33","20190401094503","Shop","AAA05","4","240000","80000","160000","2019-04-01 09:45:03"
"4375","93","20190329120032","Shop","AAA03","4","68000","12000","56000","2019-03-29 00:00:32"
"4376","21","20190328081321","Mobile","AAA03","16","272000","48000","224000","2019-03-28 20:13:21"
"4377","40","20190328024746","PC","AAA03","9","153000","27000","126000","2019-03-28 14:47:46"
"4378","19","20190328010704","PC","AAA04","2","16000","800","15200","2019-03-28 13:07:04"
"4379","88","20190328120046","PC","AAA04","5","40000","2000","38000","2019-03-28 12:00:46"
"4380","27","20190328104610","Shop","AAA03","19","323000","57000","266000","2019-03-28 10:46:10"
"4381","68","20190328090143","Mobile","AAA03","6","102000","18000","84000","2019-03-28 09:01:43"
"4382","73","20190328072145","Mobile","AAA03","10","170000","30000","140000","2019-03-28 07:21:45"
"4383","62","20190328011654","PC","AAA04","1","8000","400","7600","2019-03-28 01:16:54"
"4384","84","20190327113735","PC","AAA02","1","15000","2300","12700","2019-03-27 11:37:35"
"4385","84","20190327112037","Shop","AAA03","1","17000","3000","14000","2019-03-27 11:20:37"
"4386","50","20190327100106","Mobile","AAA02","2","30000","4600","25400","2019-03-27 10:01:06"
"4387","61","20190327085219","Mobile","AAA01","2","20000","4000","16000","2019-03-27 08:52:19"
"4388","28","20190327072348","Shop","AAA01","12","120000","24000","96000","2019-03-27 07:23:48"
"4389","100","20190326094248","PC","AAA03","4","68000","12000","56000","2019-03-26 21:42:48"
"4390","7","20190326051157","PC","AAA04","3","24000","1200","22800","2019-03-26 17:11:57"
"4391","87","20190326031936","Mobile","AAA02","7","105000","16100","88900","2019-03-26 15:19:36"
"4392","92","20190326014817","Mobile","AAA02","13","195000","29900","165100","2019-03-26 13:48:17"
"4393","42","20190326121235","Shop","AAA01","10","100000","20000","80000","2019-03-26 12:12:35"
"4394","97","20190326110800","Shop","AAA03","4","68000","12000","56000","2019-03-26 11:08:00"
"4395","48","20190326100817","Mobile","AAA02","8","120000","18400","101600","2019-03-26 10:08:17"
"4396","55","20190326095956","Shop","AAA03","6","102000","18000","84000","2019-03-26 09:59:56"
"4397","48","20190326083335","Mobile","AAA03","6","102000","18000","84000","2019-03-26 08:33:35"
"4398","92","20190326072651","Shop","AAA02","15","225000","34500","190500","2019-03-26 07:26:51"
"4399","67","20190325100830","Shop","AAA03","2","34000","6000","28000","2019-03-25 22:08:30"
"4400","83","20190325060652","PC","AAA04","19","152000","7600","144400","2019-03-25 18:06:52"
"4401","52","20190325011302","Mobile","AAA05","5","300000","100000","200000","2019-03-25 13:13:02"
"4402","64","20190325124734","PC","AAA03","5","85000","15000","70000","2019-03-25 12:47:34"
"4403","75","20190325110544","PC","AAA04","1","8000","400","7600","2019-03-25 11:05:44"
"4404","93","20190325101149","Shop","AAA04","3","24000","1200","22800","2019-03-25 10:11:49"
"4405","24","20190325091632","Mobile","AAA03","11","187000","33000","154000","2019-03-25 09:16:32"
"4406","80","20190323121304","Shop","AAA05","8","480000","160000","320000","2019-03-23 00:13:04"
"4407","100","20190322120740","Shop","AAA04","6","48000","2400","45600","2019-03-22 00:07:40"
"4408","14","20190321015330","PC","AAA01","4","40000","8000","32000","2019-03-21 13:53:30"
"4409","85","20190321120804","PC","AAA04","6","48000","2400","45600","2019-03-21 12:08:04"
"4410","76","20190321105627","PC","AAA05","7","420000","140000","280000","2019-03-21 10:56:27"
"4411","43","20190321085337","PC","AAA04","11","88000","4400","83600","2019-03-21 08:53:37"
"4412","36","20190321080810","Shop","AAA04","6","48000","2400","45600","2019-03-21 08:08:10"
"4413","74","20190321063750","Mobile","AAA04","1","8000","400","7600","2019-03-21 06:37:50"
"4414","20","20190320115945","Shop","AAA02","5","75000","11500","63500","2019-03-20 11:59:45"
"4415","27","20190320104007","Shop","AAA05","5","300000","100000","200000","2019-03-20 10:40:07"
"4416","77","20190320093157","Shop","AAA04","3","24000","1200","22800","2019-03-20 09:31:57"
"4417","67","20190320081033","Mobile","AAA02","7","105000","16100","88900","2019-03-20 08:10:33"
"4418","66","20190320072506","Shop","AAA04","3","24000","1200","22800","2019-03-20 07:25:06"
"4419","88","20190319100819","PC","AAA05","2","120000","40000","80000","2019-03-19 22:08:19"
"4420","54","20190319065714","Shop","AAA01","4","40000","8000","32000","2019-03-19 18:57:14"
"4421","42","20190319022109","Mobile","AAA03","8","136000","24000","112000","2019-03-19 14:21:09"
"4422","72","20190319011103","PC","AAA02","6","90000","13800","76200","2019-03-19 13:11:03"
"4423","97","20190319120516","Shop","AAA05","8","480000","160000","320000","2019-03-19 12:05:16"
"4424","9","20190319111012","Shop","AAA03","3","51000","9000","42000","2019-03-19 11:10:12"
"4425","6","20190319094414","Shop","AAA05","4","240000","80000","160000","2019-03-19 09:44:14"
"4426","56","20190319084917","PC","AAA03","12","204000","36000","168000","2019-03-19 08:49:17"
"4427","93","20190318015634","Shop","AAA04","4","32000","1600","30400","2019-03-18 13:56:34"
"4428","41","20190318123914","Mobile","AAA05","6","360000","120000","240000","2019-03-18 12:39:14"
"4429","98","20190318112013","Mobile","AAA03","7","119000","21000","98000","2019-03-18 11:20:13"
"4430","22","20190318102605","Shop","AAA04","2","16000","800","15200","2019-03-18 10:26:05"
"4431","98","20190318093858","PC","AAA01","5","50000","10000","40000","2019-03-18 09:38:58"
"4432","71","20190315081451","Shop","AAA05","5","300000","100000","200000","2019-03-15 20:14:51"
"4433","80","20190315020106","PC","AAA01","8","80000","16000","64000","2019-03-15 14:01:06"
"4434","55","20190315011535","Mobile","AAA04","9","72000","3600","68400","2019-03-15 13:15:35"
"4435","65","20190315114044","Shop","AAA01","1","10000","2000","8000","2019-03-15 11:40:44"
"4436","94","20190315093136","Mobile","AAA02","18","270000","41400","228600","2019-03-15 09:31:36"
"4437","85","20190315064406","Mobile","AAA04","10","80000","4000","76000","2019-03-15 06:44:06"
"4438","67","20190314041421","Mobile","AAA03","9","153000","27000","126000","2019-03-14 16:14:21"
"4439","81","20190314024701","Mobile","AAA04","3","24000","1200","22800","2019-03-14 14:47:01"
"4440","38","20190314013154","Shop","AAA02","10","150000","23000","127000","2019-03-14 13:31:54"
"4441","71","20190314124946","Shop","AAA04","15","120000","6000","114000","2019-03-14 12:49:46"
"4442","76","20190314120553","Shop","AAA05","2","120000","40000","80000","2019-03-14 12:05:53"
"4443","13","20190314104048","Mobile","AAA04","7","56000","2800","53200","2019-03-14 10:40:48"
"4444","7","20190314093424","Shop","AAA01","3","30000","6000","24000","2019-03-14 09:34:24"
"4445","87","20190314080353","Shop","AAA01","8","80000","16000","64000","2019-03-14 08:03:53"
"4446","55","20190314072926","Shop","AAA04","5","40000","2000","38000","2019-03-14 07:29:26"
"4447","62","20190313103139","PC","AAA03","7","119000","21000","98000","2019-03-13 22:31:39"
"4448","52","20190313092345","Mobile","AAA04","9","72000","3600","68400","2019-03-13 21:23:45"
"4449","44","20190313070247","PC","AAA04","1","8000","400","7600","2019-03-13 19:02:47"
"4450","10","20190313021520","PC","AAA03","5","85000","15000","70000","2019-03-13 14:15:20"
"4451","88","20190313121927","Mobile","AAA04","10","80000","4000","76000","2019-03-13 12:19:27"
"4452","58","20190313103229","PC","AAA05","1","60000","20000","40000","2019-03-13 10:32:29"
"4453","73","20190313071031","PC","AAA02","4","60000","9200","50800","2019-03-13 07:10:31"
"4454","79","20190312124139","Mobile","AAA01","6","60000","12000","48000","2019-03-12 12:41:39"
"4455","96","20190312111947","PC","AAA02","6","90000","13800","76200","2019-03-12 11:19:47"
"4456","13","20190312104758","Shop","AAA03","2","34000","6000","28000","2019-03-12 10:47:58"
"4457","96","20190312091923","Mobile","AAA03","2","34000","6000","28000","2019-03-12 09:19:23"
"4458","6","20190312083602","PC","AAA02","1","15000","2300","12700","2019-03-12 08:36:02"
"4459","48","20190312062225","PC","AAA04","5","40000","2000","38000","2019-03-12 06:22:25"
"4460","11","20190312122346","Shop","AAA02","11","165000","25300","139700","2019-03-12 00:23:46"
"4461","61","20190311123522","Mobile","AAA01","1","10000","2000","8000","2019-03-11 12:35:22"
"4462","42","20190311120701","Shop","AAA02","7","105000","16100","88900","2019-03-11 12:07:01"
"4463","24","20190311103340","Shop","AAA01","8","80000","16000","64000","2019-03-11 10:33:40"
"4464","75","20190311090308","Mobile","AAA02","2","30000","4600","25400","2019-03-11 09:03:08"
"4465","20","20190309091054","Shop","AAA04","10","80000","4000","76000","2019-03-09 09:10:54"
"4466","79","20190309041903","Mobile","AAA01","2","20000","4000","16000","2019-03-09 04:19:03"
"4467","28","20190308064152","PC","AAA02","3","45000","6900","38100","2019-03-08 18:41:52"
"4468","60","20190308040555","Mobile","AAA04","6","48000","2400","45600","2019-03-08 16:05:55"
"4469","3","20190308030542","Mobile","AAA01","8","80000","16000","64000","2019-03-08 15:05:42"
"4470","19","20190308021857","Shop","AAA04","4","32000","1600","30400","2019-03-08 14:18:57"
"4471","95","20190308123105","PC","AAA02","4","60000","9200","50800","2019-03-08 12:31:05"
"4472","76","20190308112813","Mobile","AAA05","4","240000","80000","160000","2019-03-08 11:28:13"
"4473","55","20190308101957","Shop","AAA04","4","32000","1600","30400","2019-03-08 10:19:57"
"4474","2","20190308084330","PC","AAA04","4","32000","1600","30400","2019-03-08 08:43:30"
"4475","57","20190308070711","Mobile","AAA04","5","40000","2000","38000","2019-03-08 07:07:11"
"4476","19","20190308011058","Shop","AAA02","5","75000","11500","63500","2019-03-08 01:10:58"
"4477","66","20190307124452","PC","AAA02","5","75000","11500","63500","2019-03-07 12:44:52"
"4478","79","20190307103448","PC","AAA04","5","40000","2000","38000","2019-03-07 10:34:48"
"4479","93","20190307092728","Shop","AAA05","4","240000","80000","160000","2019-03-07 09:27:28"
"4480","10","20190307072228","Shop","AAA01","9","90000","18000","72000","2019-03-07 07:22:28"
"4481","39","20190306035104","Shop","AAA04","1","8000","400","7600","2019-03-06 15:51:04"
"4482","36","20190306024111","Mobile","AAA05","17","1020000","340000","680000","2019-03-06 14:41:11"
"4483","23","20190306124801","Mobile","AAA02","15","225000","34500","190500","2019-03-06 12:48:01"
"4484","13","20190306114446","Shop","AAA04","4","32000","1600","30400","2019-03-06 11:44:46"
"4485","30","20190306082623","Mobile","AAA04","5","40000","2000","38000","2019-03-06 08:26:23"
"4486","3","20190306072518","Mobile","AAA05","5","300000","100000","200000","2019-03-06 07:25:18"
"4487","57","20190305105019","Shop","AAA05","8","480000","160000","320000","2019-03-05 22:50:19"
"4488","35","20190305091826","PC","AAA04","4","32000","1600","30400","2019-03-05 21:18:26"
"4489","8","20190305052446","Mobile","AAA01","5","50000","10000","40000","2019-03-05 17:24:46"
"4490","72","20190305041252","PC","AAA02","8","120000","18400","101600","2019-03-05 16:12:52"
"4491","72","20190305030403","PC","AAA04","13","104000","5200","98800","2019-03-05 15:04:03"
"4492","5","20190305010920","Shop","AAA04","9","72000","3600","68400","2019-03-05 13:09:20"
"4493","77","20190305121446","Mobile","AAA01","2","20000","4000","16000","2019-03-05 12:14:46"
"4494","59","20190305111918","PC","AAA04","13","104000","5200","98800","2019-03-05 11:19:18"
"4495","90","20190305103428","Shop","AAA04","1","8000","400","7600","2019-03-05 10:34:28"
"4496","79","20190305091203","Mobile","AAA04","11","88000","4400","83600","2019-03-05 09:12:03"
"4497","76","20190305072251","PC","AAA05","10","600000","200000","400000","2019-03-05 07:22:51"
"4498","84","20190304025012","Mobile","AAA02","1","15000","2300","12700","2019-03-04 14:50:12"
"4499","36","20190304012116","Shop","AAA04","10","80000","4000","76000","2019-03-04 13:21:16"
"4500","82","20190304121145","PC","AAA03","6","102000","18000","84000","2019-03-04 12:11:45"
"4501","10","20190304103757","PC","AAA05","11","660000","220000","440000","2019-03-04 10:37:57"
"4502","86","20190304085940","Shop","AAA03","2","34000","6000","28000","2019-03-04 08:59:40"
"4503","42","20190301015032","Mobile","AAA03","19","323000","57000","266000","2019-03-01 13:50:32"
"4504","93","20190301120815","Mobile","AAA04","2","16000","800","15200","2019-03-01 12:08:15"
"4505","30","20190301105332","PC","AAA02","11","165000","25300","139700","2019-03-01 10:53:32"
"4506","36","20190301102205","Shop","AAA02","28","420000","64400","355600","2019-03-01 10:22:05"
"4507","51","20190301021541","PC","AAA04","10","80000","4000","76000","2019-03-01 02:15:41"
"4508","20","20190228042327","Shop","AAA04","1","8000","400","7600","2019-02-28 16:23:27"
"4509","16","20190228032032","Mobile","AAA02","4","60000","9200","50800","2019-02-28 15:20:32"
"4510","60","20190228024106","PC","AAA04","5","40000","2000","38000","2019-02-28 14:41:06"
"4511","94","20190228012100","PC","AAA01","9","90000","18000","72000","2019-02-28 13:21:00"
"4512","87","20190228115755","Shop","AAA05","3","180000","60000","120000","2019-02-28 11:57:55"
"4513","50","20190228101801","PC","AAA04","4","32000","1600","30400","2019-02-28 10:18:01"
"4514","89","20190227025002","Shop","AAA03","15","255000","45000","210000","2019-02-27 14:50:02"
"4515","60","20190227020812","Mobile","AAA01","3","30000","6000","24000","2019-02-27 14:08:12"
"4516","35","20190227012317","Mobile","AAA03","4","68000","12000","56000","2019-02-27 13:23:17"
"4517","59","20190227120029","PC","AAA05","1","60000","20000","40000","2019-02-27 12:00:29"
"4518","44","20190227111830","PC","AAA05","2","120000","40000","80000","2019-02-27 11:18:30"
"4519","76","20190227103639","Shop","AAA03","6","102000","18000","84000","2019-02-27 10:36:39"
"4520","80","20190227090933","Shop","AAA03","9","153000","27000","126000","2019-02-27 09:09:33"
"4521","57","20190227080649","Mobile","AAA02","6","90000","13800","76200","2019-02-27 08:06:49"
"4522","15","20190227065939","Mobile","AAA05","15","900000","300000","600000","2019-02-27 06:59:39"
"4523","4","20190226071102","Shop","AAA01","1","10000","2000","8000","2019-02-26 19:11:02"
"4524","90","20190226043253","Shop","AAA02","1","15000","2300","12700","2019-02-26 16:32:53"
"4525","83","20190226033644","Shop","AAA03","15","255000","45000","210000","2019-02-26 15:36:44"
"4526","23","20190226024633","Mobile","AAA01","1","10000","2000","8000","2019-02-26 14:46:33"
"4527","1","20190226012732","PC","AAA03","3","51000","9000","42000","2019-02-26 13:27:32"
"4528","5","20190226110256","Mobile","AAA05","17","1020000","340000","680000","2019-02-26 11:02:56"
"4529","49","20190226102056","PC","AAA04","5","40000","2000","38000","2019-02-26 10:20:56"
"4530","43","20190226080649","Shop","AAA05","6","360000","120000","240000","2019-02-26 08:06:49"
"4531","49","20190226064407","PC","AAA02","16","240000","36800","203200","2019-02-26 06:44:07"
"4532","28","20190225095520","Mobile","AAA01","7","70000","14000","56000","2019-02-25 21:55:20"
"4533","43","20190225055105","Mobile","AAA01","19","190000","38000","152000","2019-02-25 17:51:05"
"4534","69","20190225045758","PC","AAA01","7","70000","14000","56000","2019-02-25 16:57:58"
"4535","84","20190225010824","PC","AAA03","1","17000","3000","14000","2019-02-25 13:08:24"
"4536","57","20190225115340","Mobile","AAA01","8","80000","16000","64000","2019-02-25 11:53:40"
"4537","64","20190225100822","Mobile","AAA03","14","238000","42000","196000","2019-02-25 10:08:22"
"4538","92","20190225090209","Shop","AAA03","13","221000","39000","182000","2019-02-25 09:02:09"
"4539","16","20190224120447","PC","AAA04","10","80000","4000","76000","2019-02-24 00:04:47"
"4540","28","20190222122406","PC","AAA03","3","51000","9000","42000","2019-02-22 12:24:06"
"4541","60","20190222111312","PC","AAA04","4","32000","1600","30400","2019-02-22 11:13:12"
"4542","31","20190222100205","Mobile","AAA05","2","120000","40000","80000","2019-02-22 10:02:05"
"4543","32","20190222090800","PC","AAA05","2","120000","40000","80000","2019-02-22 09:08:00"
"4544","73","20190222075850","Mobile","AAA02","11","165000","25300","139700","2019-02-22 07:58:50"
"4545","90","20190221011601","PC","AAA02","10","150000","23000","127000","2019-02-21 13:16:01"
"4546","20","20190221112243","PC","AAA05","5","300000","100000","200000","2019-02-21 11:22:43"
"4547","39","20190220025750","Mobile","AAA02","16","240000","36800","203200","2019-02-20 14:57:50"
"4548","52","20190220022250","Mobile","AAA01","7","70000","14000","56000","2019-02-20 14:22:50"
"4549","12","20190220013223","PC","AAA01","3","30000","6000","24000","2019-02-20 13:32:23"
"4550","3","20190220123403","Mobile","AAA02","1","15000","2300","12700","2019-02-20 12:34:03"
"4551","94","20190220113755","Shop","AAA02","15","225000","34500","190500","2019-02-20 11:37:55"
"4552","65","20190220110133","Shop","AAA02","10","150000","23000","127000","2019-02-20 11:01:33"
"4553","90","20190220100808","Shop","AAA03","12","204000","36000","168000","2019-02-20 10:08:08"
"4554","29","20190220093837","Shop","AAA04","7","56000","2800","53200","2019-02-20 09:38:37"
"4555","80","20190220064648","Mobile","AAA02","4","60000","9200","50800","2019-02-20 06:46:48"
"4556","49","20190219032915","Shop","AAA05","5","300000","100000","200000","2019-02-19 15:29:15"
"4557","57","20190219010826","Mobile","AAA03","10","170000","30000","140000","2019-02-19 13:08:26"
"4558","47","20190219115312","PC","AAA04","1","8000","400","7600","2019-02-19 11:53:12"
"4559","72","20190219064507","PC","AAA01","7","70000","14000","56000","2019-02-19 06:45:07"
"4560","4","20190218063445","PC","AAA05","1","60000","20000","40000","2019-02-18 18:34:45"
"4561","54","20190218050722","Shop","AAA05","11","660000","220000","440000","2019-02-18 17:07:22"
"4562","22","20190218042704","Mobile","AAA04","2","16000","800","15200","2019-02-18 16:27:04"
"4563","3","20190218031458","Shop","AAA01","7","70000","14000","56000","2019-02-18 15:14:58"
"4564","64","20190218023854","PC","AAA02","8","120000","18400","101600","2019-02-18 14:38:54"
"4565","30","20190218120342","Shop","AAA05","9","540000","180000","360000","2019-02-18 12:03:42"
"4566","12","20190218102547","PC","AAA01","6","60000","12000","48000","2019-02-18 10:25:47"
"4567","87","20190218091750","Shop","AAA05","5","300000","100000","200000","2019-02-18 09:17:50"
"4568","73","20190215085011","Shop","AAA01","7","70000","14000","56000","2019-02-15 20:50:11"
"4569","7","20190215032514","PC","AAA05","9","540000","180000","360000","2019-02-15 15:25:14"
"4570","61","20190215121838","PC","AAA01","2","20000","4000","16000","2019-02-15 12:18:38"
"4571","67","20190215111253","Shop","AAA04","14","112000","5600","106400","2019-02-15 11:12:53"
"4572","91","20190215085743","PC","AAA05","2","120000","40000","80000","2019-02-15 08:57:43"
"4573","80","20190215071819","Mobile","AAA04","7","56000","2800","53200","2019-02-15 07:18:19"
"4574","33","20190214053921","Shop","AAA01","7","70000","14000","56000","2019-02-14 17:39:21"
"4575","39","20190214052520","Shop","AAA05","6","360000","120000","240000","2019-02-14 17:25:20"
"4576","87","20190214052008","Mobile","AAA05","1","60000","20000","40000","2019-02-14 17:20:08"
"4577","44","20190214044800","Shop","AAA03","3","51000","9000","42000","2019-02-14 16:48:00"
"4578","74","20190214034524","Mobile","AAA02","1","15000","2300","12700","2019-02-14 15:45:24"
"4579","2","20190214022324","Mobile","AAA04","8","64000","3200","60800","2019-02-14 14:23:24"
"4580","75","20190214011018","Mobile","AAA05","2","120000","40000","80000","2019-02-14 13:10:18"
"4581","42","20190214115832","Mobile","AAA05","6","360000","120000","240000","2019-02-14 11:58:32"
"4582","50","20190214102213","PC","AAA02","5","75000","11500","63500","2019-02-14 10:22:13"
"4583","24","20190214094204","Mobile","AAA03","6","102000","18000","84000","2019-02-14 09:42:04"
"4584","16","20190214083229","Shop","AAA01","4","40000","8000","32000","2019-02-14 08:32:29"
"4585","32","20190214071958","PC","AAA04","10","80000","4000","76000","2019-02-14 07:19:58"
"4586","32","20190213094017","Mobile","AAA05","7","420000","140000","280000","2019-02-13 21:40:17"
"4587","76","20190213062624","PC","AAA04","1","8000","400","7600","2019-02-13 18:26:24"
"4588","92","20190213035622","PC","AAA03","15","255000","45000","210000","2019-02-13 15:56:22"
"4589","65","20190213023640","Mobile","AAA04","8","64000","3200","60800","2019-02-13 14:36:40"
"4590","60","20190213121840","PC","AAA05","11","660000","220000","440000","2019-02-13 12:18:40"
"4591","11","20190213105511","Mobile","AAA02","8","120000","18400","101600","2019-02-13 10:55:11"
"4592","31","20190213093048","Mobile","AAA03","4","68000","12000","56000","2019-02-13 09:30:48"
"4593","21","20190213082711","Shop","AAA05","9","540000","180000","360000","2019-02-13 08:27:11"
"4594","16","20190213064942","Mobile","AAA01","8","80000","16000","64000","2019-02-13 06:49:42"
"4595","59","20190212095031","Mobile","AAA04","1","8000","400","7600","2019-02-12 21:50:31"
"4596","96","20190212070200","Mobile","AAA01","15","150000","30000","120000","2019-02-12 19:02:00"
"4597","96","20190212040116","Mobile","AAA02","6","90000","13800","76200","2019-02-12 16:01:16"
"4598","8","20190212032901","PC","AAA03","10","170000","30000","140000","2019-02-12 15:29:01"
"4599","73","20190212025336","Shop","AAA01","5","50000","10000","40000","2019-02-12 14:53:36"
"4600","34","20190212015206","Mobile","AAA02","15","225000","34500","190500","2019-02-12 13:52:06"
"4601","42","20190212114339","Mobile","AAA02","2","30000","4600","25400","2019-02-12 11:43:39"
"4602","34","20190212105621","PC","AAA04","7","56000","2800","53200","2019-02-12 10:56:21"
"4603","46","20190212094922","Mobile","AAA03","6","102000","18000","84000","2019-02-12 09:49:22"
"4604","99","20190212085323","PC","AAA05","4","240000","80000","160000","2019-02-12 08:53:23"
"4605","89","20190212071938","Mobile","AAA02","1","15000","2300","12700","2019-02-12 07:19:38"
"4606","21","20190211032725","PC","AAA02","13","195000","29900","165100","2019-02-11 15:27:25"
"4607","82","20190211023952","Mobile","AAA03","6","102000","18000","84000","2019-02-11 14:39:52"
"4608","12","20190211015004","PC","AAA03","2","34000","6000","28000","2019-02-11 13:50:04"
"4609","28","20190211012232","PC","AAA01","13","130000","26000","104000","2019-02-11 13:22:32"
"4610","25","20190211123246","Shop","AAA02","7","105000","16100","88900","2019-02-11 12:32:46"
"4611","71","20190211111536","PC","AAA04","2","16000","800","15200","2019-02-11 11:15:36"
"4612","54","20190208042725","PC","AAA03","3","51000","9000","42000","2019-02-08 04:27:25"
"4613","54","20190207073126","Shop","AAA04","1","8000","400","7600","2019-02-07 19:31:26"
"4614","27","20190207034729","Shop","AAA05","1","60000","20000","40000","2019-02-07 15:47:29"
"4615","31","20190207015450","Shop","AAA02","2","30000","4600","25400","2019-02-07 13:54:50"
"4616","69","20190207122420","Shop","AAA05","1","60000","20000","40000","2019-02-07 12:24:20"
"4617","35","20190207113103","Mobile","AAA02","4","60000","9200","50800","2019-02-07 11:31:03"
"4618","43","20190207105626","PC","AAA04","19","152000","7600","144400","2019-02-07 10:56:26"
"4619","18","20190207094959","PC","AAA02","4","60000","9200","50800","2019-02-07 09:49:59"
"4620","77","20190207090758","Shop","AAA04","9","72000","3600","68400","2019-02-07 09:07:58"
"4621","7","20190207072636","PC","AAA03","15","255000","45000","210000","2019-02-07 07:26:36"
"4622","30","20190206083734","Mobile","AAA04","5","40000","2000","38000","2019-02-06 20:37:34"
"4623","72","20190206053050","Shop","AAA04","1","8000","400","7600","2019-02-06 17:30:50"
"4624","37","20190206020906","Shop","AAA02","10","150000","23000","127000","2019-02-06 14:09:06"
"4625","100","20190206124936","PC","AAA02","6","90000","13800","76200","2019-02-06 12:49:36"
"4626","85","20190206115016","Mobile","AAA05","10","600000","200000","400000","2019-02-06 11:50:16"
"4627","20","20190206103130","PC","AAA01","3","30000","6000","24000","2019-02-06 10:31:30"
"4628","22","20190206081416","Shop","AAA02","6","90000","13800","76200","2019-02-06 08:14:16"
"4629","50","20190206072224","Shop","AAA03","15","255000","45000","210000","2019-02-06 07:22:24"
"4630","88","20190206044040","Mobile","AAA01","7","70000","14000","56000","2019-02-06 04:40:40"
"4631","69","20190205072836","Mobile","AAA02","1","15000","2300","12700","2019-02-05 19:28:36"
"4632","64","20190205034209","Shop","AAA05","2","120000","40000","80000","2019-02-05 15:42:09"
"4633","71","20190205023909","Shop","AAA03","3","51000","9000","42000","2019-02-05 14:39:09"
"4634","42","20190205013551","PC","AAA05","13","780000","260000","520000","2019-02-05 13:35:51"
"4635","15","20190205123710","Shop","AAA05","12","720000","240000","480000","2019-02-05 12:37:10"
"4636","84","20190205113718","Shop","AAA04","3","24000","1200","22800","2019-02-05 11:37:18"
"4637","41","20190205090453","Shop","AAA05","17","1020000","340000","680000","2019-02-05 09:04:53"
"4638","87","20190205071624","Shop","AAA04","7","56000","2800","53200","2019-02-05 07:16:24"
"4639","55","20190204033902","Shop","AAA02","3","45000","6900","38100","2019-02-04 15:39:02"
"4640","64","20190204024114","Mobile","AAA01","9","90000","18000","72000","2019-02-04 14:41:14"
"4641","25","20190204015223","Shop","AAA03","3","51000","9000","42000","2019-02-04 13:52:23"
"4642","28","20190204124010","PC","AAA03","11","187000","33000","154000","2019-02-04 12:40:10"
"4643","5","20190204115133","PC","AAA03","5","85000","15000","70000","2019-02-04 11:51:33"
"4644","61","20190204095713","PC","AAA03","2","34000","6000","28000","2019-02-04 09:57:13"
"4645","6","20190130054442","Mobile","AAA05","5","300000","100000","200000","2019-01-30 17:44:42"
"4646","29","20190130042628","Shop","AAA03","3","51000","9000","42000","2019-01-30 16:26:28"
"4647","2","20190130033751","PC","AAA01","13","130000","26000","104000","2019-01-30 15:37:51"
"4648","93","20190130020737","Shop","AAA04","4","32000","1600","30400","2019-01-30 14:07:37"
"4649","2","20190130010201","Mobile","AAA05","12","720000","240000","480000","2019-01-30 13:02:01"
"4650","52","20190130121132","Shop","AAA01","1","10000","2000","8000","2019-01-30 12:11:32"
"4651","35","20190130112133","Mobile","AAA04","6","48000","2400","45600","2019-01-30 11:21:33"
"4652","40","20190130095716","PC","AAA04","14","112000","5600","106400","2019-01-30 09:57:16"
"4653","69","20190130084041","Mobile","AAA02","2","30000","4600","25400","2019-01-30 08:40:41"
"4654","39","20190130073056","Mobile","AAA02","2","30000","4600","25400","2019-01-30 07:30:56"
"4655","7","20190129105510","Mobile","AAA03","12","204000","36000","168000","2019-01-29 22:55:10"
"4656","3","20190129081447","PC","AAA01","15","150000","30000","120000","2019-01-29 20:14:47"
"4657","85","20190129030030","PC","AAA01","7","70000","14000","56000","2019-01-29 15:00:30"
"4658","61","20190129015203","Shop","AAA03","1","17000","3000","14000","2019-01-29 13:52:03"
"4659","77","20190129010438","Mobile","AAA03","4","68000","12000","56000","2019-01-29 13:04:38"
"4660","63","20190129122247","Shop","AAA04","8","64000","3200","60800","2019-01-29 12:22:47"
"4661","40","20190129111619","PC","AAA01","4","40000","8000","32000","2019-01-29 11:16:19"
"4662","100","20190129092822","Mobile","AAA02","4","60000","9200","50800","2019-01-29 09:28:22"
"4663","64","20190129082028","Shop","AAA05","10","600000","200000","400000","2019-01-29 08:20:28"
"4664","41","20190129061816","Shop","AAA04","1","8000","400","7600","2019-01-29 06:18:16"
"4665","10","20190128014000","PC","AAA05","19","1140000","380000","760000","2019-01-28 13:40:00"
"4666","93","20190128123637","PC","AAA03","8","136000","24000","112000","2019-01-28 12:36:37"
"4667","7","20190128112435","Mobile","AAA02","1","15000","2300","12700","2019-01-28 11:24:35"
"4668","48","20190128100532","Shop","AAA03","13","221000","39000","182000","2019-01-28 10:05:32"
"4669","80","20190128094452","PC","AAA02","8","120000","18400","101600","2019-01-28 09:44:52"
"4670","82","20190125120743","Mobile","AAA05","11","660000","220000","440000","2019-01-25 12:07:43"
"4671","26","20190125111426","PC","AAA02","6","90000","13800","76200","2019-01-25 11:14:26"
"4672","45","20190125095147","Mobile","AAA04","1","8000","400","7600","2019-01-25 09:51:47"
"4673","88","20190125085551","PC","AAA03","4","68000","12000","56000","2019-01-25 08:55:51"
"4674","86","20190125080556","Mobile","AAA01","2","20000","4000","16000","2019-01-25 08:05:56"
"4675","1","20190124092748","Shop","AAA04","4","32000","1600","30400","2019-01-24 21:27:48"
"4676","32","20190124052008","Shop","AAA04","5","40000","2000","38000","2019-01-24 17:20:08"
"4677","84","20190124041929","PC","AAA02","3","45000","6900","38100","2019-01-24 16:19:29"
"4678","36","20190124032649","Mobile","AAA05","11","660000","220000","440000","2019-01-24 15:26:49"
"4679","94","20190124021519","Shop","AAA04","8","64000","3200","60800","2019-01-24 14:15:19"
"4680","67","20190124125631","PC","AAA03","9","153000","27000","126000","2019-01-24 12:56:31"
"4681","84","20190124093408","Shop","AAA05","3","180000","60000","120000","2019-01-24 09:34:08"
"4682","7","20190124075858","Mobile","AAA04","10","80000","4000","76000","2019-01-24 07:58:58"
"4683","52","20190123050137","Mobile","AAA01","3","30000","6000","24000","2019-01-23 17:01:37"
"4684","53","20190123032000","Mobile","AAA05","4","240000","80000","160000","2019-01-23 15:20:00"
"4685","71","20190123013555","PC","AAA05","3","180000","60000","120000","2019-01-23 13:35:55"
"4686","48","20190123114953","Mobile","AAA05","3","180000","60000","120000","2019-01-23 11:49:53"
"4687","30","20190123100637","Shop","AAA03","6","102000","18000","84000","2019-01-23 10:06:37"
"4688","53","20190123092512","PC","AAA05","1","60000","20000","40000","2019-01-23 09:25:12"
"4689","92","20190123081633","PC","AAA04","12","96000","4800","91200","2019-01-23 08:16:33"
"4690","40","20190123070258","PC","AAA05","2","120000","40000","80000","2019-01-23 07:02:58"
"4691","53","20190122100312","Shop","AAA02","2","30000","4600","25400","2019-01-22 22:03:12"
"4692","90","20190122082310","Shop","AAA05","1","60000","20000","40000","2019-01-22 20:23:10"
"4693","94","20190122025837","PC","AAA05","9","540000","180000","360000","2019-01-22 14:58:37"
"4694","58","20190122105505","PC","AAA02","2","30000","4600","25400","2019-01-22 10:55:05"
"4695","3","20190122092834","Mobile","AAA01","6","60000","12000","48000","2019-01-22 09:28:34"
"4696","60","20190122080728","Shop","AAA05","2","120000","40000","80000","2019-01-22 08:07:28"
"4697","47","20190121035402","Mobile","AAA04","4","32000","1600","30400","2019-01-21 15:54:02"
"4698","71","20190121024849","PC","AAA01","13","130000","26000","104000","2019-01-21 14:48:49"
"4699","74","20190121011141","Shop","AAA01","4","40000","8000","32000","2019-01-21 13:11:41"
"4700","59","20190121115023","PC","AAA01","1","10000","2000","8000","2019-01-21 11:50:23"
"4701","69","20190121104107","Mobile","AAA01","3","30000","6000","24000","2019-01-21 10:41:07"
"4702","94","20190121092657","Shop","AAA04","16","128000","6400","121600","2019-01-21 09:26:57"
"4703","1","20190118071559","PC","AAA03","11","187000","33000","154000","2019-01-18 07:15:59"
"4704","7","20190118011754","Shop","AAA04","10","80000","4000","76000","2019-01-18 01:17:54"
"4705","77","20190117031916","Mobile","AAA03","1","17000","3000","14000","2019-01-17 15:19:16"
"4706","91","20190117021031","PC","AAA02","4","60000","9200","50800","2019-01-17 14:10:31"
"4707","98","20190117010123","Mobile","AAA04","1","8000","400","7600","2019-01-17 13:01:23"
"4708","35","20190117124651","Shop","AAA05","3","180000","60000","120000","2019-01-17 12:46:51"
"4709","48","20190117113145","Shop","AAA04","7","56000","2800","53200","2019-01-17 11:31:45"
"4710","21","20190117095843","Mobile","AAA03","18","306000","54000","252000","2019-01-17 09:58:43"
"4711","67","20190117083045","PC","AAA02","13","195000","29900","165100","2019-01-17 08:30:45"
"4712","34","20190117073440","Shop","AAA04","9","72000","3600","68400","2019-01-17 07:34:40"
"4713","18","20190116060236","Shop","AAA05","4","240000","80000","160000","2019-01-16 18:02:36"
"4714","67","20190116031541","Mobile","AAA01","9","90000","18000","72000","2019-01-16 15:15:41"
"4715","94","20190116024034","Mobile","AAA01","11","110000","22000","88000","2019-01-16 14:40:34"
"4716","1","20190116114555","PC","AAA03","7","119000","21000","98000","2019-01-16 11:45:55"
"4717","3","20190116085735","PC","AAA04","24","192000","9600","182400","2019-01-16 08:57:35"
"4718","26","20190116073207","PC","AAA02","5","75000","11500","63500","2019-01-16 07:32:07"
"4719","80","20190115100014","Shop","AAA03","5","85000","15000","70000","2019-01-15 22:00:14"
"4720","47","20190115050615","Mobile","AAA02","5","75000","11500","63500","2019-01-15 17:06:15"
"4721","24","20190115034754","Mobile","AAA02","1","15000","2300","12700","2019-01-15 15:47:54"
"4722","22","20190115125916","Shop","AAA02","2","30000","4600","25400","2019-01-15 12:59:16"
"4723","38","20190115121353","Shop","AAA02","3","45000","6900","38100","2019-01-15 12:13:53"
"4724","18","20190115095905","Shop","AAA03","3","51000","9000","42000","2019-01-15 09:59:05"
"4725","36","20190115091357","PC","AAA01","18","180000","36000","144000","2019-01-15 09:13:57"
"4726","51","20190114043414","Shop","AAA05","5","300000","100000","200000","2019-01-14 16:34:14"
"4727","100","20190114031827","Shop","AAA03","4","68000","12000","56000","2019-01-14 15:18:27"
"4728","74","20190114015620","Mobile","AAA03","3","51000","9000","42000","2019-01-14 13:56:20"
"4729","96","20190114010915","Mobile","AAA02","4","60000","9200","50800","2019-01-14 13:09:15"
"4730","82","20190114115353","PC","AAA03","6","102000","18000","84000","2019-01-14 11:53:53"
"4731","13","20190114103301","PC","AAA01","1","10000","2000","8000","2019-01-14 10:33:01"
"4732","37","20190114094301","PC","AAA02","5","75000","11500","63500","2019-01-14 09:43:01"
"4733","25","20190112032128","PC","AAA04","4","32000","1600","30400","2019-01-12 15:21:28"
"4734","41","20190111042335","Shop","AAA03","4","68000","12000","56000","2019-01-11 04:23:35"
"4735","74","20190110060819","Shop","AAA01","7","70000","14000","56000","2019-01-10 18:08:19"
"4736","82","20190110032333","PC","AAA02","1","15000","2300","12700","2019-01-10 15:23:33"
"4737","6","20190110015013","PC","AAA01","4","40000","8000","32000","2019-01-10 13:50:13"
"4738","30","20190110125604","PC","AAA05","11","660000","220000","440000","2019-01-10 12:56:04"
"4739","60","20190110115317","Mobile","AAA02","8","120000","18400","101600","2019-01-10 11:53:17"
"4740","72","20190110103126","PC","AAA04","7","56000","2800","53200","2019-01-10 10:31:26"
"4741","34","20190110083523","Shop","AAA03","7","119000","21000","98000","2019-01-10 08:35:23"
"4742","55","20190110073850","PC","AAA02","11","165000","25300","139700","2019-01-10 07:38:50"
"4743","32","20190109110247","Shop","AAA05","4","240000","80000","160000","2019-01-09 23:02:47"
"4744","13","20190109110340","PC","AAA02","9","135000","20700","114300","2019-01-09 11:03:40"
"4745","86","20190109093009","PC","AAA04","3","24000","1200","22800","2019-01-09 09:30:09"
"4746","32","20190109084342","Mobile","AAA02","8","120000","18400","101600","2019-01-09 08:43:42"
"4747","18","20190109072245","PC","AAA02","4","60000","9200","50800","2019-01-09 07:22:45"
"4748","99","20190108051126","Mobile","AAA04","1","8000","400","7600","2019-01-08 17:11:26"
"4749","5","20190108035018","PC","AAA02","7","105000","16100","88900","2019-01-08 15:50:18"
"4750","20","20190108025250","Mobile","AAA03","3","51000","9000","42000","2019-01-08 14:52:50"
"4751","19","20190108022124","Mobile","AAA02","4","60000","9200","50800","2019-01-08 14:21:24"
"4752","38","20190108010143","Mobile","AAA01","10","100000","20000","80000","2019-01-08 13:01:43"
"4753","22","20190108111539","Shop","AAA01","5","50000","10000","40000","2019-01-08 11:15:39"
"4754","16","20190108095923","Shop","AAA03","10","170000","30000","140000","2019-01-08 09:59:23"
"4755","62","20190108085556","Mobile","AAA02","9","135000","20700","114300","2019-01-08 08:55:56"
"4756","85","20190107061550","Mobile","AAA04","10","80000","4000","76000","2019-01-07 18:15:50"
"4757","42","20190107023429","Mobile","AAA05","9","540000","180000","360000","2019-01-07 14:34:29"
"4758","16","20190107013850","PC","AAA05","20","1200000","400000","800000","2019-01-07 13:38:50"
"4759","28","20190107115945","PC","AAA02","13","195000","29900","165100","2019-01-07 11:59:45"
"4760","96","20190107104249","Mobile","AAA02","14","210000","32200","177800","2019-01-07 10:42:49"
"4761","75","20190107094006","Shop","AAA04","1","8000","400","7600","2019-01-07 09:40:06"
"4762","35","20190103031220","Mobile","AAA02","3","45000","6900","38100","2019-01-03 15:12:20"
"4763","49","20190103021320","PC","AAA01","6","60000","12000","48000","2019-01-03 14:13:20"
"4764","30","20190103010713","Mobile","AAA03","7","119000","21000","98000","2019-01-03 13:07:13"
"4765","92","20190103113126","Mobile","AAA05","8","480000","160000","320000","2019-01-03 11:31:26"
"4766","18","20190103100600","Mobile","AAA05","9","540000","180000","360000","2019-01-03 10:06:00"
"4767","81","20190103084239","Mobile","AAA02","5","75000","11500","63500","2019-01-03 08:42:39"
"4768","84","20190102084129","Mobile","AAA02","4","60000","9200","50800","2019-01-02 20:41:29"
"4769","55","20190102045003","Shop","AAA01","1","10000","2000","8000","2019-01-02 16:50:03"
"4770","60","20190102032734","Mobile","AAA01","1","10000","2000","8000","2019-01-02 15:27:34"
"4771","55","20190102021233","Mobile","AAA01","8","80000","16000","64000","2019-01-02 14:12:33"
"4772","86","20190102124315","PC","AAA02","6","90000","13800","76200","2019-01-02 12:43:15"
"4773","89","20190102114645","Mobile","AAA01","16","160000","32000","128000","2019-01-02 11:46:45"
"4774","81","20190102084448","PC","AAA05","4","240000","80000","160000","2019-01-02 08:44:48"
"4775","37","20190102071658","Shop","AAA02","12","180000","27600","152400","2019-01-02 07:16:58"
"4776","40","20190101110615","Shop","AAA05","2","120000","40000","80000","2019-01-01 23:06:15"
"4777","66","20190101011306","Shop","AAA05","3","180000","60000","120000","2019-01-01 13:13:06"
"4778","88","20190101123547","Shop","AAA03","5","85000","15000","70000","2019-01-01 12:35:47"
"4779","64","20190101110802","Shop","AAA04","11","88000","4400","83600","2019-01-01 11:08:02"
"4780","53","20190101095550","Mobile","AAA05","4","240000","80000","160000","2019-01-01 09:55:50"
"4781","3","20190101083027","Shop","AAA01","7","70000","14000","56000","2019-01-01 08:30:27"
"4782","48","20190101065915","Shop","AAA01","4","40000","8000","32000","2019-01-01 06:59:15"
"4783","8","20181231095920","PC","AAA03","7","119000","21000","98000","2018-12-31 21:59:20"
"4784","42","20181231074539","Mobile","AAA01","1","10000","2000","8000","2018-12-31 19:45:39"
"4785","35","20181231051950","Mobile","AAA04","5","40000","2000","38000","2018-12-31 17:19:50"
"4786","67","20181231030129","Mobile","AAA02","7","105000","16100","88900","2018-12-31 15:01:29"
"4787","44","20181231010923","Shop","AAA05","1","60000","20000","40000","2018-12-31 13:09:23"
"4788","47","20181231113455","Mobile","AAA03","2","34000","6000","28000","2018-12-31 11:34:55"
"4789","52","20181231104127","PC","AAA03","9","153000","27000","126000","2018-12-31 10:41:27"
"4790","11","20181231094511","Shop","AAA05","7","420000","140000","280000","2018-12-31 09:45:11"
"4791","47","20181228075805","Mobile","AAA02","8","120000","18400","101600","2018-12-28 07:58:05"
"4792","11","20181227044925","Mobile","AAA04","7","56000","2800","53200","2018-12-27 16:49:25"
"4793","3","20181227023650","Mobile","AAA01","11","110000","22000","88000","2018-12-27 14:36:50"
"4794","77","20181227124927","Shop","AAA04","1","8000","400","7600","2018-12-27 12:49:27"
"4795","87","20181227121039","Mobile","AAA03","4","68000","12000","56000","2018-12-27 12:10:39"
"4796","40","20181227085611","PC","AAA02","3","45000","6900","38100","2018-12-27 08:56:11"
"4797","21","20181227073159","PC","AAA01","10","100000","20000","80000","2018-12-27 07:31:59"
"4798","22","20181226032608","Mobile","AAA02","6","90000","13800","76200","2018-12-26 15:26:08"
"4799","18","20181226011517","Shop","AAA01","4","40000","8000","32000","2018-12-26 13:15:17"
"4800","20","20181226122353","Mobile","AAA04","2","16000","800","15200","2018-12-26 12:23:53"
"4801","10","20181226111807","Mobile","AAA02","8","120000","18400","101600","2018-12-26 11:18:07"
"4802","51","20181226100134","PC","AAA03","10","170000","30000","140000","2018-12-26 10:01:34"
"4803","1","20181226085134","PC","AAA05","13","780000","260000","520000","2018-12-26 08:51:34"
"4804","58","20181226072128","Shop","AAA04","5","40000","2000","38000","2018-12-26 07:21:28"
"4805","82","20181225095736","Mobile","AAA01","3","30000","6000","24000","2018-12-25 21:57:36"
"4806","25","20181225025315","Shop","AAA01","5","50000","10000","40000","2018-12-25 14:53:15"
"4807","42","20181225015512","PC","AAA02","2","30000","4600","25400","2018-12-25 13:55:12"
"4808","80","20181225125357","Shop","AAA03","7","119000","21000","98000","2018-12-25 12:53:57"
"4809","42","20181225114528","Shop","AAA03","7","119000","21000","98000","2018-12-25 11:45:28"
"4810","19","20181225105140","PC","AAA04","3","24000","1200","22800","2018-12-25 10:51:40"
"4811","36","20181225080540","Mobile","AAA02","19","285000","43700","241300","2018-12-25 08:05:40"
"4812","56","20181225063612","PC","AAA04","7","56000","2800","53200","2018-12-25 06:36:12"
"4813","55","20181224051641","PC","AAA04","3","24000","1200","22800","2018-12-24 17:16:41"
"4814","57","20181224034201","Shop","AAA03","1","17000","3000","14000","2018-12-24 15:42:01"
"4815","28","20181224114038","Mobile","AAA01","15","150000","30000","120000","2018-12-24 11:40:38"
"4816","70","20181224091741","Mobile","AAA03","20","340000","60000","280000","2018-12-24 09:17:41"
"4817","62","20181221060800","PC","AAA03","9","153000","27000","126000","2018-12-21 18:08:00"
"4818","70","20181221023400","PC","AAA04","22","176000","8800","167200","2018-12-21 14:34:00"
"4819","97","20181221124759","Mobile","AAA01","8","80000","16000","64000","2018-12-21 12:47:59"
"4820","83","20181221114919","PC","AAA01","4","40000","8000","32000","2018-12-21 11:49:19"
"4821","2","20181221111618","Shop","AAA01","3","30000","6000","24000","2018-12-21 11:16:18"
"4822","63","20181221090343","PC","AAA05","5","300000","100000","200000","2018-12-21 09:03:43"
"4823","89","20181221081124","Mobile","AAA05","4","240000","80000","160000","2018-12-21 08:11:24"
"4824","79","20181220092656","Shop","AAA03","1","17000","3000","14000","2018-12-20 21:26:56"
"4825","91","20181220052939","PC","AAA03","4","68000","12000","56000","2018-12-20 17:29:39"
"4826","55","20181220034740","Mobile","AAA04","5","40000","2000","38000","2018-12-20 15:47:40"
"4827","76","20181220021356","PC","AAA04","7","56000","2800","53200","2018-12-20 14:13:56"
"4828","45","20181220012224","Mobile","AAA05","4","240000","80000","160000","2018-12-20 13:22:24"
"4829","78","20181220120154","PC","AAA04","6","48000","2400","45600","2018-12-20 12:01:54"
"4830","90","20181220104903","Shop","AAA02","5","75000","11500","63500","2018-12-20 10:49:03"
"4831","3","20181220070204","Mobile","AAA03","9","153000","27000","126000","2018-12-20 07:02:04"
"4832","86","20181219025521","Shop","AAA01","9","90000","18000","72000","2018-12-19 14:55:21"
"4833","24","20181219011755","PC","AAA03","7","119000","21000","98000","2018-12-19 13:17:55"
"4834","86","20181219114442","Shop","AAA03","8","136000","24000","112000","2018-12-19 11:44:42"
"4835","10","20181219112403","Mobile","AAA01","7","70000","14000","56000","2018-12-19 11:24:03"
"4836","21","20181219100139","PC","AAA02","2","30000","4600","25400","2018-12-19 10:01:39"
"4837","88","20181219085222","Mobile","AAA03","2","34000","6000","28000","2018-12-19 08:52:22"
"4838","15","20181219070727","Shop","AAA02","13","195000","29900","165100","2018-12-19 07:07:27"
"4839","15","20181218114355","PC","AAA01","16","160000","32000","128000","2018-12-18 23:43:55"
"4840","76","20181218023758","Mobile","AAA02","5","75000","11500","63500","2018-12-18 14:37:58"
"4841","78","20181218012914","Mobile","AAA02","1","15000","2300","12700","2018-12-18 13:29:14"
"4842","15","20181218122231","Mobile","AAA04","16","128000","6400","121600","2018-12-18 12:22:31"
"4843","73","20181218114352","Mobile","AAA05","9","540000","180000","360000","2018-12-18 11:43:52"
"4844","17","20181218085354","PC","AAA01","2","20000","4000","16000","2018-12-18 08:53:54"
"4845","10","20181218071217","PC","AAA04","5","40000","2000","38000","2018-12-18 07:12:17"
"4846","28","20181217071944","PC","AAA03","6","102000","18000","84000","2018-12-17 19:19:44"
"4847","55","20181217023258","Mobile","AAA01","14","140000","28000","112000","2018-12-17 14:32:58"
"4848","8","20181217121006","Mobile","AAA03","13","221000","39000","182000","2018-12-17 12:10:06"
"4849","73","20181217104919","PC","AAA05","12","720000","240000","480000","2018-12-17 10:49:19"
"4850","35","20181217091808","Mobile","AAA03","4","68000","12000","56000","2018-12-17 09:18:08"
"4851","88","20181214070803","Shop","AAA04","2","16000","800","15200","2018-12-14 19:08:03"
"4852","73","20181214011202","Mobile","AAA04","4","32000","1600","30400","2018-12-14 13:12:02"
"4853","20","20181214120328","PC","AAA05","1","60000","20000","40000","2018-12-14 12:03:28"
"4854","27","20181214105016","Shop","AAA03","10","170000","30000","140000","2018-12-14 10:50:16"
"4855","43","20181214091647","Shop","AAA04","19","152000","7600","144400","2018-12-14 09:16:47"
"4856","19","20181214072157","Shop","AAA01","2","20000","4000","16000","2018-12-14 07:21:57"
"4857","3","20181213075224","Mobile","AAA04","11","88000","4400","83600","2018-12-13 19:52:24"
"4858","91","20181213045357","Mobile","AAA01","3","30000","6000","24000","2018-12-13 16:53:57"
"4859","89","20181213032520","Shop","AAA04","24","192000","9600","182400","2018-12-13 15:25:20"
"4860","61","20181213123727","Mobile","AAA02","4","60000","9200","50800","2018-12-13 12:37:27"
"4861","45","20181213103924","Mobile","AAA03","7","119000","21000","98000","2018-12-13 10:39:24"
"4862","93","20181213082338","Mobile","AAA01","1","10000","2000","8000","2018-12-13 08:23:38"
"4863","3","20181213065534","Shop","AAA01","23","230000","46000","184000","2018-12-13 06:55:34"
"4864","85","20181212052217","Mobile","AAA01","12","120000","24000","96000","2018-12-12 17:22:17"
"4865","41","20181212041707","PC","AAA02","7","105000","16100","88900","2018-12-12 16:17:07"
"4866","5","20181212033445","Mobile","AAA05","8","480000","160000","320000","2018-12-12 15:34:45"
"4867","75","20181212014459","PC","AAA03","1","17000","3000","14000","2018-12-12 13:44:59"
"4868","3","20181212111825","PC","AAA03","19","323000","57000","266000","2018-12-12 11:18:25"
"4869","35","20181212094624","Shop","AAA05","3","180000","60000","120000","2018-12-12 09:46:24"
"4870","95","20181212075941","Mobile","AAA05","11","660000","220000","440000","2018-12-12 07:59:41"
"4871","78","20181211085704","Mobile","AAA05","9","540000","180000","360000","2018-12-11 20:57:04"
"4872","67","20181211035209","Shop","AAA03","12","204000","36000","168000","2018-12-11 15:52:09"
"4873","61","20181211121341","Mobile","AAA03","6","102000","18000","84000","2018-12-11 12:13:41"
"4874","20","20181211110720","Shop","AAA03","7","119000","21000","98000","2018-12-11 11:07:20"
"4875","52","20181211100624","PC","AAA04","3","24000","1200","22800","2018-12-11 10:06:24"
"4876","85","20181211084228","PC","AAA04","4","32000","1600","30400","2018-12-11 08:42:28"
"4877","15","20181211073131","PC","AAA03","11","187000","33000","154000","2018-12-11 07:31:31"
"4878","29","20181210095810","Shop","AAA02","5","75000","11500","63500","2018-12-10 21:58:10"
"4879","6","20181210055001","PC","AAA03","1","17000","3000","14000","2018-12-10 17:50:01"
"4880","17","20181210055550","Mobile","AAA04","4","32000","1600","30400","2018-12-10 17:55:50"
"4881","64","20181210035517","Shop","AAA04","9","72000","3600","68400","2018-12-10 15:55:17"
"4882","97","20181210015444","Shop","AAA03","4","68000","12000","56000","2018-12-10 13:54:44"
"4883","3","20181210122025","PC","AAA04","2","16000","800","15200","2018-12-10 12:20:25"
"4884","78","20181210094821","Shop","AAA01","1","10000","2000","8000","2018-12-10 09:48:21"
"4885","35","20181205051404","PC","AAA03","2","34000","6000","28000","2018-12-05 17:14:04"
"4886","67","20181205033939","Mobile","AAA02","15","225000","34500","190500","2018-12-05 15:39:39"
"4887","19","20181205024532","Mobile","AAA04","3","24000","1200","22800","2018-12-05 14:45:32"
"4888","81","20181205123905","Shop","AAA03","12","204000","36000","168000","2018-12-05 12:39:05"
"4889","68","20181205101814","Shop","AAA04","1","8000","400","7600","2018-12-05 10:18:14"
"4890","9","20181205093427","PC","AAA02","5","75000","11500","63500","2018-12-05 09:34:27"
"4891","89","20181205074551","PC","AAA03","9","153000","27000","126000","2018-12-05 07:45:51"
"4892","80","20181204073218","PC","AAA02","8","120000","18400","101600","2018-12-04 19:32:18"
"4893","54","20181204035305","Shop","AAA04","1","8000","400","7600","2018-12-04 15:53:05"
"4894","31","20181204023730","PC","AAA01","6","60000","12000","48000","2018-12-04 14:37:30"
"4895","83","20181204122723","Shop","AAA04","11","88000","4400","83600","2018-12-04 12:27:23"
"4896","84","20181204113839","Shop","AAA03","2","34000","6000","28000","2018-12-04 11:38:39"
"4897","62","20181204094630","Mobile","AAA04","4","32000","1600","30400","2018-12-04 09:46:30"
"4898","74","20181204090101","PC","AAA05","3","180000","60000","120000","2018-12-04 09:01:01"
"4899","38","20181204074108","PC","AAA04","6","48000","2400","45600","2018-12-04 07:41:08"
"4900","81","20181203103347","Mobile","AAA03","1","17000","3000","14000","2018-12-03 22:33:47"
"4901","85","20181203070118","PC","AAA03","12","204000","36000","168000","2018-12-03 19:01:18"
"4902","16","20181203124947","Mobile","AAA03","6","102000","18000","84000","2018-12-03 12:49:47"
"4903","45","20181203110154","PC","AAA04","5","40000","2000","38000","2018-12-03 11:01:54"
"4904","17","20181202073546","Shop","AAA04","4","32000","1600","30400","2018-12-02 19:35:46"
"4905","25","20181130011923","Mobile","AAA02","2","30000","4600","25400","2018-11-30 01:19:23"
"4906","100","20181129033335","PC","AAA04","4","32000","1600","30400","2018-11-29 15:33:35"
"4907","17","20181129012042","Mobile","AAA03","8","136000","24000","112000","2018-11-29 13:20:42"
"4908","55","20181129115546","Mobile","AAA03","4","68000","12000","56000","2018-11-29 11:55:46"
"4909","60","20181129104753","Mobile","AAA01","3","30000","6000","24000","2018-11-29 10:47:53"
"4910","11","20181129092825","Mobile","AAA05","3","180000","60000","120000","2018-11-29 09:28:25"
"4911","36","20181129080943","Shop","AAA01","13","130000","26000","104000","2018-11-29 08:09:43"
"4912","41","20181129063232","Shop","AAA01","6","60000","12000","48000","2018-11-29 06:32:32"
"4913","10","20181128010701","Mobile","AAA03","17","289000","51000","238000","2018-11-28 13:07:01"
"4914","39","20181128114905","PC","AAA02","8","120000","18400","101600","2018-11-28 11:49:05"
"4915","29","20181128104955","Shop","AAA05","7","420000","140000","280000","2018-11-28 10:49:55"
"4916","86","20181128090609","Mobile","AAA02","4","60000","9200","50800","2018-11-28 09:06:09"
"4917","10","20181128084158","Mobile","AAA02","10","150000","23000","127000","2018-11-28 08:41:58"
"4918","3","20181128080534","Shop","AAA04","5","40000","2000","38000","2018-11-28 08:05:34"
"4919","68","20181128063742","Shop","AAA02","6","90000","13800","76200","2018-11-28 06:37:42"
"4920","73","20181127014939","Shop","AAA02","5","75000","11500","63500","2018-11-27 13:49:39"
"4921","15","20181127114154","Shop","AAA05","19","1140000","380000","760000","2018-11-27 11:41:54"
"4922","30","20181127103455","PC","AAA04","13","104000","5200","98800","2018-11-27 10:34:55"
"4923","71","20181127090704","PC","AAA04","9","72000","3600","68400","2018-11-27 09:07:04"
"4924","100","20181127082139","PC","AAA02","3","45000","6900","38100","2018-11-27 08:21:39"
"4925","38","20181127121822","Mobile","AAA03","3","51000","9000","42000","2018-11-27 00:18:22"
"4926","64","20181126064924","Mobile","AAA03","10","170000","30000","140000","2018-11-26 18:49:24"
"4927","41","20181126010251","Shop","AAA02","8","120000","18400","101600","2018-11-26 13:02:51"
"4928","51","20181126120410","Mobile","AAA01","8","80000","16000","64000","2018-11-26 12:04:10"
"4929","64","20181126095006","Mobile","AAA02","9","135000","20700","114300","2018-11-26 09:50:06"
"4930","50","20181122092556","Mobile","AAA04","6","48000","2400","45600","2018-11-22 09:25:56"
"4931","75","20181122080930","Mobile","AAA01","4","40000","8000","32000","2018-11-22 08:09:30"
"4932","40","20181122070611","PC","AAA02","7","105000","16100","88900","2018-11-22 07:06:11"
"4933","62","20181121064136","PC","AAA03","7","119000","21000","98000","2018-11-21 18:41:36"
"4934","88","20181121012719","Mobile","AAA01","3","30000","6000","24000","2018-11-21 13:27:19"
"4935","24","20181121120110","Mobile","AAA03","5","85000","15000","70000","2018-11-21 12:01:10"
"4936","89","20181121105654","PC","AAA04","10","80000","4000","76000","2018-11-21 10:56:54"
"4937","72","20181121095846","PC","AAA01","10","100000","20000","80000","2018-11-21 09:58:46"
"4938","93","20181121090056","PC","AAA03","5","85000","15000","70000","2018-11-21 09:00:56"
"4939","44","20181121075954","Mobile","AAA04","7","56000","2800","53200","2018-11-21 07:59:54"
"4940","23","20181120025909","Shop","AAA01","11","110000","22000","88000","2018-11-20 14:59:09"
"4941","71","20181120022916","Mobile","AAA01","6","60000","12000","48000","2018-11-20 14:29:16"
"4942","40","20181120013022","Mobile","AAA01","12","120000","24000","96000","2018-11-20 13:30:22"
"4943","73","20181120123207","Shop","AAA05","5","300000","100000","200000","2018-11-20 12:32:07"
"4944","44","20181120115145","PC","AAA02","10","150000","23000","127000","2018-11-20 11:51:45"
"4945","9","20181120101659","PC","AAA01","2","20000","4000","16000","2018-11-20 10:16:59"
"4946","34","20181120085723","Shop","AAA05","12","720000","240000","480000","2018-11-20 08:57:23"
"4947","97","20181120075922","Shop","AAA03","6","102000","18000","84000","2018-11-20 07:59:22"
"4948","35","20181119092550","PC","AAA02","1","15000","2300","12700","2018-11-19 21:25:50"
"4949","25","20181119044310","Shop","AAA03","3","51000","9000","42000","2018-11-19 16:43:10"
"4950","7","20181119033346","Mobile","AAA03","7","119000","21000","98000","2018-11-19 15:33:46"
"4951","87","20181119105312","PC","AAA02","10","150000","23000","127000","2018-11-19 10:53:12"
"4952","45","20181119101024","Shop","AAA02","2","30000","4600","25400","2018-11-19 10:10:24"
"4953","76","20181119084956","Shop","AAA05","5","300000","100000","200000","2018-11-19 08:49:56"
"4954","97","20181115045227","PC","AAA05","6","360000","120000","240000","2018-11-15 04:52:27"
"4955","78","20181114114803","Shop","AAA02","3","45000","6900","38100","2018-11-14 11:48:03"
"4956","36","20181114093556","Shop","AAA04","2","16000","800","15200","2018-11-14 09:35:56"
"4957","40","20181114074755","PC","AAA01","3","30000","6000","24000","2018-11-14 07:47:55"
"4958","42","20181113091522","Mobile","AAA02","4","60000","9200","50800","2018-11-13 21:15:22"
"4959","23","20181113045010","Shop","AAA05","8","480000","160000","320000","2018-11-13 16:50:10"
"4960","39","20181113034719","PC","AAA04","11","88000","4400","83600","2018-11-13 15:47:19"
"4961","14","20181113015502","Mobile","AAA03","7","119000","21000","98000","2018-11-13 13:55:02"
"4962","61","20181113125303","Mobile","AAA05","4","240000","80000","160000","2018-11-13 12:53:03"
"4963","58","20181113122153","Shop","AAA03","6","102000","18000","84000","2018-11-13 12:21:53"
"4964","82","20181113094302","Mobile","AAA03","10","170000","30000","140000","2018-11-13 09:43:02"
"4965","1","20181113082956","Shop","AAA01","8","80000","16000","64000","2018-11-13 08:29:56"
"4966","28","20181113064347","Shop","AAA05","12","720000","240000","480000","2018-11-13 06:43:47"
"4967","66","20181112115047","PC","AAA03","5","85000","15000","70000","2018-11-12 23:50:47"
"4968","48","20181112024547","PC","AAA01","8","80000","16000","64000","2018-11-12 14:45:47"
"4969","60","20181112013836","Shop","AAA04","6","48000","2400","45600","2018-11-12 13:38:36"
"4970","33","20181112121924","Mobile","AAA02","2","30000","4600","25400","2018-11-12 12:19:24"
"4971","78","20181112114100","PC","AAA01","8","80000","16000","64000","2018-11-12 11:41:00"
"4972","71","20181112103415","PC","AAA02","5","75000","11500","63500","2018-11-12 10:34:15"
"4973","48","20181112083805","Shop","AAA04","3","24000","1200","22800","2018-11-12 08:38:05"
"4974","86","20181109014454","Shop","AAA02","4","60000","9200","50800","2018-11-09 01:44:54"
"4975","75","20181108040430","Shop","AAA04","1","8000","400","7600","2018-11-08 16:04:30"
"4976","48","20181108031639","Mobile","AAA02","10","150000","23000","127000","2018-11-08 15:16:39"
"4977","60","20181108122416","PC","AAA01","3","30000","6000","24000","2018-11-08 12:24:16"
"4978","65","20181108102438","PC","AAA02","8","120000","18400","101600","2018-11-08 10:24:38"
"4979","62","20181108091546","PC","AAA03","15","255000","45000","210000","2018-11-08 09:15:46"
"4980","39","20181108082859","Mobile","AAA02","7","105000","16100","88900","2018-11-08 08:28:59"
"4981","35","20181108073656","Shop","AAA02","1","15000","2300","12700","2018-11-08 07:36:56"
"4982","52","20181107074109","PC","AAA01","3","30000","6000","24000","2018-11-07 07:41:09"
"4983","16","20181106045344","PC","AAA03","1","17000","3000","14000","2018-11-06 16:53:44"
"4984","81","20181106034526","PC","AAA03","3","51000","9000","42000","2018-11-06 15:45:26"
"4985","82","20181106031033","Shop","AAA04","11","88000","4400","83600","2018-11-06 15:10:33"
"4986","5","20181106024209","Mobile","AAA05","12","720000","240000","480000","2018-11-06 14:42:09"
"4987","4","20181106125332","PC","AAA04","2","16000","800","15200","2018-11-06 12:53:32"
"4988","48","20181106121801","Shop","AAA03","1","17000","3000","14000","2018-11-06 12:18:01"
"4989","61","20181106100023","Shop","AAA02","5","75000","11500","63500","2018-11-06 10:00:23"
"4990","62","20181106081609","PC","AAA04","1","8000","400","7600","2018-11-06 08:16:09"
"4991","62","20181106062242","Mobile","AAA04","5","40000","2000","38000","2018-11-06 06:22:42"
"4992","39","20181105055924","PC","AAA05","2","120000","40000","80000","2018-11-05 17:59:24"
"4993","59","20181105043702","Mobile","AAA01","2","20000","4000","16000","2018-11-05 16:37:02"
"4994","19","20181105033852","PC","AAA01","5","50000","10000","40000","2018-11-05 15:38:52"
"4995","68","20181105025942","PC","AAA03","1","17000","3000","14000","2018-11-05 14:59:42"
"4996","97","20181105015834","Mobile","AAA02","8","120000","18400","101600","2018-11-05 13:58:34"
"4997","63","20181105122411","Shop","AAA05","5","300000","100000","200000","2018-11-05 12:24:11"
"4998","13","20181105112512","Shop","AAA05","2","120000","40000","80000","2018-11-05 11:25:12"
"4999","77","20181105094552","Mobile","AAA03","6","102000","18000","84000","2018-11-05 09:45:52"
"5000","96","20181101095606","Mobile","AAA05","2","120000","40000","80000","2018-11-01 09:56:06"
"5001","62","20181101083645","Mobile","AAA01","5","50000","10000","40000","2018-11-01 08:36:45"
"5002","93","20181101072310","Shop","AAA04","4","32000","1600","30400","2018-11-01 07:23:10"
"5003","87","20181031054301","Mobile","AAA02","15","225000","34500","190500","2018-10-31 17:43:01"
"5004","35","20181031040421","Mobile","AAA03","2","34000","6000","28000","2018-10-31 16:04:21"
"5005","55","20181031030927","Mobile","AAA02","21","315000","48300","266700","2018-10-31 15:09:27"
"5006","43","20181031013029","PC","AAA04","6","48000","2400","45600","2018-10-31 13:30:29"
"5007","94","20181031125552","Shop","AAA05","10","600000","200000","400000","2018-10-31 12:55:52"
"5008","29","20181031114046","PC","AAA05","9","540000","180000","360000","2018-10-31 11:40:46"
"5009","61","20181031104157","PC","AAA02","6","90000","13800","76200","2018-10-31 10:41:57"
"5010","15","20181031093238","Shop","AAA02","13","195000","29900","165100","2018-10-31 09:32:38"
"5011","57","20181031075048","PC","AAA03","8","136000","24000","112000","2018-10-31 07:50:48"
"5012","45","20181030060610","Mobile","AAA01","7","70000","14000","56000","2018-10-30 18:06:10"
"5013","16","20181030020547","Shop","AAA03","14","238000","42000","196000","2018-10-30 14:05:47"
"5014","58","20181030125926","Mobile","AAA04","8","64000","3200","60800","2018-10-30 12:59:26"
"5015","62","20181030120003","Shop","AAA04","6","48000","2400","45600","2018-10-30 12:00:03"
"5016","32","20181030105521","Shop","AAA01","2","20000","4000","16000","2018-10-30 10:55:21"
"5017","57","20181030102014","Shop","AAA05","8","480000","160000","320000","2018-10-30 10:20:14"
"5018","27","20181030092349","PC","AAA05","9","540000","180000","360000","2018-10-30 09:23:49"
"5019","85","20181030090317","PC","AAA01","2","20000","4000","16000","2018-10-30 09:03:17"
"5020","40","20181030074914","PC","AAA04","1","8000","400","7600","2018-10-30 07:49:14"
"5021","23","20181029072029","Mobile","AAA04","9","72000","3600","68400","2018-10-29 19:20:29"
"5022","48","20181029033948","PC","AAA04","5","40000","2000","38000","2018-10-29 15:39:48"
"5023","68","20181029023600","Shop","AAA05","1","60000","20000","40000","2018-10-29 14:36:00"
"5024","51","20181029125555","PC","AAA01","5","50000","10000","40000","2018-10-29 12:55:55"
"5025","8","20181029094406","PC","AAA04","9","72000","3600","68400","2018-10-29 09:44:06"
"5026","96","20181025061900","Shop","AAA02","8","120000","18400","101600","2018-10-25 18:19:00"
"5027","4","20181025045348","PC","AAA02","8","120000","18400","101600","2018-10-25 16:53:48"
"5028","1","20181025031543","PC","AAA01","7","70000","14000","56000","2018-10-25 15:15:43"
"5029","77","20181025015633","Mobile","AAA05","1","60000","20000","40000","2018-10-25 13:56:33"
"5030","82","20181025104247","Shop","AAA05","2","120000","40000","80000","2018-10-25 10:42:47"
"5031","99","20181025090212","Mobile","AAA03","2","34000","6000","28000","2018-10-25 09:02:12"
"5032","19","20181024091211","PC","AAA04","5","40000","2000","38000","2018-10-24 21:12:11"
"5033","54","20181024054753","PC","AAA04","4","32000","1600","30400","2018-10-24 17:47:53"
"5034","87","20181024014132","Shop","AAA02","6","90000","13800","76200","2018-10-24 13:41:32"
"5035","73","20181024124334","Mobile","AAA02","9","135000","20700","114300","2018-10-24 12:43:34"
"5036","30","20181024113809","PC","AAA01","1","10000","2000","8000","2018-10-24 11:38:09"
"5037","93","20181024104245","PC","AAA01","1","10000","2000","8000","2018-10-24 10:42:45"
"5038","76","20181024084522","PC","AAA05","4","240000","80000","160000","2018-10-24 08:45:22"
"5039","91","20181023064636","Shop","AAA03","1","17000","3000","14000","2018-10-23 18:46:36"
"5040","47","20181023035759","Shop","AAA05","1","60000","20000","40000","2018-10-23 15:57:59"
"5041","30","20181023025444","PC","AAA03","10","170000","30000","140000","2018-10-23 14:54:44"
"5042","55","20181023011959","Shop","AAA02","8","120000","18400","101600","2018-10-23 13:19:59"
"5043","15","20181023114522","PC","AAA01","20","200000","40000","160000","2018-10-23 11:45:22"
"5044","20","20181023085956","PC","AAA02","4","60000","9200","50800","2018-10-23 08:59:56"
"5045","16","20181023073418","Shop","AAA02","8","120000","18400","101600","2018-10-23 07:34:18"
"5046","9","20181022022830","PC","AAA01","3","30000","6000","24000","2018-10-22 14:28:30"
"5047","100","20181022122038","Shop","AAA05","2","120000","40000","80000","2018-10-22 12:20:38"
"5048","39","20181022110009","Shop","AAA02","3","45000","6900","38100","2018-10-22 11:00:09"
"5049","1","20181022092542","Shop","AAA04","7","56000","2800","53200","2018-10-22 09:25:42"
"5050","85","20181019040932","Mobile","AAA04","6","48000","2400","45600","2018-10-19 04:09:32"
"5051","90","20181018110937","Mobile","AAA02","1","15000","2300","12700","2018-10-18 11:09:37"
"5052","96","20181018103611","Shop","AAA03","6","102000","18000","84000","2018-10-18 10:36:11"
"5053","69","20181018084312","Shop","AAA03","3","51000","9000","42000","2018-10-18 08:43:12"
"5054","27","20181017061134","PC","AAA02","12","180000","27600","152400","2018-10-17 18:11:34"
"5055","68","20181017012328","Mobile","AAA02","3","45000","6900","38100","2018-10-17 13:23:28"
"5056","1","20181017114718","Shop","AAA05","9","540000","180000","360000","2018-10-17 11:47:18"
"5057","29","20181017100603","Shop","AAA01","6","60000","12000","48000","2018-10-17 10:06:03"
"5058","3","20181017100927","Shop","AAA04","17","136000","6800","129200","2018-10-17 10:09:27"
"5059","92","20181017075846","Shop","AAA03","3","51000","9000","42000","2018-10-17 07:58:46"
"5060","67","20181017043356","PC","AAA05","15","900000","300000","600000","2018-10-17 04:33:56"
"5061","54","20181016070532","PC","AAA03","6","102000","18000","84000","2018-10-16 19:05:32"
"5062","80","20181016031049","Shop","AAA01","8","80000","16000","64000","2018-10-16 15:10:49"
"5063","30","20181016104707","PC","AAA01","10","100000","20000","80000","2018-10-16 10:47:07"
"5064","65","20181016093137","Shop","AAA02","24","360000","55200","304800","2018-10-16 09:31:37"
"5065","99","20181016075830","Shop","AAA04","3","24000","1200","22800","2018-10-16 07:58:30"
"5066","97","20181015104541","Shop","AAA04","7","56000","2800","53200","2018-10-15 22:45:41"
"5067","62","20181015070221","Shop","AAA05","3","180000","60000","120000","2018-10-15 19:02:21"
"5068","52","20181015021205","Shop","AAA02","4","60000","9200","50800","2018-10-15 14:12:05"
"5069","74","20181015010537","Mobile","AAA01","2","20000","4000","16000","2018-10-15 13:05:37"
"5070","98","20181015112830","PC","AAA03","2","34000","6000","28000","2018-10-15 11:28:30"
"5071","36","20181015100540","Mobile","AAA05","12","720000","240000","480000","2018-10-15 10:05:40"
"5072","62","20181015082944","PC","AAA02","16","240000","36800","203200","2018-10-15 08:29:44"
"5073","28","20181013015835","PC","AAA04","6","48000","2400","45600","2018-10-13 01:58:35"
"5074","20","20181012075156","Mobile","AAA02","7","105000","16100","88900","2018-10-12 07:51:56"
"5075","100","20181011112446","Mobile","AAA04","1","8000","400","7600","2018-10-11 23:24:46"
"5076","85","20181011112936","Mobile","AAA02","9","135000","20700","114300","2018-10-11 11:29:36"
"5077","60","20181011091416","Mobile","AAA05","3","180000","60000","120000","2018-10-11 09:14:16"
"5078","11","20181011073547","Mobile","AAA01","9","90000","18000","72000","2018-10-11 07:35:47"
"5079","73","20181010072941","Shop","AAA03","1","17000","3000","14000","2018-10-10 19:29:41"
"5080","84","20181010034636","Mobile","AAA05","3","180000","60000","120000","2018-10-10 15:46:36"
"5081","1","20181010030656","Mobile","AAA05","8","480000","160000","320000","2018-10-10 15:06:56"
"5082","92","20181010014231","Shop","AAA04","11","88000","4400","83600","2018-10-10 13:42:31"
"5083","99","20181010121702","Mobile","AAA03","7","119000","21000","98000","2018-10-10 12:17:02"
"5084","32","20181010111325","Shop","AAA02","8","120000","18400","101600","2018-10-10 11:13:25"
"5085","19","20181010094612","PC","AAA01","2","20000","4000","16000","2018-10-10 09:46:12"
"5086","87","20181010092222","PC","AAA01","5","50000","10000","40000","2018-10-10 09:22:22"
"5087","59","20181010074842","Shop","AAA03","4","68000","12000","56000","2018-10-10 07:48:42"
"5088","76","20181009032928","PC","AAA01","6","60000","12000","48000","2018-10-09 15:29:28"
"5089","65","20181009020017","PC","AAA04","7","56000","2800","53200","2018-10-09 14:00:17"
"5090","84","20181009125214","Mobile","AAA02","4","60000","9200","50800","2018-10-09 12:52:14"
"5091","54","20181009111855","PC","AAA05","4","240000","80000","160000","2018-10-09 11:18:55"
"5092","57","20181009101921","Shop","AAA05","10","600000","200000","400000","2018-10-09 10:19:21"
"5093","91","20181009092136","Shop","AAA04","7","56000","2800","53200","2018-10-09 09:21:36"
"5094","8","20181009073131","Shop","AAA02","8","120000","18400","101600","2018-10-09 07:31:31"
"5095","25","20181008113618","PC","AAA04","3","24000","1200","22800","2018-10-08 23:36:18"
"5096","61","20181008021711","PC","AAA04","1","8000","400","7600","2018-10-08 14:17:11"
"5097","39","20181008011803","PC","AAA04","6","48000","2400","45600","2018-10-08 13:18:03"
"5098","63","20181008115610","Shop","AAA03","4","68000","12000","56000","2018-10-08 11:56:10"
"5099","74","20181008102837","Mobile","AAA03","2","34000","6000","28000","2018-10-08 10:28:37"
"5100","64","20181004045113","PC","AAA05","14","840000","280000","560000","2018-10-04 04:51:13"
"5101","69","20181003080352","Mobile","AAA05","6","360000","120000","240000","2018-10-03 20:03:52"
"5102","54","20181003035606","Mobile","AAA05","4","240000","80000","160000","2018-10-03 15:56:06"
"5103","28","20181003022948","PC","AAA02","6","90000","13800","76200","2018-10-03 14:29:48"
"5104","29","20181003011857","Mobile","AAA02","4","60000","9200","50800","2018-10-03 13:18:57"
"5105","90","20181003122651","PC","AAA05","2","120000","40000","80000","2018-10-03 12:26:51"
"5106","17","20181003093948","Mobile","AAA01","8","80000","16000","64000","2018-10-03 09:39:48"
"5107","97","20181003062747","PC","AAA01","5","50000","10000","40000","2018-10-03 06:27:47"
"5108","41","20181002073413","Mobile","AAA03","5","85000","15000","70000","2018-10-02 19:34:13"
"5109","86","20181002035339","PC","AAA04","6","48000","2400","45600","2018-10-02 15:53:39"
"5110","100","20181002023941","Shop","AAA03","1","17000","3000","14000","2018-10-02 14:39:41"
"5111","16","20181002010646","Mobile","AAA03","11","187000","33000","154000","2018-10-02 13:06:46"
"5112","43","20181002120218","Shop","AAA01","8","80000","16000","64000","2018-10-02 12:02:18"
"5113","53","20181002105336","Shop","AAA02","4","60000","9200","50800","2018-10-02 10:53:36"
"5114","15","20181002092235","Mobile","AAA05","12","720000","240000","480000","2018-10-02 09:22:35"
"5115","52","20181001104128","Shop","AAA05","4","240000","80000","160000","2018-10-01 22:41:28"
"5116","32","20181001064108","PC","AAA01","12","120000","24000","96000","2018-10-01 18:41:08"
"5117","46","20181001043340","Shop","AAA04","4","32000","1600","30400","2018-10-01 16:33:40"
"5118","72","20181001033556","PC","AAA04","3","24000","1200","22800","2018-10-01 15:35:56"
"5119","49","20181001113148","Mobile","AAA04","7","56000","2800","53200","2018-10-01 11:31:48"
"5120","94","20181001095805","Mobile","AAA01","12","120000","24000","96000","2018-10-01 09:58:05"
"5121","54","20180929033623","Shop","AAA05","8","480000","160000","320000","2018-09-29 15:36:23"
"5122","87","20180928022516","Mobile","AAA05","2","120000","40000","80000","2018-09-28 02:25:16"
"5123","18","20180927022216","Shop","AAA02","5","75000","11500","63500","2018-09-27 14:22:16"
"5124","70","20180927011312","Mobile","AAA05","8","480000","160000","320000","2018-09-27 13:13:12"
"5125","16","20180927120400","Shop","AAA03","5","85000","15000","70000","2018-09-27 12:04:00"
"5126","34","20180927110650","Shop","AAA01","7","70000","14000","56000","2018-09-27 11:06:50"
"5127","58","20180927082507","Shop","AAA04","2","16000","800","15200","2018-09-27 08:25:07"
"5128","51","20180927075222","Mobile","AAA05","11","660000","220000","440000","2018-09-27 07:52:22"
"5129","19","20180926064731","Mobile","AAA03","2","34000","6000","28000","2018-09-26 18:47:31"
"5130","61","20180926121237","PC","AAA04","1","8000","400","7600","2018-09-26 12:12:37"
"5131","22","20180926112834","Shop","AAA01","2","20000","4000","16000","2018-09-26 11:28:34"
"5132","85","20180926084430","Mobile","AAA04","6","48000","2400","45600","2018-09-26 08:44:30"
"5133","54","20180926070316","Shop","AAA03","11","187000","33000","154000","2018-09-26 07:03:16"
"5134","28","20180925084944","PC","AAA01","8","80000","16000","64000","2018-09-25 20:49:44"
"5135","33","20180925053022","Mobile","AAA03","7","119000","21000","98000","2018-09-25 17:30:22"
"5136","15","20180925031530","Shop","AAA02","5","75000","11500","63500","2018-09-25 15:15:30"
"5137","62","20180925022253","Shop","AAA01","5","50000","10000","40000","2018-09-25 14:22:53"
"5138","47","20180925011622","PC","AAA01","8","80000","16000","64000","2018-09-25 13:16:22"
"5139","33","20180925121320","PC","AAA03","3","51000","9000","42000","2018-09-25 12:13:20"
"5140","44","20180925103535","PC","AAA05","10","600000","200000","400000","2018-09-25 10:35:35"
"5141","23","20180925093021","Mobile","AAA04","11","88000","4400","83600","2018-09-25 09:30:21"
"5142","12","20180925080537","Shop","AAA04","7","56000","2800","53200","2018-09-25 08:05:37"
"5143","31","20180924074046","Shop","AAA05","4","240000","80000","160000","2018-09-24 19:40:46"
"5144","100","20180924024739","Shop","AAA03","6","102000","18000","84000","2018-09-24 14:47:39"
"5145","57","20180924022521","PC","AAA02","1","15000","2300","12700","2018-09-24 14:25:21"
"5146","86","20180924012059","Shop","AAA02","2","30000","4600","25400","2018-09-24 13:20:59"
"5147","40","20180924113921","PC","AAA04","5","40000","2000","38000","2018-09-24 11:39:21"
"5148","26","20180924110414","Shop","AAA03","2","34000","6000","28000","2018-09-24 11:04:14"
"5149","62","20180924095921","Mobile","AAA01","17","170000","34000","136000","2018-09-24 09:59:21"
"5150","54","20180920052737","Mobile","AAA01","12","120000","24000","96000","2018-09-20 17:27:37"
"5151","25","20180920040229","PC","AAA01","8","80000","16000","64000","2018-09-20 16:02:29"
"5152","45","20180920032447","Mobile","AAA05","3","180000","60000","120000","2018-09-20 15:24:47"
"5153","68","20180920020026","Shop","AAA04","4","32000","1600","30400","2018-09-20 14:00:26"
"5154","79","20180920124312","PC","AAA05","2","120000","40000","80000","2018-09-20 12:43:12"
"5155","92","20180920113848","Mobile","AAA03","2","34000","6000","28000","2018-09-20 11:38:48"
"5156","32","20180920100720","PC","AAA03","4","68000","12000","56000","2018-09-20 10:07:20"
"5157","5","20180920083928","Mobile","AAA04","11","88000","4400","83600","2018-09-20 08:39:28"
"5158","75","20180919115612","Shop","AAA05","3","180000","60000","120000","2018-09-19 23:56:12"
"5159","26","20180919050039","Shop","AAA01","5","50000","10000","40000","2018-09-19 17:00:39"
"5160","93","20180919020018","Mobile","AAA04","4","32000","1600","30400","2018-09-19 14:00:18"
"5161","89","20180919013549","Shop","AAA02","16","240000","36800","203200","2018-09-19 13:35:49"
"5162","93","20180919125654","Shop","AAA03","3","51000","9000","42000","2018-09-19 12:56:54"
"5163","91","20180919112509","Shop","AAA03","5","85000","15000","70000","2018-09-19 11:25:09"
"5164","28","20180919104031","PC","AAA03","7","119000","21000","98000","2018-09-19 10:40:31"
"5165","1","20180919090450","PC","AAA05","8","480000","160000","320000","2018-09-19 09:04:50"
"5166","7","20180919075628","Shop","AAA05","8","480000","160000","320000","2018-09-19 07:56:28"
"5167","42","20180918095818","Mobile","AAA04","11","88000","4400","83600","2018-09-18 21:58:18"
"5168","31","20180918074140","PC","AAA04","2","16000","800","15200","2018-09-18 19:41:40"
"5169","14","20180918024342","PC","AAA03","2","34000","6000","28000","2018-09-18 14:43:42"
"5170","73","20180918010849","Shop","AAA04","6","48000","2400","45600","2018-09-18 13:08:49"
"5171","71","20180918115614","PC","AAA03","6","102000","18000","84000","2018-09-18 11:56:14"
"5172","96","20180918110300","Mobile","AAA02","6","90000","13800","76200","2018-09-18 11:03:00"
"5173","66","20180918091318","Shop","AAA02","8","120000","18400","101600","2018-09-18 09:13:18"
"5174","30","20180918081127","PC","AAA03","9","153000","27000","126000","2018-09-18 08:11:27"
"5175","46","20180918061125","PC","AAA05","10","600000","200000","400000","2018-09-18 06:11:25"
"5176","54","20180918123701","Shop","AAA05","6","360000","120000","240000","2018-09-18 00:37:01"
"5177","79","20180917060453","Mobile","AAA03","1","17000","3000","14000","2018-09-17 06:04:53"
"5178","21","20180914062000","PC","AAA04","9","72000","3600","68400","2018-09-14 06:20:00"
"5179","67","20180914122828","Mobile","AAA02","14","210000","32200","177800","2018-09-14 00:28:28"
"5180","67","20180913011217","PC","AAA04","7","56000","2800","53200","2018-09-13 13:12:17"
"5181","29","20180913120714","Shop","AAA01","12","120000","24000","96000","2018-09-13 12:07:14"
"5182","9","20180913104326","Shop","AAA03","3","51000","9000","42000","2018-09-13 10:43:26"
"5183","82","20180913103949","PC","AAA03","10","170000","30000","140000","2018-09-13 10:39:49"
"5184","30","20180913090829","PC","AAA05","2","120000","40000","80000","2018-09-13 09:08:29"
"5185","43","20180913011911","PC","AAA01","8","80000","16000","64000","2018-09-13 01:19:11"
"5186","64","20180912114116","Shop","AAA05","14","840000","280000","560000","2018-09-12 11:41:16"
"5187","64","20180912105549","Shop","AAA05","6","360000","120000","240000","2018-09-12 10:55:49"
"5188","30","20180912093912","Shop","AAA01","13","130000","26000","104000","2018-09-12 09:39:12"
"5189","44","20180912090455","PC","AAA02","6","90000","13800","76200","2018-09-12 09:04:55"
"5190","24","20180912072358","Mobile","AAA02","11","165000","25300","139700","2018-09-12 07:23:58"
"5191","32","20180911103537","PC","AAA02","21","315000","48300","266700","2018-09-11 22:35:37"
"5192","5","20180911061404","Mobile","AAA05","8","480000","160000","320000","2018-09-11 18:14:04"
"5193","88","20180911041051","Mobile","AAA04","1","8000","400","7600","2018-09-11 16:10:51"
"5194","55","20180911030548","Shop","AAA05","2","120000","40000","80000","2018-09-11 15:05:48"
"5195","66","20180911013944","Mobile","AAA02","8","120000","18400","101600","2018-09-11 13:39:44"
"5196","78","20180911121516","PC","AAA03","1","17000","3000","14000","2018-09-11 12:15:16"
"5197","94","20180911105144","Shop","AAA05","6","360000","120000","240000","2018-09-11 10:51:44"
"5198","72","20180911100108","Shop","AAA04","7","56000","2800","53200","2018-09-11 10:01:08"
"5199","94","20180911084458","Shop","AAA05","7","420000","140000","280000","2018-09-11 08:44:58"
"5200","99","20180911074733","Shop","AAA03","1","17000","3000","14000","2018-09-11 07:47:33"
"5201","47","20180910020322","PC","AAA01","13","130000","26000","104000","2018-09-10 14:03:22"
"5202","13","20180910121926","PC","AAA04","1","8000","400","7600","2018-09-10 12:19:26"
"5203","95","20180910110113","PC","AAA04","9","72000","3600","68400","2018-09-10 11:01:13"
"5204","68","20180910093044","Shop","AAA05","7","420000","140000","280000","2018-09-10 09:30:44"
"5205","38","20180907024506","Shop","AAA05","9","540000","180000","360000","2018-09-07 02:45:06"
"5206","25","20180906121617","Shop","AAA04","7","56000","2800","53200","2018-09-06 12:16:17"
"5207","16","20180906112246","Shop","AAA01","10","100000","20000","80000","2018-09-06 11:22:46"
"5208","3","20180906075407","Shop","AAA04","11","88000","4400","83600","2018-09-06 07:54:07"
"5209","86","20180905112538","PC","AAA01","10","100000","20000","80000","2018-09-05 23:25:38"
"5210","85","20180904075905","PC","AAA02","1","15000","2300","12700","2018-09-04 19:59:05"
"5211","38","20180904041148","PC","AAA04","3","24000","1200","22800","2018-09-04 16:11:48"
"5212","26","20180904012112","Shop","AAA05","1","60000","20000","40000","2018-09-04 13:21:12"
"5213","35","20180904104506","Mobile","AAA04","2","16000","800","15200","2018-09-04 10:45:06"
"5214","86","20180904091644","Mobile","AAA01","1","10000","2000","8000","2018-09-04 09:16:44"
"5215","41","20180904075359","Mobile","AAA02","3","45000","6900","38100","2018-09-04 07:53:59"
"5216","89","20180903091014","Shop","AAA01","19","190000","38000","152000","2018-09-03 21:10:14"
"5217","35","20180903052159","PC","AAA02","7","105000","16100","88900","2018-09-03 17:21:59"
"5218","84","20180903042150","Shop","AAA03","3","51000","9000","42000","2018-09-03 16:21:50"
"5219","11","20180903035149","PC","AAA05","3","180000","60000","120000","2018-09-03 15:51:49"
"5220","31","20180903030001","Mobile","AAA01","6","60000","12000","48000","2018-09-03 15:00:01"
"5221","21","20180903011250","Shop","AAA05","16","960000","320000","640000","2018-09-03 13:12:50"
"5222","29","20180903113715","PC","AAA04","1","8000","400","7600","2018-09-03 11:37:15"
"5223","64","20180901014844","Mobile","AAA05","1","60000","20000","40000","2018-09-01 13:48:44"
"5224","14","20180830064601","Mobile","AAA02","1","15000","2300","12700","2018-08-30 18:46:01"
"5225","15","20180830032239","Shop","AAA03","8","136000","24000","112000","2018-08-30 15:22:39"
"5226","78","20180830013845","Shop","AAA02","3","45000","6900","38100","2018-08-30 13:38:45"
"5227","30","20180830121848","PC","AAA03","11","187000","33000","154000","2018-08-30 12:18:48"
"5228","94","20180830111154","PC","AAA03","17","289000","51000","238000","2018-08-30 11:11:54"
"5229","70","20180830100933","PC","AAA04","2","16000","800","15200","2018-08-30 10:09:33"
"5230","21","20180830084050","PC","AAA01","7","70000","14000","56000","2018-08-30 08:40:50"
"5231","88","20180830080356","Shop","AAA01","3","30000","6000","24000","2018-08-30 08:03:56"
"5232","2","20180830055656","PC","AAA03","3","51000","9000","42000","2018-08-30 05:56:56"
"5233","15","20180829033235","PC","AAA05","16","960000","320000","640000","2018-08-29 15:32:35"
"5234","63","20180829014950","Mobile","AAA02","2","30000","4600","25400","2018-08-29 13:49:50"
"5235","73","20180829100824","Shop","AAA01","4","40000","8000","32000","2018-08-29 10:08:24"
"5236","11","20180829081601","Mobile","AAA05","13","780000","260000","520000","2018-08-29 08:16:01"
"5237","7","20180829065347","PC","AAA04","6","48000","2400","45600","2018-08-29 06:53:47"
"5238","23","20180829125622","Mobile","AAA03","9","153000","27000","126000","2018-08-29 00:56:22"
"5239","77","20180828103902","PC","AAA03","2","34000","6000","28000","2018-08-28 10:39:02"
"5240","64","20180828092015","PC","AAA04","8","64000","3200","60800","2018-08-28 09:20:15"
"5241","54","20180828084157","Mobile","AAA03","8","136000","24000","112000","2018-08-28 08:41:57"
"5242","11","20180828072816","Mobile","AAA01","1","10000","2000","8000","2018-08-28 07:28:16"
"5243","99","20180827090235","Shop","AAA04","4","32000","1600","30400","2018-08-27 21:02:35"
"5244","87","20180827053159","PC","AAA02","12","180000","27600","152400","2018-08-27 17:31:59"
"5245","83","20180827044402","Mobile","AAA05","14","840000","280000","560000","2018-08-27 16:44:02"
"5246","18","20180827025323","Shop","AAA02","4","60000","9200","50800","2018-08-27 14:53:23"
"5247","44","20180827014728","PC","AAA01","3","30000","6000","24000","2018-08-27 13:47:28"
"5248","25","20180827105255","Shop","AAA01","2","20000","4000","16000","2018-08-27 10:52:55"
"5249","60","20180827095325","PC","AAA04","2","16000","800","15200","2018-08-27 09:53:25"
"5250","67","20180823070445","PC","AAA02","4","60000","9200","50800","2018-08-23 07:04:45"
"5251","34","20180822064333","Mobile","AAA04","17","136000","6800","129200","2018-08-22 18:43:33"
"5252","3","20180822025517","Shop","AAA02","5","75000","11500","63500","2018-08-22 14:55:17"
"5253","66","20180822012005","Mobile","AAA05","1","60000","20000","40000","2018-08-22 13:20:05"
"5254","93","20180822114727","Mobile","AAA04","2","16000","800","15200","2018-08-22 11:47:27"
"5255","81","20180822110622","Mobile","AAA05","2","120000","40000","80000","2018-08-22 11:06:22"
"5256","46","20180822100351","Mobile","AAA02","6","90000","13800","76200","2018-08-22 10:03:51"
"5257","7","20180821073218","Mobile","AAA01","7","70000","14000","56000","2018-08-21 19:32:18"
"5258","41","20180821045257","PC","AAA05","14","840000","280000","560000","2018-08-21 16:52:57"
"5259","49","20180821034417","PC","AAA01","10","100000","20000","80000","2018-08-21 15:44:17"
"5260","29","20180821025720","Shop","AAA01","10","100000","20000","80000","2018-08-21 14:57:20"
"5261","43","20180821022147","Shop","AAA04","9","72000","3600","68400","2018-08-21 14:21:47"
"5262","96","20180821122633","Shop","AAA04","3","24000","1200","22800","2018-08-21 12:26:33"
"5263","18","20180821111223","Shop","AAA04","7","56000","2800","53200","2018-08-21 11:12:23"
"5264","66","20180821080844","Shop","AAA02","1","15000","2300","12700","2018-08-21 08:08:44"
"5265","56","20180821073535","PC","AAA04","9","72000","3600","68400","2018-08-21 07:35:35"
"5266","4","20180820051910","PC","AAA04","3","24000","1200","22800","2018-08-20 17:19:10"
"5267","92","20180820042652","PC","AAA01","2","20000","4000","16000","2018-08-20 16:26:52"
"5268","54","20180820021126","PC","AAA02","8","120000","18400","101600","2018-08-20 14:11:26"
"5269","28","20180820125636","Shop","AAA04","4","32000","1600","30400","2018-08-20 12:56:36"
"5270","47","20180820115847","Mobile","AAA05","2","120000","40000","80000","2018-08-20 11:58:47"
"5271","82","20180820094239","PC","AAA04","1","8000","400","7600","2018-08-20 09:42:39"
"5272","81","20180816062129","Shop","AAA01","8","80000","16000","64000","2018-08-16 06:21:29"
"5273","89","20180815053050","Shop","AAA04","19","152000","7600","144400","2018-08-15 17:30:50"
"5274","80","20180815025314","PC","AAA04","2","16000","800","15200","2018-08-15 14:53:14"
"5275","33","20180815011131","Mobile","AAA04","1","8000","400","7600","2018-08-15 13:11:31"
"5276","3","20180815113257","Shop","AAA02","8","120000","18400","101600","2018-08-15 11:32:57"
"5277","37","20180815100736","Shop","AAA03","7","119000","21000","98000","2018-08-15 10:07:36"
"5278","48","20180815090751","Shop","AAA03","8","136000","24000","112000","2018-08-15 09:07:51"
"5279","95","20180815085132","Shop","AAA03","6","102000","18000","84000","2018-08-15 08:51:32"
"5280","57","20180815072311","Mobile","AAA04","5","40000","2000","38000","2018-08-15 07:23:11"
"5281","49","20180814083601","Shop","AAA05","7","420000","140000","280000","2018-08-14 20:36:01"
"5282","31","20180814030341","Mobile","AAA03","5","85000","15000","70000","2018-08-14 15:03:41"
"5283","3","20180814014343","PC","AAA03","14","238000","42000","196000","2018-08-14 13:43:43"
"5284","30","20180814125918","Shop","AAA01","14","140000","28000","112000","2018-08-14 12:59:18"
"5285","77","20180814102358","PC","AAA04","1","8000","400","7600","2018-08-14 10:23:58"
"5286","18","20180814083235","Shop","AAA02","8","120000","18400","101600","2018-08-14 08:32:35"
"5287","18","20180814063312","PC","AAA03","5","85000","15000","70000","2018-08-14 06:33:12"
"5288","98","20180813094411","Shop","AAA01","2","20000","4000","16000","2018-08-13 21:44:11"
"5289","7","20180813034002","Mobile","AAA01","4","40000","8000","32000","2018-08-13 15:40:02"
"5290","33","20180813023229","Mobile","AAA02","1","15000","2300","12700","2018-08-13 14:32:29"
"5291","51","20180813110518","PC","AAA02","6","90000","13800","76200","2018-08-13 11:05:18"
"5292","1","20180813094018","Mobile","AAA04","8","64000","3200","60800","2018-08-13 09:40:18"
"5293","40","20180809061644","PC","AAA01","3","30000","6000","24000","2018-08-09 18:16:44"
"5294","47","20180809024341","PC","AAA05","5","300000","100000","200000","2018-08-09 14:43:41"
"5295","91","20180809015451","PC","AAA02","1","15000","2300","12700","2018-08-09 13:54:51"
"5296","78","20180809121654","Mobile","AAA04","7","56000","2800","53200","2018-08-09 12:16:54"
"5297","77","20180809110435","Mobile","AAA02","9","135000","20700","114300","2018-08-09 11:04:35"
"5298","17","20180809091943","PC","AAA02","1","15000","2300","12700","2018-08-09 09:19:43"
"5299","12","20180809075503","PC","AAA04","7","56000","2800","53200","2018-08-09 07:55:03"
"5300","48","20180808065905","Shop","AAA03","6","102000","18000","84000","2018-08-08 18:59:05"
"5301","73","20180808032714","Mobile","AAA01","4","40000","8000","32000","2018-08-08 15:27:14"
"5302","4","20180808022026","Shop","AAA01","3","30000","6000","24000","2018-08-08 14:20:26"
"5303","15","20180808125024","Mobile","AAA05","6","360000","120000","240000","2018-08-08 12:50:24"
"5304","14","20180808113510","Shop","AAA03","4","68000","12000","56000","2018-08-08 11:35:10"
"5305","73","20180808101835","PC","AAA04","6","48000","2400","45600","2018-08-08 10:18:35"
"5306","59","20180808083725","Shop","AAA04","8","64000","3200","60800","2018-08-08 08:37:25"
"5307","17","20180808073039","Shop","AAA04","12","96000","4800","91200","2018-08-08 07:30:39"
"5308","95","20180807055141","PC","AAA05","8","480000","160000","320000","2018-08-07 17:51:41"
"5309","76","20180807045302","Mobile","AAA02","7","105000","16100","88900","2018-08-07 16:53:02"
"5310","18","20180807033033","Shop","AAA01","2","20000","4000","16000","2018-08-07 15:30:33"
"5311","59","20180807023811","Mobile","AAA01","4","40000","8000","32000","2018-08-07 14:38:11"
"5312","11","20180807014600","PC","AAA01","3","30000","6000","24000","2018-08-07 13:46:00"
"5313","77","20180807121722","PC","AAA05","2","120000","40000","80000","2018-08-07 12:17:22"
"5314","14","20180807112923","Mobile","AAA04","5","40000","2000","38000","2018-08-07 11:29:23"
"5315","31","20180807084406","Mobile","AAA03","4","68000","12000","56000","2018-08-07 08:44:06"
"5316","43","20180807071540","Shop","AAA03","12","204000","36000","168000","2018-08-07 07:15:40"
"5317","91","20180806060203","PC","AAA03","1","17000","3000","14000","2018-08-06 18:02:03"
"5318","30","20180806050525","PC","AAA04","4","32000","1600","30400","2018-08-06 17:05:25"
"5319","51","20180806033448","Mobile","AAA03","11","187000","33000","154000","2018-08-06 15:34:48"
"5320","33","20180806021550","PC","AAA03","3","51000","9000","42000","2018-08-06 14:15:50"
"5321","71","20180806124706","Shop","AAA03","1","17000","3000","14000","2018-08-06 12:47:06"
"5322","78","20180806114818","Mobile","AAA04","6","48000","2400","45600","2018-08-06 11:48:18"
"5323","4","20180806102213","PC","AAA05","3","180000","60000","120000","2018-08-06 10:22:13"
"5324","7","20180806091020","Mobile","AAA01","3","30000","6000","24000","2018-08-06 09:10:20"
"5325","11","20180802102727","Shop","AAA01","9","90000","18000","72000","2018-08-02 10:27:27"
"5326","68","20180802083216","PC","AAA02","5","75000","11500","63500","2018-08-02 08:32:16"
"5327","57","20180802071432","Mobile","AAA01","5","50000","10000","40000","2018-08-02 07:14:32"
"5328","77","20180801101752","PC","AAA01","3","30000","6000","24000","2018-08-01 22:17:52"
"5329","93","20180801091355","Shop","AAA03","6","102000","18000","84000","2018-08-01 21:13:55"
"5330","51","20180801050928","Mobile","AAA04","2","16000","800","15200","2018-08-01 17:09:28"
"5331","8","20180801035014","Mobile","AAA01","2","20000","4000","16000","2018-08-01 15:50:14"
"5332","84","20180801011251","Mobile","AAA02","3","45000","6900","38100","2018-08-01 13:12:51"
"5333","81","20180801115329","Shop","AAA02","5","75000","11500","63500","2018-08-01 11:53:29"
"5334","27","20180801101427","PC","AAA03","5","85000","15000","70000","2018-08-01 10:14:27"
"5335","25","20180801091200","PC","AAA04","8","64000","3200","60800","2018-08-01 09:12:00"
"5336","51","20180731094505","Shop","AAA05","16","960000","320000","640000","2018-07-31 21:45:05"
"5337","82","20180731080036","PC","AAA05","7","420000","140000","280000","2018-07-31 20:00:36"
"5338","73","20180731033440","Mobile","AAA04","3","24000","1200","22800","2018-07-31 15:34:40"
"5339","83","20180731105713","Mobile","AAA04","3","24000","1200","22800","2018-07-31 10:57:13"
"5340","95","20180731102349","Mobile","AAA04","2","16000","800","15200","2018-07-31 10:23:49"
"5341","28","20180731094541","Mobile","AAA04","6","48000","2400","45600","2018-07-31 09:45:41"
"5342","41","20180731021956","Mobile","AAA01","4","40000","8000","32000","2018-07-31 02:19:56"
"5343","76","20180730033147","PC","AAA01","10","100000","20000","80000","2018-07-30 15:31:47"
"5344","15","20180730021441","Shop","AAA03","3","51000","9000","42000","2018-07-30 14:14:41"
"5345","86","20180730123910","PC","AAA01","5","50000","10000","40000","2018-07-30 12:39:10"
"5346","52","20180730122647","PC","AAA04","2","16000","800","15200","2018-07-30 12:26:47"
"5347","50","20180730091734","Shop","AAA05","4","240000","80000","160000","2018-07-30 09:17:34"
"5348","3","20180728060955","Shop","AAA03","19","323000","57000","266000","2018-07-28 06:09:55"
"5349","84","20180727070550","Shop","AAA05","5","300000","100000","200000","2018-07-27 19:05:50"
"5350","61","20180727024039","Shop","AAA05","3","180000","60000","120000","2018-07-27 14:40:39"
"5351","67","20180727020005","PC","AAA02","8","120000","18400","101600","2018-07-27 14:00:05"
"5352","5","20180727125725","Shop","AAA02","5","75000","11500","63500","2018-07-27 12:57:25"
"5353","81","20180727121215","Mobile","AAA02","9","135000","20700","114300","2018-07-27 12:12:15"
"5354","16","20180727113324","PC","AAA03","5","85000","15000","70000","2018-07-27 11:33:24"
"5355","42","20180727092016","PC","AAA03","12","204000","36000","168000","2018-07-27 09:20:16"
"5356","23","20180727073742","Shop","AAA01","1","10000","2000","8000","2018-07-27 07:37:42"
"5357","24","20180726100718","Shop","AAA01","7","70000","14000","56000","2018-07-26 10:07:18"
"5358","81","20180726094116","Shop","AAA02","3","45000","6900","38100","2018-07-26 09:41:16"
"5359","43","20180726080520","PC","AAA05","8","480000","160000","320000","2018-07-26 08:05:20"
"5360","78","20180726063718","Shop","AAA01","1","10000","2000","8000","2018-07-26 06:37:18"
"5361","90","20180725062632","PC","AAA05","1","60000","20000","40000","2018-07-25 18:26:32"
"5362","29","20180725014507","Shop","AAA03","6","102000","18000","84000","2018-07-25 13:45:07"
"5363","55","20180725120747","Mobile","AAA05","10","600000","200000","400000","2018-07-25 12:07:47"
"5364","41","20180725093113","PC","AAA03","6","102000","18000","84000","2018-07-25 09:31:13"
"5365","49","20180725082222","PC","AAA01","2","20000","4000","16000","2018-07-25 08:22:22"
"5366","48","20180725065621","Mobile","AAA05","4","240000","80000","160000","2018-07-25 06:56:21"
"5367","79","20180724065047","Mobile","AAA01","5","50000","10000","40000","2018-07-24 18:50:47"
"5368","82","20180724121835","Shop","AAA01","4","40000","8000","32000","2018-07-24 12:18:35"
"5369","10","20180724105933","Mobile","AAA05","11","660000","220000","440000","2018-07-24 10:59:33"
"5370","3","20180724100256","PC","AAA02","12","180000","27600","152400","2018-07-24 10:02:56"
"5371","76","20180724082056","Mobile","AAA03","8","136000","24000","112000","2018-07-24 08:20:56"
"5372","30","20180724072040","Mobile","AAA01","1","10000","2000","8000","2018-07-24 07:20:40"
"5373","19","20180723111047","Shop","AAA03","2","34000","6000","28000","2018-07-23 23:10:47"
"5374","30","20180723093606","PC","AAA01","5","50000","10000","40000","2018-07-23 09:36:06"
"5375","6","20180719031157","Shop","AAA04","1","8000","400","7600","2018-07-19 03:11:57"
"5376","16","20180718084717","Mobile","AAA05","11","660000","220000","440000","2018-07-18 20:47:17"
"5377","76","20180718065014","PC","AAA05","8","480000","160000","320000","2018-07-18 18:50:14"
"5378","11","20180718044750","PC","AAA02","1","15000","2300","12700","2018-07-18 16:47:50"
"5379","43","20180718041620","PC","AAA01","16","160000","32000","128000","2018-07-18 16:16:20"
"5380","55","20180718025146","Mobile","AAA02","5","75000","11500","63500","2018-07-18 14:51:46"
"5381","27","20180718010823","Shop","AAA02","6","90000","13800","76200","2018-07-18 13:08:23"
"5382","100","20180718113303","PC","AAA03","1","17000","3000","14000","2018-07-18 11:33:03"
"5383","49","20180718085805","PC","AAA01","10","100000","20000","80000","2018-07-18 08:58:05"
"5384","68","20180718080305","Shop","AAA01","6","60000","12000","48000","2018-07-18 08:03:05"
"5385","10","20180718061918","Mobile","AAA04","8","64000","3200","60800","2018-07-18 06:19:18"
"5386","22","20180717022500","PC","AAA01","5","50000","10000","40000","2018-07-17 14:25:00"
"5387","32","20180717015605","Mobile","AAA05","4","240000","80000","160000","2018-07-17 13:56:05"
"5388","99","20180717114921","PC","AAA04","1","8000","400","7600","2018-07-17 11:49:21"
"5389","85","20180717103940","PC","AAA01","4","40000","8000","32000","2018-07-17 10:39:40"
"5390","73","20180717092434","Mobile","AAA01","6","60000","12000","48000","2018-07-17 09:24:34"
"5391","88","20180717081234","PC","AAA01","4","40000","8000","32000","2018-07-17 08:12:34"
"5392","68","20180716071448","PC","AAA01","10","100000","20000","80000","2018-07-16 19:14:48"
"5393","62","20180716023232","Shop","AAA02","11","165000","25300","139700","2018-07-16 14:32:32"
"5394","66","20180716010403","PC","AAA05","9","540000","180000","360000","2018-07-16 13:04:03"
"5395","25","20180716120559","Shop","AAA02","2","30000","4600","25400","2018-07-16 12:05:59"
"5396","23","20180716105031","PC","AAA05","10","600000","200000","400000","2018-07-16 10:50:31"
"5397","84","20180716095254","Mobile","AAA01","5","50000","10000","40000","2018-07-16 09:52:54"
"5398","20","20180713021225","PC","AAA01","2","20000","4000","16000","2018-07-13 02:12:25"
"5399","22","20180712022842","Shop","AAA04","4","32000","1600","30400","2018-07-12 14:28:42"
"5400","94","20180712011138","Shop","AAA01","12","120000","24000","96000","2018-07-12 13:11:38"
"5401","9","20180712120401","Shop","AAA04","1","8000","400","7600","2018-07-12 12:04:01"
"5402","4","20180712095510","PC","AAA02","7","105000","16100","88900","2018-07-12 09:55:10"
"5403","68","20180712082442","Mobile","AAA02","2","30000","4600","25400","2018-07-12 08:24:42"
"5404","31","20180712071854","Mobile","AAA02","4","60000","9200","50800","2018-07-12 07:18:54"
"5405","84","20180711045207","Mobile","AAA02","2","30000","4600","25400","2018-07-11 16:52:07"
"5406","23","20180711032412","Shop","AAA04","1","8000","400","7600","2018-07-11 15:24:12"
"5407","90","20180711015639","PC","AAA05","2","120000","40000","80000","2018-07-11 13:56:39"
"5408","52","20180711123855","Mobile","AAA03","5","85000","15000","70000","2018-07-11 12:38:55"
"5409","26","20180711111839","PC","AAA05","5","300000","100000","200000","2018-07-11 11:18:39"
"5410","22","20180711095401","Shop","AAA01","1","10000","2000","8000","2018-07-11 09:54:01"
"5411","71","20180711084407","PC","AAA04","5","40000","2000","38000","2018-07-11 08:44:07"
"5412","61","20180710040136","Shop","AAA01","2","20000","4000","16000","2018-07-10 16:01:36"
"5413","21","20180710025713","Mobile","AAA03","10","170000","30000","140000","2018-07-10 14:57:13"
"5414","1","20180710014112","PC","AAA04","2","16000","800","15200","2018-07-10 13:41:12"
"5415","18","20180710120931","Mobile","AAA04","4","32000","1600","30400","2018-07-10 12:09:31"
"5416","30","20180710111220","PC","AAA01","7","70000","14000","56000","2018-07-10 11:12:20"
"5417","20","20180710104204","Shop","AAA05","3","180000","60000","120000","2018-07-10 10:42:04"
"5418","6","20180710093747","PC","AAA03","2","34000","6000","28000","2018-07-10 09:37:47"
"5419","11","20180710081424","PC","AAA03","7","119000","21000","98000","2018-07-10 08:14:24"
"5420","26","20180710070331","Mobile","AAA05","2","120000","40000","80000","2018-07-10 07:03:31"
"5421","49","20180710042347","Shop","AAA02","5","75000","11500","63500","2018-07-10 04:23:47"
"5422","71","20180709035539","Mobile","AAA03","11","187000","33000","154000","2018-07-09 15:55:39"
"5423","75","20180709020827","PC","AAA04","4","32000","1600","30400","2018-07-09 14:08:27"
"5424","23","20180709123803","Mobile","AAA04","5","40000","2000","38000","2018-07-09 12:38:03"
"5425","55","20180709112227","Mobile","AAA03","13","221000","39000","182000","2018-07-09 11:22:27"
"5426","33","20180709101927","Shop","AAA05","1","60000","20000","40000","2018-07-09 10:19:27"
"5427","39","20180709094046","Mobile","AAA02","4","60000","9200","50800","2018-07-09 09:40:46"
"5428","64","20180706010542","PC","AAA03","10","170000","30000","140000","2018-07-06 01:05:42"
"5429","50","20180705054800","PC","AAA01","3","30000","6000","24000","2018-07-05 05:48:00"
"5430","74","20180704071538","PC","AAA01","4","40000","8000","32000","2018-07-04 19:15:38"
"5431","92","20180704014837","PC","AAA02","10","150000","23000","127000","2018-07-04 13:48:37"
"5432","65","20180704010640","Shop","AAA02","4","60000","9200","50800","2018-07-04 13:06:40"
"5433","40","20180704113627","PC","AAA02","6","90000","13800","76200","2018-07-04 11:36:27"
"5434","96","20180704102202","Mobile","AAA02","10","150000","23000","127000","2018-07-04 10:22:02"
"5435","69","20180704091105","PC","AAA05","9","540000","180000","360000","2018-07-04 09:11:05"
"5436","58","20180704074025","PC","AAA05","11","660000","220000","440000","2018-07-04 07:40:25"
"5437","17","20180703065147","Shop","AAA03","6","102000","18000","84000","2018-07-03 18:51:47"
"5438","14","20180703035501","PC","AAA01","8","80000","16000","64000","2018-07-03 15:55:01"
"5439","9","20180703011859","PC","AAA02","2","30000","4600","25400","2018-07-03 13:18:59"
"5440","62","20180703110851","Mobile","AAA02","4","60000","9200","50800","2018-07-03 11:08:51"
"5441","41","20180703074441","Mobile","AAA05","7","420000","140000","280000","2018-07-03 07:44:41"
"5442","7","20180702101154","Shop","AAA03","4","68000","12000","56000","2018-07-02 22:11:54"
"5443","8","20180702052029","PC","AAA04","8","64000","3200","60800","2018-07-02 17:20:29"
"5444","7","20180702043322","PC","AAA01","9","90000","18000","72000","2018-07-02 16:33:22"
"5445","92","20180702033154","Mobile","AAA02","9","135000","20700","114300","2018-07-02 15:31:54"
"5446","28","20180702022236","PC","AAA02","13","195000","29900","165100","2018-07-02 14:22:36"
"5447","80","20180702120638","PC","AAA05","2","120000","40000","80000","2018-07-02 12:06:38"
"5448","1","20180702112151","PC","AAA04","10","80000","4000","76000","2018-07-02 11:21:51"
"5449","31","20180702093801","Shop","AAA03","3","51000","9000","42000","2018-07-02 09:38:01"
"5450","85","20180630020854","Mobile","AAA04","10","80000","4000","76000","2018-06-30 02:08:54"
"5451","22","20180629102945","Mobile","AAA01","3","30000","6000","24000","2018-06-29 10:29:45"
"5452","5","20180629090232","Mobile","AAA02","12","180000","27600","152400","2018-06-29 09:02:32"
"5453","64","20180629074010","PC","AAA01","10","100000","20000","80000","2018-06-29 07:40:10"
"5454","20","20180628072444","PC","AAA03","1","17000","3000","14000","2018-06-28 19:24:44"
"5455","34","20180628052618","PC","AAA05","5","300000","100000","200000","2018-06-28 17:26:18"
"5456","55","20180628034556","PC","AAA03","7","119000","21000","98000","2018-06-28 15:45:56"
"5457","8","20180628012100","Shop","AAA01","7","70000","14000","56000","2018-06-28 13:21:00"
"5458","63","20180628010201","Mobile","AAA03","3","51000","9000","42000","2018-06-28 13:02:01"
"5459","1","20180628115830","Mobile","AAA03","13","221000","39000","182000","2018-06-28 11:58:30"
"5460","95","20180628105701","Shop","AAA03","5","85000","15000","70000","2018-06-28 10:57:01"
"5461","50","20180628085643","Shop","AAA02","5","75000","11500","63500","2018-06-28 08:56:43"
"5462","95","20180628080849","Shop","AAA02","1","15000","2300","12700","2018-06-28 08:08:49"
"5463","46","20180628071422","PC","AAA01","6","60000","12000","48000","2018-06-28 07:14:22"
"5464","17","20180627073502","PC","AAA05","9","540000","180000","360000","2018-06-27 19:35:02"
"5465","28","20180627023802","Mobile","AAA04","9","72000","3600","68400","2018-06-27 14:38:02"
"5466","17","20180627102822","PC","AAA05","1","60000","20000","40000","2018-06-27 10:28:22"
"5467","16","20180627090417","Mobile","AAA01","17","170000","34000","136000","2018-06-27 09:04:17"
"5468","94","20180626064041","PC","AAA05","9","540000","180000","360000","2018-06-26 18:40:41"
"5469","72","20180626032646","PC","AAA05","4","240000","80000","160000","2018-06-26 15:26:46"
"5470","100","20180626020727","PC","AAA02","4","60000","9200","50800","2018-06-26 14:07:27"
"5471","4","20180626123001","Mobile","AAA04","1","8000","400","7600","2018-06-26 12:30:01"
"5472","26","20180626100437","PC","AAA01","1","10000","2000","8000","2018-06-26 10:04:37"
"5473","59","20180626085910","Shop","AAA01","3","30000","6000","24000","2018-06-26 08:59:10"
"5474","64","20180626072302","Mobile","AAA04","4","32000","1600","30400","2018-06-26 07:23:02"
"5475","20","20180625030544","Mobile","AAA02","2","30000","4600","25400","2018-06-25 15:05:44"
"5476","52","20180625014938","Shop","AAA04","8","64000","3200","60800","2018-06-25 13:49:38"
"5477","85","20180625111718","Shop","AAA04","1","8000","400","7600","2018-06-25 11:17:18"
"5478","86","20180625095549","Mobile","AAA02","1","15000","2300","12700","2018-06-25 09:55:49"
"5479","84","20180621072643","Mobile","AAA05","7","420000","140000","280000","2018-06-21 19:26:43"
"5480","38","20180621052155","Mobile","AAA05","6","360000","120000","240000","2018-06-21 17:21:55"
"5481","94","20180621035006","Mobile","AAA03","8","136000","24000","112000","2018-06-21 15:50:06"
"5482","25","20180621024802","Mobile","AAA03","18","306000","54000","252000","2018-06-21 14:48:02"
"5483","77","20180621013537","PC","AAA04","1","8000","400","7600","2018-06-21 13:35:37"
"5484","17","20180621112601","Shop","AAA04","7","56000","2800","53200","2018-06-21 11:26:01"
"5485","15","20180621093104","Shop","AAA05","4","240000","80000","160000","2018-06-21 09:31:04"
"5486","49","20180621075604","Shop","AAA01","16","160000","32000","128000","2018-06-21 07:56:04"
"5487","20","20180620084025","PC","AAA05","1","60000","20000","40000","2018-06-20 20:40:25"
"5488","72","20180620122339","PC","AAA03","4","68000","12000","56000","2018-06-20 12:23:39"
"5489","98","20180620113638","Shop","AAA01","4","40000","8000","32000","2018-06-20 11:36:38"
"5490","93","20180620102700","PC","AAA04","7","56000","2800","53200","2018-06-20 10:27:00"
"5491","55","20180620094350","PC","AAA02","1","15000","2300","12700","2018-06-20 09:43:50"
"5492","53","20180620074618","Shop","AAA03","4","68000","12000","56000","2018-06-20 07:46:18"
"5493","40","20180619111303","Mobile","AAA03","1","17000","3000","14000","2018-06-19 23:13:03"
"5494","4","20180619060839","Mobile","AAA05","2","120000","40000","80000","2018-06-19 18:08:39"
"5495","62","20180619125059","Mobile","AAA03","17","289000","51000","238000","2018-06-19 12:50:59"
"5496","69","20180619115111","PC","AAA04","4","32000","1600","30400","2018-06-19 11:51:11"
"5497","15","20180619091321","Mobile","AAA04","20","160000","8000","152000","2018-06-19 09:13:21"
"5498","83","20180619083348","Mobile","AAA02","9","135000","20700","114300","2018-06-19 08:33:48"
"5499","67","20180619070429","Shop","AAA04","1","8000","400","7600","2018-06-19 07:04:29"
"5500","92","20180618112950","PC","AAA03","10","170000","30000","140000","2018-06-18 23:29:50"
"5501","20","20180618125051","PC","AAA03","4","68000","12000","56000","2018-06-18 12:50:51"
"5502","84","20180618114007","Shop","AAA02","3","45000","6900","38100","2018-06-18 11:40:07"
"5503","82","20180617112305","Shop","AAA03","8","136000","24000","112000","2018-06-17 23:23:05"
"5504","49","20180615013127","Shop","AAA04","6","48000","2400","45600","2018-06-15 01:31:27"
"5505","82","20180614115710","Mobile","AAA04","1","8000","400","7600","2018-06-14 11:57:10"
"5506","71","20180614102059","Shop","AAA01","10","100000","20000","80000","2018-06-14 10:20:59"
"5507","40","20180614090952","PC","AAA05","2","120000","40000","80000","2018-06-14 09:09:52"
"5508","50","20180614072804","PC","AAA05","3","180000","60000","120000","2018-06-14 07:28:04"
"5509","32","20180613071112","PC","AAA01","12","120000","24000","96000","2018-06-13 19:11:12"
"5510","84","20180613033658","Shop","AAA01","3","30000","6000","24000","2018-06-13 15:36:58"
"5511","77","20180613125437","Mobile","AAA03","2","34000","6000","28000","2018-06-13 12:54:37"
"5512","73","20180613114108","PC","AAA01","7","70000","14000","56000","2018-06-13 11:41:08"
"5513","13","20180613102925","Shop","AAA02","4","60000","9200","50800","2018-06-13 10:29:25"
"5514","95","20180613091107","Shop","AAA03","6","102000","18000","84000","2018-06-13 09:11:07"
"5515","97","20180613074855","PC","AAA01","9","90000","18000","72000","2018-06-13 07:48:55"
"5516","59","20180612014240","Mobile","AAA02","3","45000","6900","38100","2018-06-12 13:42:40"
"5517","64","20180612125018","PC","AAA04","6","48000","2400","45600","2018-06-12 12:50:18"
"5518","66","20180612112542","Mobile","AAA01","11","110000","22000","88000","2018-06-12 11:25:42"
"5519","80","20180612103252","PC","AAA01","9","90000","18000","72000","2018-06-12 10:32:52"
"5520","86","20180612085203","PC","AAA01","3","30000","6000","24000","2018-06-12 08:52:03"
"5521","92","20180612072651","Shop","AAA04","8","64000","3200","60800","2018-06-12 07:26:51"
"5522","48","20180611075953","PC","AAA03","2","34000","6000","28000","2018-06-11 19:59:53"
"5523","65","20180611044033","Mobile","AAA04","16","128000","6400","121600","2018-06-11 16:40:33"
"5524","6","20180611032251","Shop","AAA02","3","45000","6900","38100","2018-06-11 15:22:51"
"5525","26","20180611120502","Shop","AAA03","2","34000","6000","28000","2018-06-11 12:05:02"
"5526","89","20180611095413","Shop","AAA03","18","306000","54000","252000","2018-06-11 09:54:13"
"5527","6","20180609081044","PC","AAA03","2","34000","6000","28000","2018-06-09 08:10:44"
"5528","97","20180608113451","Shop","AAA05","6","360000","120000","240000","2018-06-08 11:34:51"
"5529","30","20180608105347","Mobile","AAA04","4","32000","1600","30400","2018-06-08 10:53:47"
"5530","14","20180608075139","PC","AAA03","4","68000","12000","56000","2018-06-08 07:51:39"
"5531","98","20180607071729","PC","AAA03","5","85000","15000","70000","2018-06-07 19:17:29"
"5532","6","20180607020554","Shop","AAA03","3","51000","9000","42000","2018-06-07 14:05:54"
"5533","80","20180607125313","Shop","AAA03","12","204000","36000","168000","2018-06-07 12:53:13"
"5534","51","20180607103428","Shop","AAA04","10","80000","4000","76000","2018-06-07 10:34:28"
"5535","28","20180607093650","Shop","AAA04","12","96000","4800","91200","2018-06-07 09:36:50"
"5536","13","20180607071332","PC","AAA03","12","204000","36000","168000","2018-06-07 07:13:32"
"5537","43","20180606024514","Shop","AAA01","8","80000","16000","64000","2018-06-06 14:45:14"
"5538","3","20180606010102","PC","AAA05","16","960000","320000","640000","2018-06-06 13:01:02"
"5539","53","20180606120252","Shop","AAA03","6","102000","18000","84000","2018-06-06 12:02:52"
"5540","76","20180606110523","PC","AAA04","9","72000","3600","68400","2018-06-06 11:05:23"
"5541","6","20180606075251","Shop","AAA05","1","60000","20000","40000","2018-06-06 07:52:51"
"5542","25","20180605021106","Mobile","AAA03","12","204000","36000","168000","2018-06-05 14:11:06"
"5543","71","20180605123652","Mobile","AAA01","2","20000","4000","16000","2018-06-05 12:36:52"
"5544","38","20180605113540","Mobile","AAA02","7","105000","16100","88900","2018-06-05 11:35:40"
"5545","27","20180605095515","PC","AAA05","6","360000","120000","240000","2018-06-05 09:55:15"
"5546","42","20180605084823","PC","AAA01","5","50000","10000","40000","2018-06-05 08:48:23"
"5547","39","20180605071139","Shop","AAA03","8","136000","24000","112000","2018-06-05 07:11:39"
"5548","21","20180604032310","Mobile","AAA04","3","24000","1200","22800","2018-06-04 15:23:10"
"5549","13","20180604022722","PC","AAA05","2","120000","40000","80000","2018-06-04 14:27:22"
"5550","72","20180604125045","PC","AAA04","10","80000","4000","76000","2018-06-04 12:50:45"
"5551","34","20180604115003","PC","AAA01","7","70000","14000","56000","2018-06-04 11:50:03"
"5552","58","20180604094011","Shop","AAA03","2","34000","6000","28000","2018-06-04 09:40:11"
"5553","2","20180531092814","PC","AAA05","5","300000","100000","200000","2018-05-31 21:28:14"
"5554","92","20180531044222","Shop","AAA03","10","170000","30000","140000","2018-05-31 16:42:22"
"5555","83","20180531034214","Mobile","AAA03","13","221000","39000","182000","2018-05-31 15:42:14"
"5556","97","20180531021007","PC","AAA03","10","170000","30000","140000","2018-05-31 14:10:07"
"5557","8","20180531123427","Shop","AAA02","4","60000","9200","50800","2018-05-31 12:34:27"
"5558","71","20180531110610","PC","AAA02","6","90000","13800","76200","2018-05-31 11:06:10"
"5559","48","20180531093026","Shop","AAA05","5","300000","100000","200000","2018-05-31 09:30:26"
"5560","55","20180531090317","PC","AAA05","6","360000","120000","240000","2018-05-31 09:03:17"
"5561","64","20180531073539","PC","AAA04","7","56000","2800","53200","2018-05-31 07:35:39"
"5562","13","20180531023906","Shop","AAA04","12","96000","4800","91200","2018-05-31 02:39:06"
"5563","85","20180530115246","Mobile","AAA01","9","90000","18000","72000","2018-05-30 11:52:46"
"5564","34","20180530103103","Shop","AAA03","12","204000","36000","168000","2018-05-30 10:31:03"
"5565","63","20180530093327","Mobile","AAA01","4","40000","8000","32000","2018-05-30 09:33:27"
"5566","13","20180530065037","PC","AAA01","1","10000","2000","8000","2018-05-30 06:50:37"
"5567","90","20180529110113","Mobile","AAA01","2","20000","4000","16000","2018-05-29 23:01:13"
"5568","54","20180529073658","Mobile","AAA04","10","80000","4000","76000","2018-05-29 07:36:58"
"5569","50","20180528085402","Mobile","AAA04","1","8000","400","7600","2018-05-28 20:54:02"
"5570","57","20180528040153","Mobile","AAA03","7","119000","21000","98000","2018-05-28 16:01:53"
"5571","38","20180528015003","Mobile","AAA02","9","135000","20700","114300","2018-05-28 13:50:03"
"5572","72","20180528124750","Mobile","AAA05","3","180000","60000","120000","2018-05-28 12:47:50"
"5573","27","20180528104407","Shop","AAA04","10","80000","4000","76000","2018-05-28 10:44:07"
"5574","54","20180524095337","PC","AAA01","1","10000","2000","8000","2018-05-24 21:53:37"
"5575","66","20180524054630","Mobile","AAA03","5","85000","15000","70000","2018-05-24 17:46:30"
"5576","15","20180524042846","PC","AAA03","6","102000","18000","84000","2018-05-24 16:28:46"
"5577","39","20180524031247","PC","AAA05","7","420000","140000","280000","2018-05-24 15:12:47"
"5578","57","20180524122514","Shop","AAA02","7","105000","16100","88900","2018-05-24 12:25:14"
"5579","81","20180524110238","Mobile","AAA01","9","90000","18000","72000","2018-05-24 11:02:38"
"5580","80","20180524095558","Shop","AAA04","1","8000","400","7600","2018-05-24 09:55:58"
"5581","36","20180524091038","PC","AAA03","9","153000","27000","126000","2018-05-24 09:10:38"
"5582","47","20180524080500","Mobile","AAA02","9","135000","20700","114300","2018-05-24 08:05:00"
"5583","41","20180524062641","Mobile","AAA03","12","204000","36000","168000","2018-05-24 06:26:41"
"5584","59","20180523042145","Mobile","AAA01","8","80000","16000","64000","2018-05-23 16:21:45"
"5585","4","20180523021015","Mobile","AAA04","2","16000","800","15200","2018-05-23 14:10:15"
"5586","49","20180523011753","Shop","AAA05","15","900000","300000","600000","2018-05-23 13:17:53"
"5587","22","20180523123500","Shop","AAA05","11","660000","220000","440000","2018-05-23 12:35:00"
"5588","18","20180523114432","Mobile","AAA02","1","15000","2300","12700","2018-05-23 11:44:32"
"5589","60","20180523100836","PC","AAA05","1","60000","20000","40000","2018-05-23 10:08:36"
"5590","19","20180523090435","Shop","AAA04","3","24000","1200","22800","2018-05-23 09:04:35"
"5591","30","20180523081806","Shop","AAA05","4","240000","80000","160000","2018-05-23 08:18:06"
"5592","40","20180523074257","Shop","AAA04","9","72000","3600","68400","2018-05-23 07:42:57"
"5593","27","20180522045414","Mobile","AAA02","9","135000","20700","114300","2018-05-22 16:54:14"
"5594","43","20180522040615","PC","AAA05","5","300000","100000","200000","2018-05-22 16:06:15"
"5595","8","20180522010408","Mobile","AAA02","9","135000","20700","114300","2018-05-22 13:04:08"
"5596","25","20180522120151","Mobile","AAA01","6","60000","12000","48000","2018-05-22 12:01:51"
"5597","92","20180522112411","PC","AAA02","9","135000","20700","114300","2018-05-22 11:24:11"
"5598","71","20180522104412","PC","AAA02","8","120000","18400","101600","2018-05-22 10:44:12"
"5599","37","20180522081105","Mobile","AAA03","9","153000","27000","126000","2018-05-22 08:11:05"
"5600","17","20180522071343","Shop","AAA05","8","480000","160000","320000","2018-05-22 07:13:43"
"5601","23","20180521035916","Mobile","AAA05","12","720000","240000","480000","2018-05-21 15:59:16"
"5602","3","20180521025356","Shop","AAA01","23","230000","46000","184000","2018-05-21 14:53:56"
"5603","14","20180521014336","Shop","AAA01","9","90000","18000","72000","2018-05-21 13:43:36"
"5604","67","20180521010804","Shop","AAA04","5","40000","2000","38000","2018-05-21 13:08:04"
"5605","84","20180521102235","Shop","AAA05","5","300000","100000","200000","2018-05-21 10:22:35"
"5606","27","20180521091154","Shop","AAA01","5","50000","10000","40000","2018-05-21 09:11:54"
"5607","22","20180518011728","Shop","AAA01","2","20000","4000","16000","2018-05-18 13:17:28"
"5608","6","20180518113450","Mobile","AAA05","2","120000","40000","80000","2018-05-18 11:34:50"
"5609","97","20180518103631","Shop","AAA02","13","195000","29900","165100","2018-05-18 10:36:31"
"5610","27","20180518092008","Shop","AAA01","10","100000","20000","80000","2018-05-18 09:20:08"
"5611","58","20180518072909","PC","AAA03","4","68000","12000","56000","2018-05-18 07:29:09"
"5612","21","20180517094441","PC","AAA02","13","195000","29900","165100","2018-05-17 21:44:41"
"5613","2","20180517084441","Mobile","AAA01","6","60000","12000","48000","2018-05-17 20:44:41"
"5614","45","20180517050846","PC","AAA01","2","20000","4000","16000","2018-05-17 17:08:46"
"5615","26","20180517034120","Mobile","AAA05","1","60000","20000","40000","2018-05-17 15:41:20"
"5616","20","20180517012610","PC","AAA03","6","102000","18000","84000","2018-05-17 13:26:10"
"5617","40","20180517112803","PC","AAA05","3","180000","60000","120000","2018-05-17 11:28:03"
"5618","50","20180517094855","Mobile","AAA01","11","110000","22000","88000","2018-05-17 09:48:55"
"5619","50","20180517073901","Shop","AAA01","13","130000","26000","104000","2018-05-17 07:39:01"
"5620","83","20180516025836","PC","AAA04","20","160000","8000","152000","2018-05-16 14:58:36"
"5621","37","20180516021138","PC","AAA05","16","960000","320000","640000","2018-05-16 14:11:38"
"5622","32","20180516123701","PC","AAA02","6","90000","13800","76200","2018-05-16 12:37:01"
"5623","83","20180516111045","Shop","AAA03","14","238000","42000","196000","2018-05-16 11:10:45"
"5624","72","20180516095113","Shop","AAA03","12","204000","36000","168000","2018-05-16 09:51:13"
"5625","73","20180516083242","PC","AAA05","9","540000","180000","360000","2018-05-16 08:32:42"
"5626","68","20180516071348","PC","AAA05","5","300000","100000","200000","2018-05-16 07:13:48"
"5627","58","20180515081858","Mobile","AAA03","9","153000","27000","126000","2018-05-15 20:18:58"
"5628","38","20180515041936","Mobile","AAA01","7","70000","14000","56000","2018-05-15 16:19:36"
"5629","32","20180515032727","Mobile","AAA02","4","60000","9200","50800","2018-05-15 15:27:27"
"5630","97","20180515015710","Shop","AAA03","9","153000","27000","126000","2018-05-15 13:57:10"
"5631","7","20180515123043","PC","AAA05","11","660000","220000","440000","2018-05-15 12:30:43"
"5632","33","20180515105256","Shop","AAA01","6","60000","12000","48000","2018-05-15 10:52:56"
"5633","1","20180515093052","PC","AAA01","3","30000","6000","24000","2018-05-15 09:30:52"
"5634","32","20180515082003","Mobile","AAA03","9","153000","27000","126000","2018-05-15 08:20:03"
"5635","17","20180515065101","Shop","AAA01","2","20000","4000","16000","2018-05-15 06:51:01"
"5636","92","20180514065413","Shop","AAA02","4","60000","9200","50800","2018-05-14 18:54:13"
"5637","94","20180514032009","PC","AAA01","1","10000","2000","8000","2018-05-14 15:20:09"
"5638","37","20180514023337","Mobile","AAA03","14","238000","42000","196000","2018-05-14 14:33:37"
"5639","76","20180514012328","Shop","AAA02","8","120000","18400","101600","2018-05-14 13:23:28"
"5640","2","20180514121050","Shop","AAA05","4","240000","80000","160000","2018-05-14 12:10:50"
"5641","5","20180514105354","Mobile","AAA04","6","48000","2400","45600","2018-05-14 10:53:54"
"5642","54","20180514092738","Mobile","AAA01","7","70000","14000","56000","2018-05-14 09:27:38"
"5643","49","20180512091525","Mobile","AAA04","2","16000","800","15200","2018-05-12 09:15:25"
"5644","62","20180511082926","PC","AAA01","5","50000","10000","40000","2018-05-11 20:29:26"
"5645","9","20180511034028","Mobile","AAA03","2","34000","6000","28000","2018-05-11 15:40:28"
"5646","25","20180511024040","Shop","AAA01","3","30000","6000","24000","2018-05-11 14:40:40"
"5647","82","20180511012615","Shop","AAA02","7","105000","16100","88900","2018-05-11 13:26:15"
"5648","82","20180511114854","Shop","AAA01","5","50000","10000","40000","2018-05-11 11:48:54"
"5649","74","20180511092527","PC","AAA01","4","40000","8000","32000","2018-05-11 09:25:27"
"5650","91","20180511075116","Mobile","AAA01","2","20000","4000","16000","2018-05-11 07:51:16"
"5651","31","20180511010351","PC","AAA03","3","51000","9000","42000","2018-05-11 01:03:51"
"5652","63","20180510064223","Mobile","AAA02","7","105000","16100","88900","2018-05-10 06:42:23"
"5653","70","20180510044723","PC","AAA04","11","88000","4400","83600","2018-05-10 04:47:23"
"5654","6","20180509024358","Shop","AAA02","6","90000","13800","76200","2018-05-09 14:43:58"
"5655","70","20180509011939","Mobile","AAA02","14","210000","32200","177800","2018-05-09 13:19:39"
"5656","99","20180509123451","Mobile","AAA05","5","300000","100000","200000","2018-05-09 12:34:51"
"5657","32","20180509111424","Shop","AAA03","10","170000","30000","140000","2018-05-09 11:14:24"
"5658","98","20180509093102","Mobile","AAA05","1","60000","20000","40000","2018-05-09 09:31:02"
"5659","19","20180509083535","Shop","AAA05","1","60000","20000","40000","2018-05-09 08:35:35"
"5660","50","20180509072327","Shop","AAA04","4","32000","1600","30400","2018-05-09 07:23:27"
"5661","96","20180508115710","PC","AAA01","3","30000","6000","24000","2018-05-08 11:57:10"
"5662","13","20180508103156","Shop","AAA05","4","240000","80000","160000","2018-05-08 10:31:56"
"5663","16","20180508083735","PC","AAA02","13","195000","29900","165100","2018-05-08 08:37:35"
"5664","22","20180508071628","Mobile","AAA01","2","20000","4000","16000","2018-05-08 07:16:28"
"5665","1","20180507112152","Shop","AAA05","5","300000","100000","200000","2018-05-07 23:21:52"
"5666","78","20180507093842","Mobile","AAA04","5","40000","2000","38000","2018-05-07 09:38:42"
"5667","62","20180503010302","Shop","AAA02","12","180000","27600","152400","2018-05-03 13:03:02"
"5668","88","20180503113755","Shop","AAA01","2","20000","4000","16000","2018-05-03 11:37:55"
"5669","65","20180503095639","Mobile","AAA03","10","170000","30000","140000","2018-05-03 09:56:39"
"5670","34","20180503084114","Shop","AAA02","20","300000","46000","254000","2018-05-03 08:41:14"
"5671","85","20180503065530","PC","AAA01","5","50000","10000","40000","2018-05-03 06:55:30"
"5672","28","20180502081522","PC","AAA02","10","150000","23000","127000","2018-05-02 20:15:22"
"5673","81","20180502044346","Shop","AAA02","2","30000","4600","25400","2018-05-02 16:43:46"
"5674","23","20180502034638","PC","AAA02","5","75000","11500","63500","2018-05-02 15:46:38"
"5675","6","20180502012247","Shop","AAA03","4","68000","12000","56000","2018-05-02 13:22:47"
"5676","8","20180502115222","PC","AAA02","11","165000","25300","139700","2018-05-02 11:52:22"
"5677","76","20180502105204","PC","AAA05","7","420000","140000","280000","2018-05-02 10:52:04"
"5678","37","20180502094446","Mobile","AAA05","3","180000","60000","120000","2018-05-02 09:44:46"
"5679","76","20180502125628","Mobile","AAA04","7","56000","2800","53200","2018-05-02 00:56:28"
"5680","45","20180501095559","PC","AAA05","5","300000","100000","200000","2018-05-01 09:55:59"
"5681","42","20180501074709","PC","AAA03","9","153000","27000","126000","2018-05-01 07:47:09"
"5682","55","20180430094608","PC","AAA05","7","420000","140000","280000","2018-04-30 21:46:08"
"5683","82","20180430064658","Shop","AAA05","6","360000","120000","240000","2018-04-30 18:46:58"
"5684","19","20180430013337","Mobile","AAA02","1","15000","2300","12700","2018-04-30 13:33:37"
"5685","41","20180430123037","Shop","AAA03","8","136000","24000","112000","2018-04-30 12:30:37"
"5686","76","20180430111845","Shop","AAA02","1","15000","2300","12700","2018-04-30 11:18:45"
"5687","99","20180430103729","Mobile","AAA03","3","51000","9000","42000","2018-04-30 10:37:29"
"5688","21","20180430090319","PC","AAA04","7","56000","2800","53200","2018-04-30 09:03:19"
"5689","69","20180428032715","Shop","AAA01","3","30000","6000","24000","2018-04-28 15:27:15"
"5690","92","20180426021158","Shop","AAA01","5","50000","10000","40000","2018-04-26 14:11:58"
"5691","55","20180426124828","PC","AAA04","13","104000","5200","98800","2018-04-26 12:48:28"
"5692","53","20180426091005","Mobile","AAA03","2","34000","6000","28000","2018-04-26 09:10:05"
"5693","26","20180426070327","Shop","AAA03","3","51000","9000","42000","2018-04-26 07:03:27"
"5694","99","20180425125907","Mobile","AAA03","3","51000","9000","42000","2018-04-25 12:59:07"
"5695","56","20180425095250","PC","AAA04","7","56000","2800","53200","2018-04-25 09:52:50"
"5696","55","20180425085059","Shop","AAA02","5","75000","11500","63500","2018-04-25 08:50:59"
"5697","92","20180425070819","Mobile","AAA01","13","130000","26000","104000","2018-04-25 07:08:19"
"5698","94","20180424100950","Shop","AAA05","9","540000","180000","360000","2018-04-24 22:09:50"
"5699","28","20180424034649","PC","AAA05","4","240000","80000","160000","2018-04-24 15:46:49"
"5700","85","20180424025812","PC","AAA03","7","119000","21000","98000","2018-04-24 14:58:12"
"5701","65","20180424010824","PC","AAA01","12","120000","24000","96000","2018-04-24 13:08:24"
"5702","47","20180424120833","PC","AAA03","10","170000","30000","140000","2018-04-24 12:08:33"
"5703","90","20180424110202","Shop","AAA01","1","10000","2000","8000","2018-04-24 11:02:02"
"5704","68","20180424102106","Shop","AAA05","8","480000","160000","320000","2018-04-24 10:21:06"
"5705","55","20180424081943","PC","AAA04","3","24000","1200","22800","2018-04-24 08:19:43"
"5706","24","20180424070150","Mobile","AAA04","7","56000","2800","53200","2018-04-24 07:01:50"
"5707","79","20180423031015","Mobile","AAA04","2","16000","800","15200","2018-04-23 15:10:15"
"5708","42","20180423015815","Shop","AAA02","2","30000","4600","25400","2018-04-23 13:58:15"
"5709","17","20180423012010","PC","AAA03","13","221000","39000","182000","2018-04-23 13:20:10"
"5710","80","20180423120017","Mobile","AAA01","11","110000","22000","88000","2018-04-23 12:00:17"
"5711","62","20180423104708","Shop","AAA04","14","112000","5600","106400","2018-04-23 10:47:08"
"5712","18","20180423085324","Shop","AAA04","1","8000","400","7600","2018-04-23 08:53:24"
"5713","34","20180418120902","Mobile","AAA05","1","60000","20000","40000","2018-04-18 00:09:02"
"5714","7","20180417015626","Shop","AAA05","11","660000","220000","440000","2018-04-17 13:56:26"
"5715","89","20180417010306","PC","AAA03","9","153000","27000","126000","2018-04-17 13:03:06"
"5716","50","20180417122355","PC","AAA04","11","88000","4400","83600","2018-04-17 12:23:55"
"5717","65","20180417114310","Mobile","AAA01","13","130000","26000","104000","2018-04-17 11:43:10"
"5718","5","20180417100753","Shop","AAA05","9","540000","180000","360000","2018-04-17 10:07:53"
"5719","29","20180417083245","Mobile","AAA01","8","80000","16000","64000","2018-04-17 08:32:45"
"5720","35","20180417012754","PC","AAA05","7","420000","140000","280000","2018-04-17 01:27:54"
"5721","79","20180416080811","PC","AAA03","4","68000","12000","56000","2018-04-16 08:08:11"
"5722","62","20180412064327","Shop","AAA01","4","40000","8000","32000","2018-04-12 06:43:27"
"5723","65","20180411061523","Mobile","AAA03","13","221000","39000","182000","2018-04-11 18:15:23"
"5724","15","20180411020506","Mobile","AAA03","2","34000","6000","28000","2018-04-11 14:05:06"
"5725","51","20180411011236","Shop","AAA01","5","50000","10000","40000","2018-04-11 13:12:36"
"5726","67","20180411111629","Shop","AAA05","13","780000","260000","520000","2018-04-11 11:16:29"
"5727","28","20180411101758","Shop","AAA03","5","85000","15000","70000","2018-04-11 10:17:58"
"5728","91","20180411090140","PC","AAA03","2","34000","6000","28000","2018-04-11 09:01:40"
"5729","76","20180411082959","Shop","AAA02","4","60000","9200","50800","2018-04-11 08:29:59"
"5730","53","20180410084528","Shop","AAA03","1","17000","3000","14000","2018-04-10 20:45:28"
"5731","62","20180410021818","Mobile","AAA01","8","80000","16000","64000","2018-04-10 14:18:18"
"5732","49","20180410125352","Mobile","AAA03","6","102000","18000","84000","2018-04-10 12:53:52"
"5733","45","20180410104932","PC","AAA02","3","45000","6900","38100","2018-04-10 10:49:32"
"5734","27","20180410092734","Shop","AAA05","13","780000","260000","520000","2018-04-10 09:27:34"
"5735","13","20180410074612","Shop","AAA01","1","10000","2000","8000","2018-04-10 07:46:12"
"5736","51","20180409075950","Mobile","AAA01","10","100000","20000","80000","2018-04-09 19:59:50"
"5737","48","20180409030550","Shop","AAA05","14","840000","280000","560000","2018-04-09 15:05:50"
"5738","21","20180409014028","PC","AAA01","7","70000","14000","56000","2018-04-09 13:40:28"
"5739","85","20180409122502","Shop","AAA03","4","68000","12000","56000","2018-04-09 12:25:02"
"5740","56","20180409103558","PC","AAA02","13","195000","29900","165100","2018-04-09 10:35:58"
"5741","84","20180409091325","Mobile","AAA03","3","51000","9000","42000","2018-04-09 09:13:25"
"5742","79","20180405032729","Shop","AAA01","3","30000","6000","24000","2018-04-05 15:27:29"
"5743","60","20180405020145","PC","AAA01","3","30000","6000","24000","2018-04-05 14:01:45"
"5744","3","20180405112211","PC","AAA03","14","238000","42000","196000","2018-04-05 11:22:11"
"5745","91","20180405100128","Mobile","AAA01","2","20000","4000","16000","2018-04-05 10:01:28"
"5746","82","20180405092353","Mobile","AAA02","6","90000","13800","76200","2018-04-05 09:23:53"
"5747","88","20180405073507","PC","AAA05","1","60000","20000","40000","2018-04-05 07:35:07"
"5748","25","20180404021919","Mobile","AAA02","6","90000","13800","76200","2018-04-04 14:19:19"
"5749","59","20180404013323","Shop","AAA04","4","32000","1600","30400","2018-04-04 13:33:23"
"5750","90","20180404122100","Mobile","AAA05","6","360000","120000","240000","2018-04-04 12:21:00"
"5751","18","20180404111754","Shop","AAA04","4","32000","1600","30400","2018-04-04 11:17:54"
"5752","66","20180404092330","PC","AAA01","4","40000","8000","32000","2018-04-04 09:23:30"
"5753","79","20180404082011","Mobile","AAA02","10","150000","23000","127000","2018-04-04 08:20:11"
"5754","38","20180404065549","PC","AAA04","3","24000","1200","22800","2018-04-04 06:55:49"
"5755","22","20180403080847","Shop","AAA03","7","119000","21000","98000","2018-04-03 20:08:47"
"5756","94","20180403011717","PC","AAA02","13","195000","29900","165100","2018-04-03 13:17:17"
"5757","66","20180403113052","PC","AAA02","1","15000","2300","12700","2018-04-03 11:30:52"
"5758","19","20180403110500","PC","AAA04","8","64000","3200","60800","2018-04-03 11:05:00"
"5759","50","20180403101514","Shop","AAA04","12","96000","4800","91200","2018-04-03 10:15:14"
"5760","39","20180403081824","Shop","AAA01","8","80000","16000","64000","2018-04-03 08:18:24"
"5761","89","20180403070513","Shop","AAA03","10","170000","30000","140000","2018-04-03 07:05:13"
"5762","14","20180402035912","PC","AAA02","2","30000","4600","25400","2018-04-02 15:59:12"
"5763","82","20180402024027","PC","AAA05","2","120000","40000","80000","2018-04-02 14:40:27"
"5764","70","20180402015128","Mobile","AAA05","9","540000","180000","360000","2018-04-02 13:51:28"
"5765","49","20180402122030","Shop","AAA02","8","120000","18400","101600","2018-04-02 12:20:30"
"5766","54","20180402105801","Shop","AAA02","9","135000","20700","114300","2018-04-02 10:58:01"
"5767","72","20180402100407","Shop","AAA04","6","48000","2400","45600","2018-04-02 10:04:07"
"5768","47","20180331095302","PC","AAA05","15","900000","300000","600000","2018-03-31 21:53:02"
"5769","49","20180331083248","PC","AAA01","9","90000","18000","72000","2018-03-31 08:32:48"
"5770","27","20180330013516","Mobile","AAA05","6","360000","120000","240000","2018-03-30 13:35:16"
"5771","59","20180330122837","Mobile","AAA03","7","119000","21000","98000","2018-03-30 12:28:37"
"5772","31","20180330092357","PC","AAA03","5","85000","15000","70000","2018-03-30 09:23:57"
"5773","68","20180330082239","Shop","AAA03","5","85000","15000","70000","2018-03-30 08:22:39"
"5774","70","20180330074214","Mobile","AAA02","26","390000","59800","330200","2018-03-30 07:42:14"
"5775","26","20180330014617","Shop","AAA02","2","30000","4600","25400","2018-03-30 01:46:17"
"5776","42","20180329025130","PC","AAA01","4","40000","8000","32000","2018-03-29 14:51:30"
"5777","69","20180329013408","PC","AAA01","1","10000","2000","8000","2018-03-29 13:34:08"
"5778","31","20180329115245","Mobile","AAA04","5","40000","2000","38000","2018-03-29 11:52:45"
"5779","28","20180329103820","PC","AAA03","1","17000","3000","14000","2018-03-29 10:38:20"
"5780","8","20180329084238","Mobile","AAA01","9","90000","18000","72000","2018-03-29 08:42:38"
"5781","10","20180329063602","PC","AAA01","17","170000","34000","136000","2018-03-29 06:36:02"
"5782","49","20180328110226","PC","AAA03","8","136000","24000","112000","2018-03-28 23:02:26"
"5783","18","20180328040249","Shop","AAA05","3","180000","60000","120000","2018-03-28 16:02:49"
"5784","8","20180328024909","Shop","AAA02","1","15000","2300","12700","2018-03-28 14:49:09"
"5785","38","20180328015426","Mobile","AAA03","9","153000","27000","126000","2018-03-28 13:54:26"
"5786","86","20180328123459","Mobile","AAA01","2","20000","4000","16000","2018-03-28 12:34:59"
"5787","84","20180328112138","PC","AAA01","6","60000","12000","48000","2018-03-28 11:21:38"
"5788","15","20180328100647","Mobile","AAA03","9","153000","27000","126000","2018-03-28 10:06:47"
"5789","74","20180328085858","PC","AAA04","8","64000","3200","60800","2018-03-28 08:58:58"
"5790","80","20180328081344","Mobile","AAA02","1","15000","2300","12700","2018-03-28 08:13:44"
"5791","92","20180328065837","Shop","AAA02","6","90000","13800","76200","2018-03-28 06:58:37"
"5792","66","20180327123202","PC","AAA02","13","195000","29900","165100","2018-03-27 12:32:02"
"5793","12","20180327103350","Shop","AAA04","5","40000","2000","38000","2018-03-27 10:33:50"
"5794","77","20180327092501","Shop","AAA01","4","40000","8000","32000","2018-03-27 09:25:01"
"5795","4","20180327083406","Mobile","AAA05","2","120000","40000","80000","2018-03-27 08:34:06"
"5796","11","20180327071802","Shop","AAA02","10","150000","23000","127000","2018-03-27 07:18:02"
"5797","93","20180327031138","PC","AAA05","12","720000","240000","480000","2018-03-27 03:11:38"
"5798","41","20180326010751","Mobile","AAA02","3","45000","6900","38100","2018-03-26 13:07:51"
"5799","7","20180326115057","PC","AAA03","3","51000","9000","42000","2018-03-26 11:50:57"
"5800","74","20180326102526","Mobile","AAA04","1","8000","400","7600","2018-03-26 10:25:26"
"5801","41","20180326081745","Mobile","AAA05","7","420000","140000","280000","2018-03-26 08:17:45"
"5802","19","20180324075220","Mobile","AAA04","3","24000","1200","22800","2018-03-24 07:52:20"
"5803","35","20180323061639","Shop","AAA04","8","64000","3200","60800","2018-03-23 18:16:39"
"5804","43","20180323015958","Shop","AAA01","9","90000","18000","72000","2018-03-23 13:59:58"
"5805","63","20180323012433","PC","AAA05","4","240000","80000","160000","2018-03-23 13:24:33"
"5806","54","20180323121802","Shop","AAA02","5","75000","11500","63500","2018-03-23 12:18:02"
"5807","21","20180323101241","Mobile","AAA04","8","64000","3200","60800","2018-03-23 10:12:41"
"5808","89","20180323082954","PC","AAA03","13","221000","39000","182000","2018-03-23 08:29:54"
"5809","80","20180323062807","Shop","AAA04","6","48000","2400","45600","2018-03-23 06:28:07"
"5810","49","20180322074310","Mobile","AAA05","6","360000","120000","240000","2018-03-22 19:43:10"
"5811","72","20180322024216","Shop","AAA03","4","68000","12000","56000","2018-03-22 14:42:16"
"5812","50","20180322010524","PC","AAA01","7","70000","14000","56000","2018-03-22 13:05:24"
"5813","40","20180322113218","PC","AAA03","2","34000","6000","28000","2018-03-22 11:32:18"
"5814","53","20180322094855","Mobile","AAA01","1","10000","2000","8000","2018-03-22 09:48:55"
"5815","45","20180322074544","PC","AAA04","1","8000","400","7600","2018-03-22 07:45:44"
"5816","65","20180321101236","PC","AAA03","12","204000","36000","168000","2018-03-21 22:12:36"
"5817","10","20180321060724","Shop","AAA01","8","80000","16000","64000","2018-03-21 18:07:24"
"5818","79","20180321014956","Mobile","AAA02","1","15000","2300","12700","2018-03-21 13:49:56"
"5819","57","20180321124325","PC","AAA02","5","75000","11500","63500","2018-03-21 12:43:25"
"5820","47","20180321120019","Shop","AAA04","15","120000","6000","114000","2018-03-21 12:00:19"
"5821","51","20180321101512","Mobile","AAA05","8","480000","160000","320000","2018-03-21 10:15:12"
"5822","55","20180321084248","Shop","AAA03","4","68000","12000","56000","2018-03-21 08:42:48"
"5823","97","20180320104643","PC","AAA01","2","20000","4000","16000","2018-03-20 22:46:43"
"5824","64","20180320054956","Mobile","AAA04","16","128000","6400","121600","2018-03-20 17:49:56"
"5825","70","20180320025055","Shop","AAA04","10","80000","4000","76000","2018-03-20 14:50:55"
"5826","24","20180320011836","Mobile","AAA04","7","56000","2800","53200","2018-03-20 13:18:36"
"5827","74","20180320120111","Shop","AAA03","1","17000","3000","14000","2018-03-20 12:01:11"
"5828","70","20180320091858","PC","AAA03","19","323000","57000","266000","2018-03-20 09:18:58"
"5829","2","20180319044328","Mobile","AAA04","4","32000","1600","30400","2018-03-19 16:43:28"
"5830","74","20180319032213","Shop","AAA05","5","300000","100000","200000","2018-03-19 15:22:13"
"5831","9","20180319020643","PC","AAA02","1","15000","2300","12700","2018-03-19 14:06:43"
"5832","91","20180319124821","PC","AAA01","8","80000","16000","64000","2018-03-19 12:48:21"
"5833","60","20180319114648","Mobile","AAA02","1","15000","2300","12700","2018-03-19 11:46:48"
"5834","46","20180319103111","Shop","AAA01","13","130000","26000","104000","2018-03-19 10:31:11"
"5835","1","20180319085836","Mobile","AAA04","13","104000","5200","98800","2018-03-19 08:58:36"
"5836","26","20180315100739","Shop","AAA02","3","45000","6900","38100","2018-03-15 10:07:39"
"5837","49","20180315091313","Mobile","AAA02","5","75000","11500","63500","2018-03-15 09:13:13"
"5838","76","20180315075222","Shop","AAA05","1","60000","20000","40000","2018-03-15 07:52:22"
"5839","63","20180315013806","Shop","AAA02","1","15000","2300","12700","2018-03-15 01:38:06"
"5840","59","20180314110036","PC","AAA01","4","40000","8000","32000","2018-03-14 11:00:36"
"5841","52","20180314093845","Mobile","AAA02","1","15000","2300","12700","2018-03-14 09:38:45"
"5842","43","20180314093023","PC","AAA04","4","32000","1600","30400","2018-03-14 09:30:23"
"5843","70","20180314082739","PC","AAA05","1","60000","20000","40000","2018-03-14 08:27:39"
"5844","57","20180314074027","Shop","AAA02","6","90000","13800","76200","2018-03-14 07:40:27"
"5845","49","20180313031458","PC","AAA01","6","60000","12000","48000","2018-03-13 15:14:58"
"5846","28","20180313022813","Mobile","AAA01","8","80000","16000","64000","2018-03-13 14:28:13"
"5847","14","20180313122346","Shop","AAA05","2","120000","40000","80000","2018-03-13 12:23:46"
"5848","41","20180313084950","Mobile","AAA04","7","56000","2800","53200","2018-03-13 08:49:50"
"5849","97","20180313072911","PC","AAA01","5","50000","10000","40000","2018-03-13 07:29:11"
"5850","35","20180312055543","Shop","AAA03","5","85000","15000","70000","2018-03-12 17:55:43"
"5851","12","20180312035957","Mobile","AAA01","1","10000","2000","8000","2018-03-12 15:59:57"
"5852","17","20180312031227","PC","AAA01","1","10000","2000","8000","2018-03-12 15:12:27"
"5853","14","20180312104235","Mobile","AAA02","7","105000","16100","88900","2018-03-12 10:42:35"
"5854","38","20180312091240","PC","AAA04","10","80000","4000","76000","2018-03-12 09:12:40"
"5855","95","20180309073118","PC","AAA04","8","64000","3200","60800","2018-03-09 19:31:18"
"5856","38","20180309042632","PC","AAA04","3","24000","1200","22800","2018-03-09 16:26:32"
"5857","99","20180309032307","PC","AAA03","4","68000","12000","56000","2018-03-09 15:23:07"
"5858","78","20180309015337","PC","AAA05","4","240000","80000","160000","2018-03-09 13:53:37"
"5859","45","20180309122051","Shop","AAA01","8","80000","16000","64000","2018-03-09 12:20:51"
"5860","58","20180309101802","Shop","AAA04","4","32000","1600","30400","2018-03-09 10:18:02"
"5861","22","20180309084701","PC","AAA02","6","90000","13800","76200","2018-03-09 08:47:01"
"5862","39","20180309072830","Shop","AAA05","3","180000","60000","120000","2018-03-09 07:28:30"
"5863","85","20180308113701","Shop","AAA05","5","300000","100000","200000","2018-03-08 23:37:01"
"5864","100","20180308023028","Mobile","AAA01","2","20000","4000","16000","2018-03-08 14:30:28"
"5865","50","20180308010337","Shop","AAA05","8","480000","160000","320000","2018-03-08 13:03:37"
"5866","41","20180308112206","Mobile","AAA05","7","420000","140000","280000","2018-03-08 11:22:06"
"5867","52","20180308101019","Mobile","AAA01","1","10000","2000","8000","2018-03-08 10:10:19"
"5868","1","20180308084449","PC","AAA02","6","90000","13800","76200","2018-03-08 08:44:49"
"5869","53","20180307062411","PC","AAA04","9","72000","3600","68400","2018-03-07 18:24:11"
"5870","86","20180307021654","Mobile","AAA02","1","15000","2300","12700","2018-03-07 14:16:54"
"5871","63","20180307010056","Mobile","AAA05","5","300000","100000","200000","2018-03-07 13:00:56"
"5872","20","20180307115435","Shop","AAA02","1","15000","2300","12700","2018-03-07 11:54:35"
"5873","3","20180307094853","Shop","AAA01","6","60000","12000","48000","2018-03-07 09:48:53"
"5874","42","20180307085835","Shop","AAA05","5","300000","100000","200000","2018-03-07 08:58:35"
"5875","97","20180307072059","Shop","AAA03","9","153000","27000","126000","2018-03-07 07:20:59"
"5876","51","20180306024313","Mobile","AAA02","4","60000","9200","50800","2018-03-06 14:43:13"
"5877","34","20180306115615","Mobile","AAA04","12","96000","4800","91200","2018-03-06 11:56:15"
"5878","78","20180306110400","PC","AAA04","1","8000","400","7600","2018-03-06 11:04:00"
"5879","65","20180306085052","Shop","AAA05","11","660000","220000","440000","2018-03-06 08:50:52"
"5880","71","20180306065112","Shop","AAA02","8","120000","18400","101600","2018-03-06 06:51:12"
"5881","97","20180305043940","Mobile","AAA04","6","48000","2400","45600","2018-03-05 16:39:40"
"5882","20","20180305032617","Shop","AAA04","2","16000","800","15200","2018-03-05 15:26:17"
"5883","70","20180305023642","Mobile","AAA03","8","136000","24000","112000","2018-03-05 14:36:42"
"5884","27","20180305013405","Shop","AAA01","11","110000","22000","88000","2018-03-05 13:34:05"
"5885","92","20180305113707","Shop","AAA02","15","225000","34500","190500","2018-03-05 11:37:07"
"5886","6","20180305110407","PC","AAA05","4","240000","80000","160000","2018-03-05 11:04:07"
"5887","91","20180305095427","Mobile","AAA03","7","119000","21000","98000","2018-03-05 09:54:27"
"5888","71","20180302070542","Shop","AAA04","12","96000","4800","91200","2018-03-02 07:05:42"
"5889","46","20180301053836","Mobile","AAA01","7","70000","14000","56000","2018-03-01 17:38:36"
"5890","12","20180301034241","Shop","AAA04","4","32000","1600","30400","2018-03-01 15:42:41"
"5891","24","20180301020533","Shop","AAA03","9","153000","27000","126000","2018-03-01 14:05:33"
"5892","7","20180301113020","Shop","AAA02","5","75000","11500","63500","2018-03-01 11:30:20"
"5893","62","20180301101756","PC","AAA02","16","240000","36800","203200","2018-03-01 10:17:56"
"5894","99","20180301085307","Shop","AAA04","4","32000","1600","30400","2018-03-01 08:53:07"
"5895","56","20180301073325","PC","AAA04","7","56000","2800","53200","2018-03-01 07:33:25"
"5896","86","20180228041617","Mobile","AAA03","4","68000","12000","56000","2018-02-28 16:16:17"
"5897","8","20180228033038","PC","AAA02","10","150000","23000","127000","2018-02-28 15:30:38"
"5898","67","20180228012705","Shop","AAA02","2","30000","4600","25400","2018-02-28 13:27:05"
"5899","69","20180228011423","Shop","AAA03","4","68000","12000","56000","2018-02-28 13:14:23"
"5900","5","20180228083738","PC","AAA03","2","34000","6000","28000","2018-02-28 08:37:38"
"5901","84","20180228080348","Shop","AAA05","6","360000","120000","240000","2018-02-28 08:03:48"
"5902","65","20180228063531","PC","AAA01","7","70000","14000","56000","2018-02-28 06:35:31"
"5903","65","20180227084406","Mobile","AAA05","6","360000","120000","240000","2018-02-27 20:44:06"
"5904","68","20180227055314","PC","AAA02","4","60000","9200","50800","2018-02-27 17:53:14"
"5905","5","20180227041633","Mobile","AAA05","6","360000","120000","240000","2018-02-27 16:16:33"
"5906","88","20180227031736","Shop","AAA02","1","15000","2300","12700","2018-02-27 15:17:36"
"5907","31","20180227022928","Shop","AAA04","2","16000","800","15200","2018-02-27 14:29:28"
"5908","78","20180227124705","Shop","AAA04","3","24000","1200","22800","2018-02-27 12:47:05"
"5909","76","20180227113620","Shop","AAA02","6","90000","13800","76200","2018-02-27 11:36:20"
"5910","10","20180227104455","PC","AAA04","10","80000","4000","76000","2018-02-27 10:44:55"
"5911","30","20180227084925","Mobile","AAA04","4","32000","1600","30400","2018-02-27 08:49:25"
"5912","9","20180227071833","PC","AAA05","4","240000","80000","160000","2018-02-27 07:18:33"
"5913","63","20180226101242","PC","AAA03","4","68000","12000","56000","2018-02-26 22:12:42"
"5914","55","20180226052208","Mobile","AAA03","12","204000","36000","168000","2018-02-26 17:22:08"
"5915","86","20180226042528","Mobile","AAA03","8","136000","24000","112000","2018-02-26 16:25:28"
"5916","90","20180226031239","PC","AAA02","1","15000","2300","12700","2018-02-26 15:12:39"
"5917","48","20180226014455","PC","AAA02","7","105000","16100","88900","2018-02-26 13:44:55"
"5918","69","20180226120703","Mobile","AAA02","7","105000","16100","88900","2018-02-26 12:07:03"
"5919","63","20180226110503","Mobile","AAA02","9","135000","20700","114300","2018-02-26 11:05:03"
"5920","14","20180226091521","PC","AAA01","5","50000","10000","40000","2018-02-26 09:15:21"
"5921","40","20180224053426","Mobile","AAA03","1","17000","3000","14000","2018-02-24 05:34:26"
"5922","15","20180223062457","Shop","AAA04","8","64000","3200","60800","2018-02-23 06:24:57"
"5923","29","20180222122424","Mobile","AAA01","12","120000","24000","96000","2018-02-22 12:24:24"
"5924","59","20180222110604","PC","AAA01","2","20000","4000","16000","2018-02-22 11:06:04"
"5925","28","20180222092545","Mobile","AAA03","10","170000","30000","140000","2018-02-22 09:25:45"
"5926","43","20180222075658","PC","AAA01","1","10000","2000","8000","2018-02-22 07:56:58"
"5927","98","20180221075435","PC","AAA05","4","240000","80000","160000","2018-02-21 19:54:35"
"5928","23","20180221024448","Shop","AAA04","2","16000","800","15200","2018-02-21 14:44:48"
"5929","51","20180221013032","Shop","AAA04","10","80000","4000","76000","2018-02-21 13:30:32"
"5930","44","20180221114103","PC","AAA01","1","10000","2000","8000","2018-02-21 11:41:03"
"5931","66","20180221103945","PC","AAA03","6","102000","18000","84000","2018-02-21 10:39:45"
"5932","8","20180221093111","PC","AAA04","6","48000","2400","45600","2018-02-21 09:31:11"
"5933","1","20180221081046","PC","AAA01","6","60000","12000","48000","2018-02-21 08:10:46"
"5934","97","20180221010851","PC","AAA01","2","20000","4000","16000","2018-02-21 01:08:51"
"5935","64","20180220072223","Shop","AAA01","7","70000","14000","56000","2018-02-20 19:22:23"
"5936","30","20180220030636","PC","AAA02","1","15000","2300","12700","2018-02-20 15:06:36"
"5937","4","20180220020013","Shop","AAA02","6","90000","13800","76200","2018-02-20 14:00:13"
"5938","2","20180220122432","Shop","AAA01","1","10000","2000","8000","2018-02-20 12:24:32"
"5939","41","20180219094323","Mobile","AAA05","6","360000","120000","240000","2018-02-19 21:43:23"
"5940","51","20180219051129","Mobile","AAA03","1","17000","3000","14000","2018-02-19 17:11:29"
"5941","28","20180219040712","Mobile","AAA03","5","85000","15000","70000","2018-02-19 16:07:12"
"5942","42","20180219031632","Mobile","AAA05","6","360000","120000","240000","2018-02-19 15:16:32"
"5943","84","20180219023823","Shop","AAA01","1","10000","2000","8000","2018-02-19 14:38:23"
"5944","53","20180219012745","Shop","AAA03","4","68000","12000","56000","2018-02-19 13:27:45"
"5945","96","20180219121234","PC","AAA04","10","80000","4000","76000","2018-02-19 12:12:34"
"5946","77","20180219090750","Mobile","AAA05","1","60000","20000","40000","2018-02-19 09:07:50"
"5947","55","20180215012916","PC","AAA02","8","120000","18400","101600","2018-02-15 01:29:16"
"5948","66","20180214093009","Mobile","AAA04","4","32000","1600","30400","2018-02-14 09:30:09"
"5949","65","20180214083914","Mobile","AAA03","6","102000","18000","84000","2018-02-14 08:39:14"
"5950","53","20180214072700","PC","AAA02","7","105000","16100","88900","2018-02-14 07:27:00"
"5951","32","20180213083209","Shop","AAA03","5","85000","15000","70000","2018-02-13 20:32:09"
"5952","43","20180213012931","Shop","AAA05","1","60000","20000","40000","2018-02-13 13:29:31"
"5953","2","20180213121459","PC","AAA04","6","48000","2400","45600","2018-02-13 12:14:59"
"5954","82","20180213095522","PC","AAA02","7","105000","16100","88900","2018-02-13 09:55:22"
"5955","54","20180213090254","Mobile","AAA04","9","72000","3600","68400","2018-02-13 09:02:54"
"5956","30","20180213074722","Shop","AAA03","12","204000","36000","168000","2018-02-13 07:47:22"
"5957","90","20180212080129","Mobile","AAA02","1","15000","2300","12700","2018-02-12 20:01:29"
"5958","76","20180212034345","Mobile","AAA03","4","68000","12000","56000","2018-02-12 15:43:45"
"5959","24","20180212031430","PC","AAA01","3","30000","6000","24000","2018-02-12 15:14:30"
"5960","88","20180212015505","Shop","AAA01","3","30000","6000","24000","2018-02-12 13:55:05"
"5961","89","20180212093543","Mobile","AAA01","19","190000","38000","152000","2018-02-12 09:35:43"
"5962","53","20180207033331","PC","AAA02","6","90000","13800","76200","2018-02-07 15:33:31"
"5963","6","20180207014339","Mobile","AAA02","8","120000","18400","101600","2018-02-07 13:43:39"
"5964","78","20180207123441","PC","AAA05","5","300000","100000","200000","2018-02-07 12:34:41"
"5965","56","20180207112133","Shop","AAA04","1","8000","400","7600","2018-02-07 11:21:33"
"5966","71","20180207084456","PC","AAA02","8","120000","18400","101600","2018-02-07 08:44:56"
"5967","67","20180207071510","Shop","AAA04","12","96000","4800","91200","2018-02-07 07:15:10"
"5968","47","20180206090755","Mobile","AAA05","2","120000","40000","80000","2018-02-06 21:07:55"
"5969","87","20180206052655","PC","AAA03","5","85000","15000","70000","2018-02-06 17:26:55"
"5970","65","20180206025340","Shop","AAA03","4","68000","12000","56000","2018-02-06 14:53:40"
"5971","84","20180206123533","Shop","AAA05","5","300000","100000","200000","2018-02-06 12:35:33"
"5972","15","20180206105715","Mobile","AAA05","8","480000","160000","320000","2018-02-06 10:57:15"
"5973","28","20180206091914","Shop","AAA01","7","70000","14000","56000","2018-02-06 09:19:14"
"5974","1","20180206075609","PC","AAA03","9","153000","27000","126000","2018-02-06 07:56:09"
"5975","68","20180205110137","Mobile","AAA03","5","85000","15000","70000","2018-02-05 23:01:37"
"5976","80","20180205112028","PC","AAA04","4","32000","1600","30400","2018-02-05 11:20:28"
"5977","78","20180205103025","PC","AAA03","5","85000","15000","70000","2018-02-05 10:30:25"
"5978","63","20180205094928","Mobile","AAA05","6","360000","120000","240000","2018-02-05 09:49:28"
"5979","96","20180203060646","Shop","AAA05","4","240000","80000","160000","2018-02-03 06:06:46"
"5980","33","20180202061744","Shop","AAA03","2","34000","6000","28000","2018-02-02 18:17:44"
"5981","49","20180202023204","Shop","AAA05","1","60000","20000","40000","2018-02-02 14:32:04"
"5982","2","20180202015632","PC","AAA02","1","15000","2300","12700","2018-02-02 13:56:32"
"5983","12","20180202123037","PC","AAA05","1","60000","20000","40000","2018-02-02 12:30:37"
"5984","71","20180202113729","PC","AAA04","1","8000","400","7600","2018-02-02 11:37:29"
"5985","87","20180202092816","Shop","AAA01","6","60000","12000","48000","2018-02-02 09:28:16"
"5986","38","20180202073142","Mobile","AAA01","10","100000","20000","80000","2018-02-02 07:31:42"
"5987","52","20180202120301","Shop","AAA05","1","60000","20000","40000","2018-02-02 00:03:01"
"5988","49","20180201060124","Mobile","AAA01","4","40000","8000","32000","2018-02-01 06:01:24"
"5989","4","20180131071243","Mobile","AAA05","5","300000","100000","200000","2018-01-31 19:12:43"
"5990","76","20180131024036","Mobile","AAA05","4","240000","80000","160000","2018-01-31 14:40:36"
"5991","41","20180131011756","PC","AAA01","11","110000","22000","88000","2018-01-31 13:17:56"
"5992","22","20180131105044","Mobile","AAA05","5","300000","100000","200000","2018-01-31 10:50:44"
"5993","76","20180131100105","Mobile","AAA04","7","56000","2800","53200","2018-01-31 10:01:05"
"5994","87","20180131094914","PC","AAA05","6","360000","120000","240000","2018-01-31 09:49:14"
"5995","9","20180131085317","PC","AAA05","2","120000","40000","80000","2018-01-31 08:53:17"
"5996","37","20180130085912","Mobile","AAA03","4","68000","12000","56000","2018-01-30 20:59:12"
"5997","67","20180130050749","Shop","AAA01","18","180000","36000","144000","2018-01-30 17:07:49"
"5998","82","20180130034750","PC","AAA05","4","240000","80000","160000","2018-01-30 15:47:50"
"5999","95","20180130020413","PC","AAA05","6","360000","120000","240000","2018-01-30 14:04:13"
"6000","56","20180130124156","PC","AAA01","8","80000","16000","64000","2018-01-30 12:41:56"
"6001","81","20180130113329","PC","AAA03","1","17000","3000","14000","2018-01-30 11:33:29"
"6002","3","20180130104722","Mobile","AAA04","12","96000","4800","91200","2018-01-30 10:47:22"
"6003","7","20180130092423","PC","AAA01","4","40000","8000","32000","2018-01-30 09:24:23"
"6004","38","20180130075406","PC","AAA05","7","420000","140000","280000","2018-01-30 07:54:06"
"6005","30","20180129035229","PC","AAA01","3","30000","6000","24000","2018-01-29 15:52:29"
"6006","81","20180129024421","PC","AAA02","2","30000","4600","25400","2018-01-29 14:44:21"
"6007","70","20180129015132","Shop","AAA04","4","32000","1600","30400","2018-01-29 13:51:32"
"6008","2","20180129110807","PC","AAA05","5","300000","100000","200000","2018-01-29 11:08:07"
"6009","51","20180129093447","Mobile","AAA04","7","56000","2800","53200","2018-01-29 09:34:47"
"6010","94","20180126094345","Mobile","AAA03","7","119000","21000","98000","2018-01-26 09:43:45"
"6011","26","20180126084810","PC","AAA02","10","150000","23000","127000","2018-01-26 08:48:10"
"6012","55","20180126072528","PC","AAA01","11","110000","22000","88000","2018-01-26 07:25:28"
"6013","41","20180125092716","Mobile","AAA01","6","60000","12000","48000","2018-01-25 09:27:16"
"6014","57","20180125080740","PC","AAA05","6","360000","120000","240000","2018-01-25 08:07:40"
"6015","88","20180125065505","Mobile","AAA05","1","60000","20000","40000","2018-01-25 06:55:05"
"6016","37","20180124071236","Shop","AAA04","12","96000","4800","91200","2018-01-24 19:12:36"
"6017","18","20180124124015","PC","AAA05","10","600000","200000","400000","2018-01-24 12:40:15"
"6018","43","20180124114857","Shop","AAA01","2","20000","4000","16000","2018-01-24 11:48:57"
"6019","79","20180124101435","Mobile","AAA04","2","16000","800","15200","2018-01-24 10:14:35"
"6020","62","20180124091547","PC","AAA01","8","80000","16000","64000","2018-01-24 09:15:47"
"6021","31","20180124085914","Shop","AAA03","4","68000","12000","56000","2018-01-24 08:59:14"
"6022","58","20180124080731","Shop","AAA04","3","24000","1200","22800","2018-01-24 08:07:31"
"6023","48","20180123032150","Mobile","AAA01","8","80000","16000","64000","2018-01-23 15:21:50"
"6024","28","20180123113630","Mobile","AAA05","14","840000","280000","560000","2018-01-23 11:36:30"
"6025","13","20180123102635","Shop","AAA03","2","34000","6000","28000","2018-01-23 10:26:35"
"6026","46","20180123083020","Mobile","AAA05","10","600000","200000","400000","2018-01-23 08:30:20"
"6027","35","20180123065904","PC","AAA04","6","48000","2400","45600","2018-01-23 06:59:04"
"6028","5","20180122010110","Mobile","AAA05","1","60000","20000","40000","2018-01-22 13:01:10"
"6029","84","20180122120158","PC","AAA03","4","68000","12000","56000","2018-01-22 12:01:58"
"6030","23","20180122104108","Shop","AAA05","5","300000","100000","200000","2018-01-22 10:41:08"
"6031","100","20180122094706","Shop","AAA01","4","40000","8000","32000","2018-01-22 09:47:06"
"6032","19","20180118014819","Mobile","AAA05","2","120000","40000","80000","2018-01-18 01:48:19"
"6033","88","20180117115053","Mobile","AAA03","6","102000","18000","84000","2018-01-17 11:50:53"
"6034","30","20180117103118","Mobile","AAA04","10","80000","4000","76000","2018-01-17 10:31:18"
"6035","4","20180117085708","PC","AAA03","9","153000","27000","126000","2018-01-17 08:57:08"
"6036","67","20180117035141","Shop","AAA02","3","45000","6900","38100","2018-01-17 03:51:41"
"6037","11","20180116015926","Shop","AAA03","1","17000","3000","14000","2018-01-16 13:59:26"
"6038","79","20180116010018","PC","AAA05","15","900000","300000","600000","2018-01-16 13:00:18"
"6039","77","20180116103238","Shop","AAA04","1","8000","400","7600","2018-01-16 10:32:38"
"6040","42","20180116080500","Shop","AAA04","6","48000","2400","45600","2018-01-16 08:05:00"
"6041","99","20180116071931","PC","AAA05","2","120000","40000","80000","2018-01-16 07:19:31"
"6042","78","20180115103010","Mobile","AAA02","7","105000","16100","88900","2018-01-15 22:30:10"
"6043","88","20180115054243","Shop","AAA04","5","40000","2000","38000","2018-01-15 17:42:43"
"6044","1","20180115045645","Mobile","AAA05","5","300000","100000","200000","2018-01-15 16:56:45"
"6045","23","20180115025715","Mobile","AAA01","10","100000","20000","80000","2018-01-15 14:57:15"
"6046","33","20180115012457","Mobile","AAA05","8","480000","160000","320000","2018-01-15 13:24:57"
"6047","60","20180115112149","PC","AAA05","2","120000","40000","80000","2018-01-15 11:21:49"
"6048","31","20180115103456","Shop","AAA04","6","48000","2400","45600","2018-01-15 10:34:56"
"6049","26","20180115085326","Mobile","AAA03","3","51000","9000","42000","2018-01-15 08:53:26"
"6050","1","20180110071258","Shop","AAA01","13","130000","26000","104000","2018-01-10 19:12:58"
"6051","99","20180110122138","Mobile","AAA03","1","17000","3000","14000","2018-01-10 12:21:38"
"6052","68","20180110100441","Shop","AAA04","3","24000","1200","22800","2018-01-10 10:04:41"
"6053","16","20180110082300","Mobile","AAA02","11","165000","25300","139700","2018-01-10 08:23:00"
"6054","100","20180110074634","Shop","AAA04","12","96000","4800","91200","2018-01-10 07:46:34"
"6055","53","20180109055116","Mobile","AAA04","5","40000","2000","38000","2018-01-09 17:51:16"
"6056","30","20180109043406","Mobile","AAA05","8","480000","160000","320000","2018-01-09 16:34:06"
"6057","81","20180109030819","Shop","AAA04","1","8000","400","7600","2018-01-09 15:08:19"
"6058","95","20180109022040","Mobile","AAA04","6","48000","2400","45600","2018-01-09 14:20:40"
"6059","66","20180109010530","Mobile","AAA03","5","85000","15000","70000","2018-01-09 13:05:30"
"6060","41","20180109100132","Shop","AAA03","11","187000","33000","154000","2018-01-09 10:01:32"
"6061","43","20180109090827","PC","AAA05","11","660000","220000","440000","2018-01-09 09:08:27"
"6062","28","20180109065432","Shop","AAA04","7","56000","2800","53200","2018-01-09 06:54:32"
"6063","95","20180108071448","Shop","AAA04","7","56000","2800","53200","2018-01-08 19:14:48"
"6064","48","20180108033551","Shop","AAA02","8","120000","18400","101600","2018-01-08 15:35:51"
"6065","93","20180108021036","Mobile","AAA03","6","102000","18000","84000","2018-01-08 14:10:36"
"6066","25","20180108114346","Mobile","AAA03","3","51000","9000","42000","2018-01-08 11:43:46"
"6067","9","20180108103748","Mobile","AAA01","5","50000","10000","40000","2018-01-08 10:37:48"
"6068","76","20180108085300","Shop","AAA05","4","240000","80000","160000","2018-01-08 08:53:00"
"6069","23","20180104055305","Shop","AAA02","9","135000","20700","114300","2018-01-04 17:53:05"
"6070","39","20180104044156","Shop","AAA03","12","204000","36000","168000","2018-01-04 16:41:56"
"6071","69","20180104034551","Mobile","AAA04","3","24000","1200","22800","2018-01-04 15:45:51"
"6072","85","20180104022811","Shop","AAA03","8","136000","24000","112000","2018-01-04 14:28:11"
"6073","73","20180104012455","PC","AAA01","7","70000","14000","56000","2018-01-04 13:24:55"
"6074","85","20180104114556","PC","AAA05","9","540000","180000","360000","2018-01-04 11:45:56"
"6075","14","20180104101214","PC","AAA02","5","75000","11500","63500","2018-01-04 10:12:14"
"6076","21","20180103012626","Shop","AAA02","13","195000","29900","165100","2018-01-03 13:26:26"
"6077","41","20180103122404","Mobile","AAA04","8","64000","3200","60800","2018-01-03 12:24:04"
"6078","56","20180103113458","Shop","AAA03","10","170000","30000","140000","2018-01-03 11:34:58"
"6079","68","20180103101551","PC","AAA01","4","40000","8000","32000","2018-01-03 10:15:51"
"6080","77","20180103094739","Shop","AAA01","6","60000","12000","48000","2018-01-03 09:47:39"
"6081","95","20180103084242","Mobile","AAA04","5","40000","2000","38000","2018-01-03 08:42:42"
"6082","46","20180103065948","PC","AAA03","7","119000","21000","98000","2018-01-03 06:59:48"
"6083","6","20180102045233","Shop","AAA04","2","16000","800","15200","2018-01-02 16:52:33"
"6084","76","20180102032901","Shop","AAA01","1","10000","2000","8000","2018-01-02 15:29:01"
"6085","96","20180102022727","Mobile","AAA03","14","238000","42000","196000","2018-01-02 14:27:27"
"6086","21","20180102125917","Mobile","AAA02","6","90000","13800","76200","2018-01-02 12:59:17"
"6087","25","20180102113853","PC","AAA04","6","48000","2400","45600","2018-01-02 11:38:53"
"6088","87","20180102100329","PC","AAA04","4","32000","1600","30400","2018-01-02 10:03:29"
"6089","92","20180102093420","Mobile","AAA02","9","135000","20700","114300","2018-01-02 09:34:20"
"6090","49","20180102080126","Shop","AAA04","5","40000","2000","38000","2018-01-02 08:01:26"
"6091","90","20180102065312","PC","AAA01","5","50000","10000","40000","2018-01-02 06:53:12"
"6092","27","20180101040039","PC","AAA05","12","720000","240000","480000","2018-01-01 16:00:39"
"6093","82","20180101023349","PC","AAA01","7","70000","14000","56000","2018-01-01 14:33:49"
"6094","67","20180101012608","Mobile","AAA01","20","200000","40000","160000","2018-01-01 13:26:08"
"6095","69","20180101115612","Mobile","AAA02","3","45000","6900","38100","2018-01-01 11:56:12"
"6096","22","20180101110322","PC","AAA02","11","165000","25300","139700","2018-01-01 11:03:22"
"6097","18","20180101092625","Shop","AAA04","7","56000","2800","53200","2018-01-01 09:26:25"
"6098","47","20171228040916","PC","AAA05","13","780000","260000","520000","2017-12-28 16:09:16"
"6099","48","20171228030837","Mobile","AAA04","10","80000","4000","76000","2017-12-28 15:08:37"
"6100","34","20171228015922","PC","AAA02","17","255000","39100","215900","2017-12-28 13:59:22"
"6101","60","20171228011931","PC","AAA04","3","24000","1200","22800","2017-12-28 13:19:31"
"6102","65","20171228122228","PC","AAA05","7","420000","140000","280000","2017-12-28 12:22:28"
"6103","33","20171228110036","Shop","AAA02","3","45000","6900","38100","2017-12-28 11:00:36"
"6104","2","20171228095528","Shop","AAA01","5","50000","10000","40000","2017-12-28 09:55:28"
"6105","31","20171228082641","PC","AAA04","2","16000","800","15200","2017-12-28 08:26:41"
"6106","34","20171228065409","Mobile","AAA04","4","32000","1600","30400","2017-12-28 06:54:09"
"6107","32","20171228022826","Shop","AAA03","11","187000","33000","154000","2017-12-28 02:28:26"
"6108","78","20171227101531","PC","AAA05","4","240000","80000","160000","2017-12-27 10:15:31"
"6109","90","20171227090013","PC","AAA03","5","85000","15000","70000","2017-12-27 09:00:13"
"6110","89","20171227075406","Mobile","AAA05","4","240000","80000","160000","2017-12-27 07:54:06"
"6111","59","20171227012319","Shop","AAA02","2","30000","4600","25400","2017-12-27 01:23:19"
"6112","96","20171226023835","Shop","AAA05","9","540000","180000","360000","2017-12-26 14:38:35"
"6113","44","20171226125859","PC","AAA03","6","102000","18000","84000","2017-12-26 12:58:59"
"6114","29","20171226075844","Mobile","AAA04","5","40000","2000","38000","2017-12-26 07:58:44"
"6115","89","20171225100448","Shop","AAA04","3","24000","1200","22800","2017-12-25 22:04:48"
"6116","11","20171225051429","Shop","AAA03","10","170000","30000","140000","2017-12-25 17:14:29"
"6117","33","20171225034722","Mobile","AAA02","1","15000","2300","12700","2017-12-25 15:47:22"
"6118","32","20171225031430","PC","AAA04","17","136000","6800","129200","2017-12-25 15:14:30"
"6119","60","20171225013208","Mobile","AAA01","2","20000","4000","16000","2017-12-25 13:32:08"
"6120","43","20171225122436","PC","AAA02","12","180000","27600","152400","2017-12-25 12:24:36"
"6121","79","20171225111638","PC","AAA03","1","17000","3000","14000","2017-12-25 11:16:38"
"6122","23","20171225103304","Shop","AAA05","9","540000","180000","360000","2017-12-25 10:33:04"
"6123","88","20171225084536","Shop","AAA02","4","60000","9200","50800","2017-12-25 08:45:36"
"6124","80","20171221010614","Mobile","AAA01","3","30000","6000","24000","2017-12-21 13:06:14"
"6125","43","20171221114151","Mobile","AAA04","8","64000","3200","60800","2017-12-21 11:41:51"
"6126","42","20171221103548","Shop","AAA05","8","480000","160000","320000","2017-12-21 10:35:48"
"6127","61","20171221092954","PC","AAA04","3","24000","1200","22800","2017-12-21 09:29:54"
"6128","27","20171221061259","Shop","AAA03","5","85000","15000","70000","2017-12-21 06:12:59"
"6129","51","20171220062453","Mobile","AAA01","8","80000","16000","64000","2017-12-20 18:24:53"
"6130","98","20171220110036","Shop","AAA04","4","32000","1600","30400","2017-12-20 11:00:36"
"6131","4","20171220090149","Mobile","AAA01","1","10000","2000","8000","2017-12-20 09:01:49"
"6132","13","20171220080055","Shop","AAA03","1","17000","3000","14000","2017-12-20 08:00:55"
"6133","49","20171220061142","Shop","AAA05","1","60000","20000","40000","2017-12-20 06:11:42"
"6134","74","20171219032154","PC","AAA03","8","136000","24000","112000","2017-12-19 15:21:54"
"6135","5","20171219012900","Shop","AAA05","10","600000","200000","400000","2017-12-19 13:29:00"
"6136","73","20171219114547","PC","AAA05","9","540000","180000","360000","2017-12-19 11:45:47"
"6137","71","20171219102517","PC","AAA01","4","40000","8000","32000","2017-12-19 10:25:17"
"6138","63","20171219095400","Mobile","AAA03","4","68000","12000","56000","2017-12-19 09:54:00"
"6139","90","20171219075225","PC","AAA04","5","40000","2000","38000","2017-12-19 07:52:25"
"6140","80","20171219010115","PC","AAA03","1","17000","3000","14000","2017-12-19 01:01:15"
"6141","25","20171218050854","Shop","AAA01","7","70000","14000","56000","2017-12-18 17:08:54"
"6142","33","20171218022026","Mobile","AAA05","4","240000","80000","160000","2017-12-18 14:20:26"
"6143","99","20171218123423","PC","AAA02","4","60000","9200","50800","2017-12-18 12:34:23"
"6144","8","20171218114312","PC","AAA03","15","255000","45000","210000","2017-12-18 11:43:12"
"6145","8","20171218100241","Shop","AAA01","7","70000","14000","56000","2017-12-18 10:02:41"
"6146","28","20171215123614","Shop","AAA04","5","40000","2000","38000","2017-12-15 12:36:14"
"6147","78","20171215114057","Mobile","AAA04","5","40000","2000","38000","2017-12-15 11:40:57"
"6148","30","20171215111853","Mobile","AAA04","10","80000","4000","76000","2017-12-15 11:18:53"
"6149","96","20171215085839","Mobile","AAA01","9","90000","18000","72000","2017-12-15 08:58:39"
"6150","89","20171215075218","Shop","AAA01","13","130000","26000","104000","2017-12-15 07:52:18"
"6151","83","20171214041429","Shop","AAA03","8","136000","24000","112000","2017-12-14 16:14:29"
"6152","80","20171214025108","Shop","AAA05","4","240000","80000","160000","2017-12-14 14:51:08"
"6153","45","20171214014046","PC","AAA03","2","34000","6000","28000","2017-12-14 13:40:46"
"6154","6","20171214125039","PC","AAA03","4","68000","12000","56000","2017-12-14 12:50:39"
"6155","70","20171214115732","PC","AAA04","1","8000","400","7600","2017-12-14 11:57:32"
"6156","34","20171214112847","Mobile","AAA03","5","85000","15000","70000","2017-12-14 11:28:47"
"6157","50","20171214110427","PC","AAA02","13","195000","29900","165100","2017-12-14 11:04:27"
"6158","87","20171214094110","PC","AAA03","2","34000","6000","28000","2017-12-14 09:41:10"
"6159","91","20171214090336","Mobile","AAA03","2","34000","6000","28000","2017-12-14 09:03:36"
"6160","36","20171214073852","Mobile","AAA02","5","75000","11500","63500","2017-12-14 07:38:52"
"6161","8","20171213070919","Shop","AAA03","1","17000","3000","14000","2017-12-13 19:09:19"
"6162","44","20171213012213","PC","AAA05","5","300000","100000","200000","2017-12-13 13:22:13"
"6163","93","20171213112918","Shop","AAA05","4","240000","80000","160000","2017-12-13 11:29:18"
"6164","27","20171213094349","Mobile","AAA03","9","153000","27000","126000","2017-12-13 09:43:49"
"6165","86","20171213074105","Shop","AAA04","3","24000","1200","22800","2017-12-13 07:41:05"
"6166","27","20171213124734","Mobile","AAA03","8","136000","24000","112000","2017-12-13 00:47:34"
"6167","98","20171212071831","PC","AAA03","5","85000","15000","70000","2017-12-12 19:18:31"
"6168","92","20171212010412","PC","AAA05","3","180000","60000","120000","2017-12-12 13:04:12"
"6169","56","20171212120239","PC","AAA04","3","24000","1200","22800","2017-12-12 12:02:39"
"6170","88","20171212104832","Shop","AAA05","3","180000","60000","120000","2017-12-12 10:48:32"
"6171","24","20171212091449","PC","AAA04","5","40000","2000","38000","2017-12-12 09:14:49"
"6172","60","20171212081709","PC","AAA01","1","10000","2000","8000","2017-12-12 08:17:09"
"6173","52","20171212072531","Mobile","AAA02","4","60000","9200","50800","2017-12-12 07:25:31"
"6174","3","20171211122410","Mobile","AAA02","7","105000","16100","88900","2017-12-11 12:24:10"
"6175","66","20171211111745","Shop","AAA05","7","420000","140000","280000","2017-12-11 11:17:45"
"6176","78","20171211095012","Shop","AAA03","3","51000","9000","42000","2017-12-11 09:50:12"
"6177","58","20171210015918","Mobile","AAA04","2","16000","800","15200","2017-12-10 01:59:18"
"6178","68","20171206101850","Mobile","AAA05","1","60000","20000","40000","2017-12-06 22:18:50"
"6179","50","20171206071905","Shop","AAA01","18","180000","36000","144000","2017-12-06 19:19:05"
"6180","1","20171206110353","Shop","AAA05","4","240000","80000","160000","2017-12-06 11:03:53"
"6181","56","20171206094350","PC","AAA02","1","15000","2300","12700","2017-12-06 09:43:50"
"6182","58","20171206082207","Shop","AAA05","1","60000","20000","40000","2017-12-06 08:22:07"
"6183","61","20171206064051","Mobile","AAA04","3","24000","1200","22800","2017-12-06 06:40:51"
"6184","34","20171205035455","Mobile","AAA05","6","360000","120000","240000","2017-12-05 15:54:55"
"6185","11","20171205015632","PC","AAA03","9","153000","27000","126000","2017-12-05 13:56:32"
"6186","31","20171205123653","Shop","AAA01","1","10000","2000","8000","2017-12-05 12:36:53"
"6187","25","20171205111911","Shop","AAA05","5","300000","100000","200000","2017-12-05 11:19:11"
"6188","78","20171205100833","Mobile","AAA02","8","120000","18400","101600","2017-12-05 10:08:33"
"6189","94","20171205085409","Mobile","AAA02","14","210000","32200","177800","2017-12-05 08:54:09"
"6190","56","20171205070429","PC","AAA05","14","840000","280000","560000","2017-12-05 07:04:29"
"6191","35","20171204021614","Mobile","AAA05","5","300000","100000","200000","2017-12-04 14:16:14"
"6192","25","20171204123411","PC","AAA05","6","360000","120000","240000","2017-12-04 12:34:11"
"6193","81","20171204114757","PC","AAA04","3","24000","1200","22800","2017-12-04 11:47:57"
"6194","44","20171129063555","Mobile","AAA02","1","15000","2300","12700","2017-11-29 18:35:55"
"6195","64","20171129033155","Shop","AAA01","12","120000","24000","96000","2017-11-29 15:31:55"
"6196","82","20171129025738","Mobile","AAA03","9","153000","27000","126000","2017-11-29 14:57:38"
"6197","68","20171129015843","Mobile","AAA04","2","16000","800","15200","2017-11-29 13:58:43"
"6198","40","20171129122257","Mobile","AAA04","8","64000","3200","60800","2017-11-29 12:22:57"
"6199","36","20171129112256","Mobile","AAA04","13","104000","5200","98800","2017-11-29 11:22:56"
"6200","24","20171129101336","Mobile","AAA04","1","8000","400","7600","2017-11-29 10:13:36"
"6201","52","20171129091128","Shop","AAA01","5","50000","10000","40000","2017-11-29 09:11:28"
"6202","96","20171128045958","Shop","AAA05","12","720000","240000","480000","2017-11-28 16:59:58"
"6203","38","20171128033159","Mobile","AAA03","1","17000","3000","14000","2017-11-28 15:31:59"
"6204","24","20171128021440","Mobile","AAA05","8","480000","160000","320000","2017-11-28 14:14:40"
"6205","61","20171128124850","PC","AAA04","3","24000","1200","22800","2017-11-28 12:48:50"
"6206","100","20171128111314","Mobile","AAA03","1","17000","3000","14000","2017-11-28 11:13:14"
"6207","16","20171128084159","Shop","AAA01","12","120000","24000","96000","2017-11-28 08:41:59"
"6208","20","20171128070719","PC","AAA02","2","30000","4600","25400","2017-11-28 07:07:19"
"6209","33","20171127105848","Mobile","AAA01","5","50000","10000","40000","2017-11-27 22:58:48"
"6210","85","20171127100626","PC","AAA02","3","45000","6900","38100","2017-11-27 22:06:26"
"6211","51","20171127044102","Shop","AAA02","1","15000","2300","12700","2017-11-27 16:41:02"
"6212","49","20171127035958","PC","AAA01","7","70000","14000","56000","2017-11-27 15:59:58"
"6213","88","20171127025550","PC","AAA02","6","90000","13800","76200","2017-11-27 14:55:50"
"6214","75","20171127015844","Shop","AAA05","3","180000","60000","120000","2017-11-27 13:58:44"
"6215","17","20171127125555","Shop","AAA05","2","120000","40000","80000","2017-11-27 12:55:55"
"6216","81","20171127112636","Mobile","AAA05","8","480000","160000","320000","2017-11-27 11:26:36"
"6217","3","20171125081446","Mobile","AAA04","19","152000","7600","144400","2017-11-25 08:14:46"
"6218","49","20171124050035","PC","AAA03","12","204000","36000","168000","2017-11-24 17:00:35"
"6219","39","20171124020209","Shop","AAA05","1","60000","20000","40000","2017-11-24 14:02:09"
"6220","12","20171124011713","Mobile","AAA04","3","24000","1200","22800","2017-11-24 13:17:13"
"6221","85","20171124110440","PC","AAA02","5","75000","11500","63500","2017-11-24 11:04:40"
"6222","49","20171124094339","PC","AAA03","10","170000","30000","140000","2017-11-24 09:43:39"
"6223","42","20171124090400","Shop","AAA01","9","90000","18000","72000","2017-11-24 09:04:00"
"6224","22","20171124075602","PC","AAA02","1","15000","2300","12700","2017-11-24 07:56:02"
"6225","42","20171123031100","PC","AAA02","7","105000","16100","88900","2017-11-23 15:11:00"
"6226","53","20171123125127","Mobile","AAA02","1","15000","2300","12700","2017-11-23 12:51:27"
"6227","73","20171123105004","Mobile","AAA03","1","17000","3000","14000","2017-11-23 10:50:04"
"6228","84","20171123095012","PC","AAA04","2","16000","800","15200","2017-11-23 09:50:12"
"6229","46","20171123081628","Shop","AAA02","3","45000","6900","38100","2017-11-23 08:16:28"
"6230","81","20171123073503","PC","AAA05","9","540000","180000","360000","2017-11-23 07:35:03"
"6231","16","20171122052146","PC","AAA01","10","100000","20000","80000","2017-11-22 17:21:46"
"6232","100","20171122031942","Shop","AAA01","1","10000","2000","8000","2017-11-22 15:19:42"
"6233","10","20171122021951","PC","AAA02","2","30000","4600","25400","2017-11-22 14:19:51"
"6234","64","20171122124431","PC","AAA01","2","20000","4000","16000","2017-11-22 12:44:31"
"6235","5","20171122110902","Mobile","AAA05","1","60000","20000","40000","2017-11-22 11:09:02"
"6236","93","20171122032213","Shop","AAA05","11","660000","220000","440000","2017-11-22 03:22:13"
"6237","43","20171121071336","PC","AAA02","9","135000","20700","114300","2017-11-21 19:13:36"
"6238","38","20171121033830","Shop","AAA03","10","170000","30000","140000","2017-11-21 15:38:30"
"6239","83","20171121021127","PC","AAA01","12","120000","24000","96000","2017-11-21 14:11:27"
"6240","74","20171121124300","PC","AAA01","4","40000","8000","32000","2017-11-21 12:43:00"
"6241","59","20171121114009","Shop","AAA01","5","50000","10000","40000","2017-11-21 11:40:09"
"6242","36","20171121095206","Shop","AAA03","8","136000","24000","112000","2017-11-21 09:52:06"
"6243","31","20171121083916","PC","AAA03","3","51000","9000","42000","2017-11-21 08:39:16"
"6244","39","20171120093604","PC","AAA01","5","50000","10000","40000","2017-11-20 21:36:04"
"6245","38","20171120065707","Shop","AAA02","8","120000","18400","101600","2017-11-20 18:57:07"
"6246","100","20171120035658","PC","AAA05","5","300000","100000","200000","2017-11-20 15:56:58"
"6247","65","20171120022226","PC","AAA01","7","70000","14000","56000","2017-11-20 14:22:26"
"6248","9","20171120105911","Mobile","AAA04","2","16000","800","15200","2017-11-20 10:59:11"
"6249","30","20171120093911","Mobile","AAA01","7","70000","14000","56000","2017-11-20 09:39:11"
"6250","43","20171117085832","Mobile","AAA02","7","105000","16100","88900","2017-11-17 20:58:32"
"6251","42","20171117062831","Shop","AAA03","6","102000","18000","84000","2017-11-17 18:28:31"
"6252","81","20171117041856","Mobile","AAA01","4","40000","8000","32000","2017-11-17 16:18:56"
"6253","90","20171117031616","PC","AAA03","3","51000","9000","42000","2017-11-17 15:16:16"
"6254","26","20171117124945","Mobile","AAA03","1","17000","3000","14000","2017-11-17 12:49:45"
"6255","52","20171117120506","Shop","AAA02","1","15000","2300","12700","2017-11-17 12:05:06"
"6256","26","20171117094953","PC","AAA04","1","8000","400","7600","2017-11-17 09:49:53"
"6257","7","20171117080947","Shop","AAA04","3","24000","1200","22800","2017-11-17 08:09:47"
"6258","83","20171117065708","Mobile","AAA02","4","60000","9200","50800","2017-11-17 06:57:08"
"6259","38","20171116102548","PC","AAA01","9","90000","18000","72000","2017-11-16 22:25:48"
"6260","16","20171116050403","Shop","AAA02","2","30000","4600","25400","2017-11-16 17:04:03"
"6261","50","20171116035915","Mobile","AAA04","9","72000","3600","68400","2017-11-16 15:59:15"
"6262","17","20171116025721","Mobile","AAA01","1","10000","2000","8000","2017-11-16 14:57:21"
"6263","87","20171116020115","PC","AAA03","9","153000","27000","126000","2017-11-16 14:01:15"
"6264","49","20171116125844","Mobile","AAA03","7","119000","21000","98000","2017-11-16 12:58:44"
"6265","38","20171116114436","Mobile","AAA02","8","120000","18400","101600","2017-11-16 11:44:36"
"6266","62","20171116102448","Shop","AAA05","2","120000","40000","80000","2017-11-16 10:24:48"
"6267","29","20171116094141","Mobile","AAA04","10","80000","4000","76000","2017-11-16 09:41:41"
"6268","62","20171116063626","PC","AAA02","2","30000","4600","25400","2017-11-16 06:36:26"
"6269","62","20171115031130","Shop","AAA05","2","120000","40000","80000","2017-11-15 15:11:30"
"6270","13","20171115021916","Shop","AAA04","3","24000","1200","22800","2017-11-15 14:19:16"
"6271","97","20171115100857","Mobile","AAA03","6","102000","18000","84000","2017-11-15 10:08:57"
"6272","57","20171115090636","PC","AAA05","5","300000","100000","200000","2017-11-15 09:06:36"
"6273","100","20171114085607","Shop","AAA05","1","60000","20000","40000","2017-11-14 20:56:07"
"6274","18","20171114024922","Shop","AAA01","1","10000","2000","8000","2017-11-14 14:49:22"
"6275","33","20171114015527","PC","AAA05","4","240000","80000","160000","2017-11-14 13:55:27"
"6276","79","20171114124455","Shop","AAA05","5","300000","100000","200000","2017-11-14 12:44:55"
"6277","5","20171114115133","PC","AAA05","7","420000","140000","280000","2017-11-14 11:51:33"
"6278","62","20171114104023","Mobile","AAA03","9","153000","27000","126000","2017-11-14 10:40:23"
"6279","62","20171114091714","Mobile","AAA02","11","165000","25300","139700","2017-11-14 09:17:14"
"6280","48","20171114081020","Mobile","AAA02","1","15000","2300","12700","2017-11-14 08:10:20"
"6281","92","20171114064101","Mobile","AAA02","5","75000","11500","63500","2017-11-14 06:41:01"
"6282","39","20171113020733","PC","AAA01","3","30000","6000","24000","2017-11-13 14:07:33"
"6283","16","20171113122837","Mobile","AAA03","10","170000","30000","140000","2017-11-13 12:28:37"
"6284","77","20171113103212","Mobile","AAA01","4","40000","8000","32000","2017-11-13 10:32:12"
"6285","95","20171107025811","Mobile","AAA01","5","50000","10000","40000","2017-11-07 14:58:11"
"6286","80","20171107020752","Mobile","AAA02","1","15000","2300","12700","2017-11-07 14:07:52"
"6287","59","20171107123651","Mobile","AAA03","2","34000","6000","28000","2017-11-07 12:36:51"
"6288","13","20171107104436","Mobile","AAA02","5","75000","11500","63500","2017-11-07 10:44:36"
"6289","65","20171107092348","Mobile","AAA01","8","80000","16000","64000","2017-11-07 09:23:48"
"6290","94","20171107072939","Shop","AAA04","12","96000","4800","91200","2017-11-07 07:29:39"
"6291","25","20171106074718","PC","AAA01","3","30000","6000","24000","2017-11-06 19:47:18"
"6292","82","20171106061445","Mobile","AAA03","8","136000","24000","112000","2017-11-06 18:14:45"
"6293","74","20171106015408","Mobile","AAA03","4","68000","12000","56000","2017-11-06 13:54:08"
"6294","31","20171106113425","PC","AAA03","11","187000","33000","154000","2017-11-06 11:34:25"
"6295","44","20171106104140","Mobile","AAA01","4","40000","8000","32000","2017-11-06 10:41:40"
"6296","25","20171104054641","Shop","AAA02","1","15000","2300","12700","2017-11-04 05:46:41"
"6297","3","20171103125008","Mobile","AAA04","17","136000","6800","129200","2017-11-03 12:50:08"
"6298","73","20171103103020","Mobile","AAA05","9","540000","180000","360000","2017-11-03 10:30:20"
"6299","6","20171102112614","PC","AAA03","4","68000","12000","56000","2017-11-02 23:26:14"
"6300","2","20171102122636","Mobile","AAA01","5","50000","10000","40000","2017-11-02 12:26:36"
"6301","27","20171102105737","Mobile","AAA01","13","130000","26000","104000","2017-11-02 10:57:37"
"6302","38","20171102095044","Shop","AAA02","9","135000","20700","114300","2017-11-02 09:50:44"
"6303","48","20171102081512","PC","AAA05","10","600000","200000","400000","2017-11-02 08:15:12"
"6304","17","20171101081205","Mobile","AAA03","8","136000","24000","112000","2017-11-01 20:12:05"
"6305","36","20171101030756","Shop","AAA01","8","80000","16000","64000","2017-11-01 15:07:56"
"6306","85","20171101014516","PC","AAA04","5","40000","2000","38000","2017-11-01 13:45:16"
"6307","65","20171101121558","Mobile","AAA01","16","160000","32000","128000","2017-11-01 12:15:58"
"6308","14","20171101112824","Shop","AAA04","1","8000","400","7600","2017-11-01 11:28:24"
"6309","40","20171101094748","Shop","AAA05","3","180000","60000","120000","2017-11-01 09:47:48"
"6310","14","20171101080256","Shop","AAA05","4","240000","80000","160000","2017-11-01 08:02:56"
"6311","38","20171101070232","PC","AAA01","2","20000","4000","16000","2017-11-01 07:02:32"
"6312","66","20171031051209","Shop","AAA03","12","204000","36000","168000","2017-10-31 17:12:09"
"6313","25","20171031042004","Shop","AAA05","7","420000","140000","280000","2017-10-31 16:20:04"
"6314","19","20171031033729","Shop","AAA04","4","32000","1600","30400","2017-10-31 15:37:29"
"6315","76","20171031022627","PC","AAA02","3","45000","6900","38100","2017-10-31 14:26:27"
"6316","94","20171031115901","Shop","AAA05","10","600000","200000","400000","2017-10-31 11:59:01"
"6317","96","20171031095858","Shop","AAA05","16","960000","320000","640000","2017-10-31 09:58:58"
"6318","93","20171031085722","Mobile","AAA04","1","8000","400","7600","2017-10-31 08:57:22"
"6319","23","20171031073534","Mobile","AAA04","8","64000","3200","60800","2017-10-31 07:35:34"
"6320","24","20171030071127","Shop","AAA03","3","51000","9000","42000","2017-10-30 19:11:27"
"6321","55","20171030012721","Mobile","AAA01","7","70000","14000","56000","2017-10-30 13:27:21"
"6322","37","20171030115127","Shop","AAA02","3","45000","6900","38100","2017-10-30 11:51:27"
"6323","7","20171030111050","Shop","AAA01","8","80000","16000","64000","2017-10-30 11:10:50"
"6324","28","20171027032111","Mobile","AAA03","4","68000","12000","56000","2017-10-27 03:21:11"
"6325","46","20171026012433","Shop","AAA01","6","60000","12000","48000","2017-10-26 13:24:33"
"6326","48","20171026115311","PC","AAA03","1","17000","3000","14000","2017-10-26 11:53:11"
"6327","25","20171026102328","Shop","AAA01","7","70000","14000","56000","2017-10-26 10:23:28"
"6328","33","20171026083955","Shop","AAA04","1","8000","400","7600","2017-10-26 08:39:55"
"6329","44","20171026071348","PC","AAA05","5","300000","100000","200000","2017-10-26 07:13:48"
"6330","89","20171025073452","Shop","AAA01","15","150000","30000","120000","2017-10-25 19:34:52"
"6331","41","20171025122953","PC","AAA03","10","170000","30000","140000","2017-10-25 12:29:53"
"6332","51","20171025110017","Shop","AAA02","12","180000","27600","152400","2017-10-25 11:00:17"
"6333","25","20171025101803","PC","AAA01","5","50000","10000","40000","2017-10-25 10:18:03"
"6334","65","20171025092234","Shop","AAA05","12","720000","240000","480000","2017-10-25 09:22:34"
"6335","100","20171025080431","Mobile","AAA03","2","34000","6000","28000","2017-10-25 08:04:31"
"6336","33","20171025065034","Mobile","AAA01","3","30000","6000","24000","2017-10-25 06:50:34"
"6337","86","20171024105237","PC","AAA01","4","40000","8000","32000","2017-10-24 22:52:37"
"6338","34","20171024065252","Shop","AAA03","10","170000","30000","140000","2017-10-24 18:52:52"
"6339","10","20171024013938","Mobile","AAA01","15","150000","30000","120000","2017-10-24 13:39:38"
"6340","21","20171024124211","Mobile","AAA01","12","120000","24000","96000","2017-10-24 12:42:11"
"6341","62","20171024121500","Shop","AAA04","6","48000","2400","45600","2017-10-24 12:15:00"
"6342","69","20171024095242","PC","AAA03","8","136000","24000","112000","2017-10-24 09:52:42"
"6343","83","20171024085556","Mobile","AAA05","10","600000","200000","400000","2017-10-24 08:55:56"
"6344","87","20171024064014","Shop","AAA03","6","102000","18000","84000","2017-10-24 06:40:14"
"6345","65","20171023070034","Mobile","AAA03","8","136000","24000","112000","2017-10-23 19:00:34"
"6346","66","20171023013414","Shop","AAA03","2","34000","6000","28000","2017-10-23 13:34:14"
"6347","36","20171023123306","Mobile","AAA03","7","119000","21000","98000","2017-10-23 12:33:06"
"6348","4","20171023112326","Shop","AAA04","3","24000","1200","22800","2017-10-23 11:23:26"
"6349","44","20171023102433","Mobile","AAA03","8","136000","24000","112000","2017-10-23 10:24:33"
"6350","89","20171023100415","Shop","AAA02","7","105000","16100","88900","2017-10-23 10:04:15"
"6351","22","20171023083154","PC","AAA03","4","68000","12000","56000","2017-10-23 08:31:54"
"6352","76","20171020061731","PC","AAA04","2","16000","800","15200","2017-10-20 18:17:31"
"6353","69","20171020022100","Shop","AAA03","4","68000","12000","56000","2017-10-20 14:21:00"
"6354","99","20171020123614","Shop","AAA01","5","50000","10000","40000","2017-10-20 12:36:14"
"6355","33","20171020110019","Mobile","AAA05","3","180000","60000","120000","2017-10-20 11:00:19"
"6356","44","20171020090647","Mobile","AAA04","9","72000","3600","68400","2017-10-20 09:06:47"
"6357","14","20171020072922","Shop","AAA02","5","75000","11500","63500","2017-10-20 07:29:22"
"6358","13","20171019093303","Shop","AAA02","1","15000","2300","12700","2017-10-19 21:33:03"
"6359","64","20171019052033","Shop","AAA02","4","60000","9200","50800","2017-10-19 17:20:33"
"6360","6","20171019040100","PC","AAA03","2","34000","6000","28000","2017-10-19 16:01:00"
"6361","49","20171019013748","Mobile","AAA04","2","16000","800","15200","2017-10-19 13:37:48"
"6362","97","20171019122109","Shop","AAA01","2","20000","4000","16000","2017-10-19 12:21:09"
"6363","88","20171019111213","Shop","AAA01","1","10000","2000","8000","2017-10-19 11:12:13"
"6364","36","20171019095522","Shop","AAA03","16","272000","48000","224000","2017-10-19 09:55:22"
"6365","47","20171019083357","PC","AAA02","9","135000","20700","114300","2017-10-19 08:33:57"
"6366","59","20171019074307","Shop","AAA02","5","75000","11500","63500","2017-10-19 07:43:07"
"6367","12","20171018104901","Shop","AAA03","4","68000","12000","56000","2017-10-18 22:49:01"
"6368","95","20171018053045","Mobile","AAA02","6","90000","13800","76200","2017-10-18 17:30:45"
"6369","4","20171018035043","Shop","AAA04","3","24000","1200","22800","2017-10-18 15:50:43"
"6370","64","20171018111722","Shop","AAA03","5","85000","15000","70000","2017-10-18 11:17:22"
"6371","51","20171018094148","PC","AAA03","7","119000","21000","98000","2017-10-18 09:41:48"
"6372","66","20171018081051","Mobile","AAA04","1","8000","400","7600","2017-10-18 08:10:51"
"6373","35","20171018070404","Shop","AAA02","4","60000","9200","50800","2017-10-18 07:04:04"
"6374","8","20171017050924","Shop","AAA05","6","360000","120000","240000","2017-10-17 17:09:24"
"6375","21","20171017035425","Shop","AAA02","5","75000","11500","63500","2017-10-17 15:54:25"
"6376","11","20171017022646","Mobile","AAA01","4","40000","8000","32000","2017-10-17 14:26:46"
"6377","35","20171017125009","Mobile","AAA03","3","51000","9000","42000","2017-10-17 12:50:09"
"6378","62","20171017105621","PC","AAA03","12","204000","36000","168000","2017-10-17 10:56:21"
"6379","48","20171017091036","Mobile","AAA05","1","60000","20000","40000","2017-10-17 09:10:36"
"6380","94","20171017074038","PC","AAA05","8","480000","160000","320000","2017-10-17 07:40:38"
"6381","15","20171016035933","Shop","AAA01","7","70000","14000","56000","2017-10-16 15:59:33"
"6382","21","20171016015841","PC","AAA04","3","24000","1200","22800","2017-10-16 13:58:41"
"6383","34","20171016121932","Shop","AAA03","4","68000","12000","56000","2017-10-16 12:19:32"
"6384","94","20171016105252","Mobile","AAA05","6","360000","120000","240000","2017-10-16 10:52:52"
"6385","91","20171016090446","Mobile","AAA04","2","16000","800","15200","2017-10-16 09:04:46"
"6386","10","20171013112419","Mobile","AAA02","2","30000","4600","25400","2017-10-13 11:24:19"
"6387","11","20171013093258","PC","AAA01","7","70000","14000","56000","2017-10-13 09:32:58"
"6388","72","20171013084043","Shop","AAA03","8","136000","24000","112000","2017-10-13 08:40:43"
"6389","55","20171013072031","Shop","AAA01","4","40000","8000","32000","2017-10-13 07:20:31"
"6390","91","20171012063851","Shop","AAA01","6","60000","12000","48000","2017-10-12 18:38:51"
"6391","43","20171012011031","Shop","AAA03","8","136000","24000","112000","2017-10-12 13:10:31"
"6392","71","20171012114316","Shop","AAA01","4","40000","8000","32000","2017-10-12 11:43:16"
"6393","56","20171012110132","PC","AAA05","10","600000","200000","400000","2017-10-12 11:01:32"
"6394","98","20171012075742","Mobile","AAA01","3","30000","6000","24000","2017-10-12 07:57:42"
"6395","71","20171011011628","PC","AAA05","4","240000","80000","160000","2017-10-11 13:16:28"
"6396","35","20171011112637","Mobile","AAA04","3","24000","1200","22800","2017-10-11 11:26:37"
"6397","92","20171011101733","PC","AAA05","6","360000","120000","240000","2017-10-11 10:17:33"
"6398","42","20171011092304","Shop","AAA01","4","40000","8000","32000","2017-10-11 09:23:04"
"6399","83","20171011090756","Mobile","AAA05","12","720000","240000","480000","2017-10-11 09:07:56"
"6400","66","20171011072410","PC","AAA03","4","68000","12000","56000","2017-10-11 07:24:10"
"6401","38","20171010070915","Shop","AAA01","3","30000","6000","24000","2017-10-10 19:09:15"
"6402","63","20171010043140","Shop","AAA05","1","60000","20000","40000","2017-10-10 16:31:40"
"6403","21","20171010011818","Shop","AAA02","7","105000","16100","88900","2017-10-10 13:18:18"
"6404","98","20171010115919","Mobile","AAA04","2","16000","800","15200","2017-10-10 11:59:19"
"6405","55","20171010102547","PC","AAA04","5","40000","2000","38000","2017-10-10 10:25:47"
"6406","51","20171010094415","Mobile","AAA04","6","48000","2400","45600","2017-10-10 09:44:15"
"6407","39","20171010085407","PC","AAA05","6","360000","120000","240000","2017-10-10 08:54:07"
"6408","1","20171010075855","Mobile","AAA01","6","60000","12000","48000","2017-10-10 07:58:55"
"6409","6","20171009044252","Mobile","AAA04","5","40000","2000","38000","2017-10-09 16:42:52"
"6410","56","20171009031541","Mobile","AAA04","4","32000","1600","30400","2017-10-09 15:15:41"
"6411","92","20171009014854","PC","AAA04","9","72000","3600","68400","2017-10-09 13:48:54"
"6412","97","20171009121111","PC","AAA03","5","85000","15000","70000","2017-10-09 12:11:11"
"6413","38","20171009105741","PC","AAA02","2","30000","4600","25400","2017-10-09 10:57:41"
"6414","2","20171009081257","PC","AAA04","3","24000","1200","22800","2017-10-09 08:12:57"
"6415","79","20171005014304","Mobile","AAA03","7","119000","21000","98000","2017-10-05 13:43:04"
"6416","78","20171005121745","Mobile","AAA05","3","180000","60000","120000","2017-10-05 12:17:45"
"6417","71","20171005104519","Shop","AAA03","4","68000","12000","56000","2017-10-05 10:45:19"
"6418","92","20171005094328","Shop","AAA01","5","50000","10000","40000","2017-10-05 09:43:28"
"6419","62","20171005083708","Mobile","AAA03","8","136000","24000","112000","2017-10-05 08:37:08"
"6420","26","20171005072356","PC","AAA02","4","60000","9200","50800","2017-10-05 07:23:56"
"6421","26","20171005122956","PC","AAA01","7","70000","14000","56000","2017-10-05 00:29:56"
"6422","30","20171004063606","PC","AAA03","7","119000","21000","98000","2017-10-04 18:36:06"
"6423","89","20171004021355","Shop","AAA01","11","110000","22000","88000","2017-10-04 14:13:55"
"6424","94","20171004112241","Shop","AAA02","9","135000","20700","114300","2017-10-04 11:22:41"
"6425","3","20171004074939","PC","AAA01","12","120000","24000","96000","2017-10-04 07:49:39"
"6426","40","20171003032301","Mobile","AAA04","3","24000","1200","22800","2017-10-03 15:23:01"
"6427","15","20171003024208","PC","AAA01","8","80000","16000","64000","2017-10-03 14:42:08"
"6428","35","20171003011946","Shop","AAA05","1","60000","20000","40000","2017-10-03 13:19:46"
"6429","63","20171003113003","Mobile","AAA04","5","40000","2000","38000","2017-10-03 11:30:03"
"6430","53","20171003090814","Mobile","AAA04","1","8000","400","7600","2017-10-03 09:08:14"
"6431","38","20171003082731","Mobile","AAA03","2","34000","6000","28000","2017-10-03 08:27:31"
"6432","35","20171003064215","Mobile","AAA05","2","120000","40000","80000","2017-10-03 06:42:15"
"6433","82","20171002043517","PC","AAA04","7","56000","2800","53200","2017-10-02 16:35:17"
"6434","70","20171002032026","Mobile","AAA03","10","170000","30000","140000","2017-10-02 15:20:26"
"6435","75","20171002123819","Shop","AAA01","2","20000","4000","16000","2017-10-02 12:38:19"
"6436","7","20171002105234","Shop","AAA05","4","240000","80000","160000","2017-10-02 10:52:34"
"6437","42","20171002095454","Shop","AAA02","3","45000","6900","38100","2017-10-02 09:54:54"
"6438","49","20170930052630","PC","AAA03","7","119000","21000","98000","2017-09-30 17:26:30"
"6439","21","20170929122325","Shop","AAA05","4","240000","80000","160000","2017-09-29 12:23:25"
"6440","70","20170929101236","PC","AAA01","1","10000","2000","8000","2017-09-29 10:12:36"
"6441","76","20170929093800","Shop","AAA05","6","360000","120000","240000","2017-09-29 09:38:00"
"6442","91","20170929083616","Shop","AAA03","3","51000","9000","42000","2017-09-29 08:36:16"
"6443","54","20170929065400","Mobile","AAA01","5","50000","10000","40000","2017-09-29 06:54:00"
"6444","53","20170928043213","PC","AAA02","4","60000","9200","50800","2017-09-28 16:32:13"
"6445","56","20170928023849","Mobile","AAA03","6","102000","18000","84000","2017-09-28 14:38:49"
"6446","76","20170928012150","Shop","AAA05","1","60000","20000","40000","2017-09-28 13:21:50"
"6447","39","20170928124537","PC","AAA04","9","72000","3600","68400","2017-09-28 12:45:37"
"6448","48","20170928112209","Mobile","AAA03","3","51000","9000","42000","2017-09-28 11:22:09"
"6449","70","20170928095632","Mobile","AAA01","13","130000","26000","104000","2017-09-28 09:56:32"
"6450","54","20170928063738","PC","AAA02","5","75000","11500","63500","2017-09-28 06:37:38"
"6451","90","20170927070907","PC","AAA02","1","15000","2300","12700","2017-09-27 19:09:07"
"6452","48","20170927030923","Mobile","AAA04","4","32000","1600","30400","2017-09-27 15:09:23"
"6453","88","20170927015420","Shop","AAA05","5","300000","100000","200000","2017-09-27 13:54:20"
"6454","70","20170927121444","Shop","AAA05","12","720000","240000","480000","2017-09-27 12:14:44"
"6455","64","20170927094617","Mobile","AAA01","11","110000","22000","88000","2017-09-27 09:46:17"
"6456","89","20170927074625","Shop","AAA04","3","24000","1200","22800","2017-09-27 07:46:25"
"6457","40","20170926055055","Shop","AAA02","1","15000","2300","12700","2017-09-26 17:50:55"
"6458","5","20170926042751","Mobile","AAA05","3","180000","60000","120000","2017-09-26 16:27:51"
"6459","95","20170926031757","Mobile","AAA04","6","48000","2400","45600","2017-09-26 15:17:57"
"6460","74","20170926015318","PC","AAA02","3","45000","6900","38100","2017-09-26 13:53:18"
"6461","30","20170926121958","Shop","AAA05","5","300000","100000","200000","2017-09-26 12:19:58"
"6462","15","20170926112034","Shop","AAA01","10","100000","20000","80000","2017-09-26 11:20:34"
"6463","89","20170926095407","Mobile","AAA03","13","221000","39000","182000","2017-09-26 09:54:07"
"6464","83","20170926082422","PC","AAA05","8","480000","160000","320000","2017-09-26 08:24:22"
"6465","43","20170926072513","Mobile","AAA04","1","8000","400","7600","2017-09-26 07:25:13"
"6466","90","20170925072857","Mobile","AAA04","7","56000","2800","53200","2017-09-25 19:28:57"
"6467","12","20170925034238","Mobile","AAA01","1","10000","2000","8000","2017-09-25 15:42:38"
"6468","73","20170925023236","Mobile","AAA02","13","195000","29900","165100","2017-09-25 14:32:36"
"6469","27","20170925010206","Mobile","AAA05","8","480000","160000","320000","2017-09-25 13:02:06"
"6470","9","20170925010943","PC","AAA03","6","102000","18000","84000","2017-09-25 13:09:43"
"6471","50","20170925101150","Mobile","AAA03","3","51000","9000","42000","2017-09-25 10:11:50"
"6472","30","20170922013415","Shop","AAA03","6","102000","18000","84000","2017-09-22 01:34:15"
"6473","57","20170921060943","PC","AAA01","7","70000","14000","56000","2017-09-21 18:09:43"
"6474","81","20170921011127","PC","AAA05","3","180000","60000","120000","2017-09-21 13:11:27"
"6475","90","20170921120122","PC","AAA04","2","16000","800","15200","2017-09-21 12:01:22"
"6476","36","20170921102852","Mobile","AAA03","5","85000","15000","70000","2017-09-21 10:28:52"
"6477","49","20170921091957","Mobile","AAA03","7","119000","21000","98000","2017-09-21 09:19:57"
"6478","73","20170921083819","PC","AAA04","5","40000","2000","38000","2017-09-21 08:38:19"
"6479","49","20170921074449","Mobile","AAA03","7","119000","21000","98000","2017-09-21 07:44:49"
"6480","44","20170920043909","Shop","AAA02","5","75000","11500","63500","2017-09-20 16:39:09"
"6481","28","20170920011416","Shop","AAA03","9","153000","27000","126000","2017-09-20 13:14:16"
"6482","55","20170920115029","PC","AAA01","1","10000","2000","8000","2017-09-20 11:50:29"
"6483","72","20170920095239","Mobile","AAA02","7","105000","16100","88900","2017-09-20 09:52:39"
"6484","87","20170920081403","PC","AAA05","2","120000","40000","80000","2017-09-20 08:14:03"
"6485","75","20170920070609","Mobile","AAA02","4","60000","9200","50800","2017-09-20 07:06:09"
"6486","34","20170919085814","Mobile","AAA04","8","64000","3200","60800","2017-09-19 20:58:14"
"6487","95","20170919041200","PC","AAA05","8","480000","160000","320000","2017-09-19 16:12:00"
"6488","34","20170919021817","Mobile","AAA02","11","165000","25300","139700","2017-09-19 14:18:17"
"6489","89","20170919125939","Mobile","AAA01","14","140000","28000","112000","2017-09-19 12:59:39"
"6490","34","20170919091241","Shop","AAA01","12","120000","24000","96000","2017-09-19 09:12:41"
"6491","85","20170919080231","Mobile","AAA03","3","51000","9000","42000","2017-09-19 08:02:31"
"6492","13","20170918040216","Mobile","AAA01","1","10000","2000","8000","2017-09-18 16:02:16"
"6493","66","20170918025127","Mobile","AAA02","1","15000","2300","12700","2017-09-18 14:51:27"
"6494","94","20170918125405","PC","AAA01","15","150000","30000","120000","2017-09-18 12:54:05"
"6495","57","20170918114250","Mobile","AAA04","3","24000","1200","22800","2017-09-18 11:42:50"
"6496","25","20170918091734","PC","AAA03","7","119000","21000","98000","2017-09-18 09:17:34"
"6497","14","20170915063836","Mobile","AAA01","3","30000","6000","24000","2017-09-15 18:38:36"
"6498","67","20170915120530","PC","AAA03","11","187000","33000","154000","2017-09-15 12:05:30"
"6499","3","20170915104733","Mobile","AAA05","11","660000","220000","440000","2017-09-15 10:47:33"
"6500","9","20170915092221","Mobile","AAA05","1","60000","20000","40000","2017-09-15 09:22:21"
"6501","94","20170915081059","PC","AAA02","8","120000","18400","101600","2017-09-15 08:10:59"
"6502","30","20170915065403","Shop","AAA05","3","180000","60000","120000","2017-09-15 06:54:03"
"6503","65","20170914111141","Mobile","AAA01","2","20000","4000","16000","2017-09-14 23:11:41"
"6504","26","20170914032100","Shop","AAA01","3","30000","6000","24000","2017-09-14 15:21:00"
"6505","45","20170914022226","Mobile","AAA03","6","102000","18000","84000","2017-09-14 14:22:26"
"6506","59","20170914012733","Shop","AAA05","4","240000","80000","160000","2017-09-14 13:27:33"
"6507","96","20170914122514","Shop","AAA05","3","180000","60000","120000","2017-09-14 12:25:14"
"6508","54","20170914113258","PC","AAA02","2","30000","4600","25400","2017-09-14 11:32:58"
"6509","97","20170914092855","PC","AAA04","10","80000","4000","76000","2017-09-14 09:28:55"
"6510","27","20170914075957","Mobile","AAA01","6","60000","12000","48000","2017-09-14 07:59:57"
"6511","60","20170913052548","PC","AAA01","6","60000","12000","48000","2017-09-13 17:25:48"
"6512","32","20170913030734","PC","AAA04","1","8000","400","7600","2017-09-13 15:07:34"
"6513","39","20170913014937","Shop","AAA03","6","102000","18000","84000","2017-09-13 13:49:37"
"6514","79","20170913121639","Mobile","AAA01","4","40000","8000","32000","2017-09-13 12:16:39"
"6515","1","20170913110123","Shop","AAA01","5","50000","10000","40000","2017-09-13 11:01:23"
"6516","16","20170913085612","Shop","AAA05","1","60000","20000","40000","2017-09-13 08:56:12"
"6517","69","20170913070806","Mobile","AAA05","1","60000","20000","40000","2017-09-13 07:08:06"
"6518","85","20170912102854","Mobile","AAA04","5","40000","2000","38000","2017-09-12 10:28:54"
"6519","83","20170912090104","PC","AAA04","2","16000","800","15200","2017-09-12 09:01:04"
"6520","87","20170912080255","Shop","AAA05","2","120000","40000","80000","2017-09-12 08:02:55"
"6521","11","20170911014829","PC","AAA05","5","300000","100000","200000","2017-09-11 13:48:29"
"6522","40","20170911010941","Mobile","AAA01","2","20000","4000","16000","2017-09-11 13:09:41"
"6523","88","20170911114900","Shop","AAA05","6","360000","120000","240000","2017-09-11 11:49:00"
"6524","8","20170911100628","PC","AAA01","8","80000","16000","64000","2017-09-11 10:06:28"
"6525","75","20170911084718","PC","AAA05","5","300000","100000","200000","2017-09-11 08:47:18"
"6526","30","20170908071534","PC","AAA04","10","80000","4000","76000","2017-09-08 19:15:34"
"6527","5","20170908025613","PC","AAA04","6","48000","2400","45600","2017-09-08 14:56:13"
"6528","30","20170908013518","Mobile","AAA02","7","105000","16100","88900","2017-09-08 13:35:18"
"6529","39","20170908102603","Mobile","AAA03","2","34000","6000","28000","2017-09-08 10:26:03"
"6530","43","20170908091047","PC","AAA03","4","68000","12000","56000","2017-09-08 09:10:47"
"6531","84","20170908074541","PC","AAA02","3","45000","6900","38100","2017-09-08 07:45:41"
"6532","54","20170907040211","Mobile","AAA02","8","120000","18400","101600","2017-09-07 16:02:11"
"6533","2","20170907030803","PC","AAA01","2","20000","4000","16000","2017-09-07 15:08:03"
"6534","5","20170907015320","Mobile","AAA04","8","64000","3200","60800","2017-09-07 13:53:20"
"6535","38","20170907123819","Mobile","AAA04","8","64000","3200","60800","2017-09-07 12:38:19"
"6536","35","20170907115704","Shop","AAA02","1","15000","2300","12700","2017-09-07 11:57:04"
"6537","100","20170907101405","PC","AAA02","4","60000","9200","50800","2017-09-07 10:14:05"
"6538","40","20170907080928","Mobile","AAA01","3","30000","6000","24000","2017-09-07 08:09:28"
"6539","57","20170907061824","Shop","AAA02","5","75000","11500","63500","2017-09-07 06:18:24"
"6540","70","20170906071642","PC","AAA05","6","360000","120000","240000","2017-09-06 19:16:42"
"6541","50","20170906023904","Shop","AAA04","8","64000","3200","60800","2017-09-06 14:39:04"
"6542","17","20170906124038","PC","AAA01","2","20000","4000","16000","2017-09-06 12:40:38"
"6543","45","20170906112155","Mobile","AAA05","7","420000","140000","280000","2017-09-06 11:21:55"
"6544","89","20170906100010","PC","AAA04","9","72000","3600","68400","2017-09-06 10:00:10"
"6545","80","20170906094345","Mobile","AAA03","5","85000","15000","70000","2017-09-06 09:43:45"
"6546","50","20170906082225","Mobile","AAA01","8","80000","16000","64000","2017-09-06 08:22:25"
"6547","17","20170906072813","Mobile","AAA02","4","60000","9200","50800","2017-09-06 07:28:13"
"6548","100","20170906041456","Shop","AAA05","5","300000","100000","200000","2017-09-06 04:14:56"
"6549","60","20170905120628","Mobile","AAA04","1","8000","400","7600","2017-09-05 12:06:28"
"6550","83","20170905101439","Shop","AAA05","6","360000","120000","240000","2017-09-05 10:14:39"
"6551","86","20170905094348","PC","AAA03","1","17000","3000","14000","2017-09-05 09:43:48"
"6552","52","20170905065427","Mobile","AAA01","3","30000","6000","24000","2017-09-05 06:54:27"
"6553","23","20170904072329","Shop","AAA05","6","360000","120000","240000","2017-09-04 19:23:29"
"6554","68","20170904044405","PC","AAA02","6","90000","13800","76200","2017-09-04 16:44:05"
"6555","85","20170904021145","Mobile","AAA02","8","120000","18400","101600","2017-09-04 14:11:45"
"6556","3","20170904124914","PC","AAA05","10","600000","200000","400000","2017-09-04 12:49:14"
"6557","83","20170904111747","PC","AAA01","15","150000","30000","120000","2017-09-04 11:17:47"
"6558","17","20170904103504","PC","AAA05","4","240000","80000","160000","2017-09-04 10:35:04"
"6559","67","20170904092544","Mobile","AAA04","1","8000","400","7600","2017-09-04 09:25:44"
"6560","27","20170830054842","PC","AAA02","12","180000","27600","152400","2017-08-30 05:48:42"
"6561","59","20170829053633","PC","AAA01","4","40000","8000","32000","2017-08-29 17:36:33"
"6562","27","20170829040906","Shop","AAA03","5","85000","15000","70000","2017-08-29 16:09:06"
"6563","64","20170829020829","Mobile","AAA05","2","120000","40000","80000","2017-08-29 14:08:29"
"6564","23","20170829123850","Mobile","AAA05","3","180000","60000","120000","2017-08-29 12:38:50"
"6565","23","20170829105711","PC","AAA05","10","600000","200000","400000","2017-08-29 10:57:11"
"6566","43","20170829090847","Shop","AAA02","5","75000","11500","63500","2017-08-29 09:08:47"
"6567","78","20170829081539","Mobile","AAA04","5","40000","2000","38000","2017-08-29 08:15:39"
"6568","99","20170829073930","PC","AAA01","4","40000","8000","32000","2017-08-29 07:39:30"
"6569","50","20170829121754","Mobile","AAA02","3","45000","6900","38100","2017-08-29 00:17:54"
"6570","57","20170828092559","PC","AAA05","1","60000","20000","40000","2017-08-28 09:25:59"
"6571","55","20170825120807","PC","AAA04","8","64000","3200","60800","2017-08-25 00:08:07"
"6572","26","20170824084200","Shop","AAA05","1","60000","20000","40000","2017-08-24 08:42:00"
"6573","48","20170823115512","PC","AAA01","2","20000","4000","16000","2017-08-23 23:55:12"
"6574","44","20170823042452","Shop","AAA02","6","90000","13800","76200","2017-08-23 16:24:52"
"6575","56","20170823034543","Shop","AAA04","7","56000","2800","53200","2017-08-23 15:45:43"
"6576","75","20170823023014","Mobile","AAA03","6","102000","18000","84000","2017-08-23 14:30:14"
"6577","65","20170823114427","Mobile","AAA01","4","40000","8000","32000","2017-08-23 11:44:27"
"6578","79","20170823100540","PC","AAA05","9","540000","180000","360000","2017-08-23 10:05:40"
"6579","80","20170823083308","Mobile","AAA05","6","360000","120000","240000","2017-08-23 08:33:08"
"6580","73","20170822100811","Mobile","AAA02","5","75000","11500","63500","2017-08-22 22:08:11"
"6581","34","20170822061703","PC","AAA03","5","85000","15000","70000","2017-08-22 18:17:03"
"6582","38","20170822033614","Mobile","AAA05","5","300000","100000","200000","2017-08-22 15:36:14"
"6583","31","20170822022835","PC","AAA04","5","40000","2000","38000","2017-08-22 14:28:35"
"6584","32","20170822010131","Shop","AAA03","9","153000","27000","126000","2017-08-22 13:01:31"
"6585","10","20170822120009","Shop","AAA05","7","420000","140000","280000","2017-08-22 12:00:09"
"6586","84","20170822094343","PC","AAA01","2","20000","4000","16000","2017-08-22 09:43:43"
"6587","18","20170822081116","Shop","AAA05","4","240000","80000","160000","2017-08-22 08:11:16"
"6588","8","20170822062911","Shop","AAA03","5","85000","15000","70000","2017-08-22 06:29:11"
"6589","80","20170821022637","Shop","AAA04","3","24000","1200","22800","2017-08-21 14:26:37"
"6590","88","20170821121648","Shop","AAA01","4","40000","8000","32000","2017-08-21 12:16:48"
"6591","61","20170821104257","Shop","AAA05","2","120000","40000","80000","2017-08-21 10:42:57"
"6592","17","20170820031322","Mobile","AAA03","2","34000","6000","28000","2017-08-20 03:13:22"
"6593","39","20170816061456","Mobile","AAA01","8","80000","16000","64000","2017-08-16 18:14:56"
"6594","27","20170816111557","PC","AAA03","5","85000","15000","70000","2017-08-16 11:15:57"
"6595","31","20170816094217","Shop","AAA01","4","40000","8000","32000","2017-08-16 09:42:17"
"6596","100","20170816083605","PC","AAA05","2","120000","40000","80000","2017-08-16 08:36:05"
"6597","80","20170816065145","Shop","AAA04","7","56000","2800","53200","2017-08-16 06:51:45"
"6598","97","20170815115945","Mobile","AAA05","1","60000","20000","40000","2017-08-15 23:59:45"
"6599","33","20170815121435","Mobile","AAA01","6","60000","12000","48000","2017-08-15 12:14:35"
"6600","78","20170815110307","PC","AAA01","4","40000","8000","32000","2017-08-15 11:03:07"
"6601","8","20170815100832","PC","AAA05","5","300000","100000","200000","2017-08-15 10:08:32"
"6602","91","20170815085151","PC","AAA02","3","45000","6900","38100","2017-08-15 08:51:51"
"6603","66","20170815080406","Mobile","AAA04","4","32000","1600","30400","2017-08-15 08:04:06"
"6604","31","20170815062037","Mobile","AAA03","5","85000","15000","70000","2017-08-15 06:20:37"
"6605","24","20170814031517","Shop","AAA05","9","540000","180000","360000","2017-08-14 15:15:17"
"6606","21","20170814110335","Shop","AAA05","11","660000","220000","440000","2017-08-14 11:03:35"
"6607","37","20170814101956","Mobile","AAA02","5","75000","11500","63500","2017-08-14 10:19:56"
"6608","37","20170814084644","Mobile","AAA01","3","30000","6000","24000","2017-08-14 08:46:44"
"6609","52","20170810063952","PC","AAA03","1","17000","3000","14000","2017-08-10 06:39:52"
"6610","58","20170809092352","Mobile","AAA04","4","32000","1600","30400","2017-08-09 21:23:52"
"6611","98","20170809042426","Shop","AAA03","6","102000","18000","84000","2017-08-09 16:24:26"
"6612","8","20170809030039","Mobile","AAA04","7","56000","2800","53200","2017-08-09 15:00:39"
"6613","99","20170809012705","Mobile","AAA04","2","16000","800","15200","2017-08-09 13:27:05"
"6614","81","20170809122306","Shop","AAA03","2","34000","6000","28000","2017-08-09 12:23:06"
"6615","16","20170809085038","Mobile","AAA02","7","105000","16100","88900","2017-08-09 08:50:38"
"6616","46","20170809063309","PC","AAA05","1","60000","20000","40000","2017-08-09 06:33:09"
"6617","89","20170808010146","Mobile","AAA01","19","190000","38000","152000","2017-08-08 01:01:46"
"6618","41","20170807103401","Mobile","AAA01","3","30000","6000","24000","2017-08-07 10:34:01"
"6619","33","20170807094834","Mobile","AAA05","4","240000","80000","160000","2017-08-07 09:48:34"
"6620","66","20170802044136","Mobile","AAA05","5","300000","100000","200000","2017-08-02 16:41:36"
"6621","58","20170802032653","PC","AAA05","1","60000","20000","40000","2017-08-02 15:26:53"
"6622","23","20170802022314","Mobile","AAA04","12","96000","4800","91200","2017-08-02 14:23:14"
"6623","86","20170802012212","Mobile","AAA05","3","180000","60000","120000","2017-08-02 13:22:12"
"6624","10","20170802110730","PC","AAA04","10","80000","4000","76000","2017-08-02 11:07:30"
"6625","69","20170802093222","Shop","AAA05","4","240000","80000","160000","2017-08-02 09:32:22"
"6626","98","20170802081616","Shop","AAA01","5","50000","10000","40000","2017-08-02 08:16:16"
"6627","78","20170802063326","PC","AAA03","2","34000","6000","28000","2017-08-02 06:33:26"
"6628","99","20170801092022","Mobile","AAA05","9","540000","180000","360000","2017-08-01 09:20:22"
"6629","77","20170801074133","PC","AAA04","2","16000","800","15200","2017-08-01 07:41:33"
"6630","12","20170801022034","Shop","AAA02","2","30000","4600","25400","2017-08-01 02:20:34"
"6631","28","20170731021631","Shop","AAA03","8","136000","24000","112000","2017-07-31 14:16:31"
"6632","60","20170731112442","PC","AAA03","1","17000","3000","14000","2017-07-31 11:24:42"
"6633","54","20170731103145","Mobile","AAA01","2","20000","4000","16000","2017-07-31 10:31:45"
"6634","24","20170731091104","Mobile","AAA03","8","136000","24000","112000","2017-07-31 09:11:04"
"6635","48","20170727095931","Shop","AAA05","2","120000","40000","80000","2017-07-27 21:59:31"
"6636","52","20170727050850","Mobile","AAA05","6","360000","120000","240000","2017-07-27 17:08:50"
"6637","33","20170727030845","Shop","AAA02","5","75000","11500","63500","2017-07-27 15:08:45"
"6638","65","20170727022453","Shop","AAA02","6","90000","13800","76200","2017-07-27 14:24:53"
"6639","16","20170727011007","Mobile","AAA03","15","255000","45000","210000","2017-07-27 13:10:07"
"6640","74","20170727122000","PC","AAA01","8","80000","16000","64000","2017-07-27 12:20:00"
"6641","71","20170727110817","PC","AAA02","4","60000","9200","50800","2017-07-27 11:08:17"
"6642","98","20170727073511","PC","AAA03","1","17000","3000","14000","2017-07-27 07:35:11"
"6643","38","20170726092804","Shop","AAA02","5","75000","11500","63500","2017-07-26 21:28:04"
"6644","55","20170726022320","PC","AAA01","1","10000","2000","8000","2017-07-26 14:23:20"
"6645","41","20170726010801","PC","AAA03","7","119000","21000","98000","2017-07-26 13:08:01"
"6646","93","20170726112707","Shop","AAA02","7","105000","16100","88900","2017-07-26 11:27:07"
"6647","10","20170726101215","PC","AAA01","10","100000","20000","80000","2017-07-26 10:12:15"
"6648","54","20170726083529","Shop","AAA03","5","85000","15000","70000","2017-07-26 08:35:29"
"6649","28","20170726073252","PC","AAA02","10","150000","23000","127000","2017-07-26 07:32:52"
"6650","27","20170725035428","Shop","AAA05","3","180000","60000","120000","2017-07-25 15:54:28"
"6651","82","20170725025409","PC","AAA01","5","50000","10000","40000","2017-07-25 14:54:09"
"6652","88","20170725123456","Mobile","AAA05","4","240000","80000","160000","2017-07-25 12:34:56"
"6653","68","20170725112829","Shop","AAA04","4","32000","1600","30400","2017-07-25 11:28:29"
"6654","97","20170725103231","Mobile","AAA01","7","70000","14000","56000","2017-07-25 10:32:31"
"6655","15","20170725090249","Mobile","AAA03","7","119000","21000","98000","2017-07-25 09:02:49"
"6656","77","20170725065905","Shop","AAA04","1","8000","400","7600","2017-07-25 06:59:05"
"6657","9","20170724053422","Shop","AAA01","5","50000","10000","40000","2017-07-24 17:34:22"
"6658","82","20170724042403","Mobile","AAA04","6","48000","2400","45600","2017-07-24 16:24:03"
"6659","95","20170724032351","Mobile","AAA01","7","70000","14000","56000","2017-07-24 15:23:51"
"6660","54","20170724013112","Mobile","AAA03","12","204000","36000","168000","2017-07-24 13:31:12"
"6661","42","20170724121912","Mobile","AAA03","1","17000","3000","14000","2017-07-24 12:19:12"
"6662","48","20170724111500","Shop","AAA04","6","48000","2400","45600","2017-07-24 11:15:00"
"6663","72","20170724090045","Shop","AAA04","12","96000","4800","91200","2017-07-24 09:00:45"
"6664","63","20170720065610","Mobile","AAA03","8","136000","24000","112000","2017-07-20 06:56:10"
"6665","50","20170720031126","Shop","AAA05","11","660000","220000","440000","2017-07-20 03:11:26"
"6666","15","20170719101253","Shop","AAA04","17","136000","6800","129200","2017-07-19 10:12:53"
"6667","25","20170719081643","PC","AAA05","8","480000","160000","320000","2017-07-19 08:16:43"
"6668","72","20170718025627","Mobile","AAA05","1","60000","20000","40000","2017-07-18 14:56:27"
"6669","15","20170718113554","PC","AAA02","11","165000","25300","139700","2017-07-18 11:35:54"
"6670","80","20170718094613","PC","AAA04","3","24000","1200","22800","2017-07-18 09:46:13"
"6671","8","20170718083230","PC","AAA04","3","24000","1200","22800","2017-07-18 08:32:30"
"6672","49","20170718065538","PC","AAA04","7","56000","2800","53200","2017-07-18 06:55:38"
"6673","68","20170717112235","Shop","AAA01","7","70000","14000","56000","2017-07-17 23:22:35"
"6674","94","20170717091043","Mobile","AAA01","11","110000","22000","88000","2017-07-17 09:10:43"
"6675","71","20170712042258","PC","AAA03","1","17000","3000","14000","2017-07-12 04:22:58"
"6676","54","20170711084215","PC","AAA01","2","20000","4000","16000","2017-07-11 20:42:15"
"6677","57","20170711041444","Mobile","AAA02","3","45000","6900","38100","2017-07-11 16:14:44"
"6678","74","20170711025119","Shop","AAA02","4","60000","9200","50800","2017-07-11 14:51:19"
"6679","74","20170711123039","Mobile","AAA04","6","48000","2400","45600","2017-07-11 12:30:39"
"6680","14","20170711121235","PC","AAA01","12","120000","24000","96000","2017-07-11 12:12:35"
"6681","34","20170711101238","Shop","AAA05","8","480000","160000","320000","2017-07-11 10:12:38"
"6682","100","20170711095133","Mobile","AAA04","8","64000","3200","60800","2017-07-11 09:51:33"
"6683","49","20170711064233","Mobile","AAA01","7","70000","14000","56000","2017-07-11 06:42:33"
"6684","94","20170710052151","PC","AAA03","7","119000","21000","98000","2017-07-10 17:21:51"
"6685","56","20170710035806","Shop","AAA02","6","90000","13800","76200","2017-07-10 15:58:06"
"6686","95","20170710025756","PC","AAA05","7","420000","140000","280000","2017-07-10 14:57:56"
"6687","97","20170710013623","Shop","AAA02","6","90000","13800","76200","2017-07-10 13:36:23"
"6688","67","20170710105854","Shop","AAA03","7","119000","21000","98000","2017-07-10 10:58:54"
"6689","3","20170710095825","PC","AAA03","21","357000","63000","294000","2017-07-10 09:58:25"
"6690","95","20170707051458","PC","AAA05","3","180000","60000","120000","2017-07-07 05:14:58"
"6691","71","20170706105151","Mobile","AAA05","6","360000","120000","240000","2017-07-06 22:51:51"
"6692","11","20170706065537","Mobile","AAA03","8","136000","24000","112000","2017-07-06 18:55:37"
"6693","19","20170706115117","Shop","AAA01","3","30000","6000","24000","2017-07-06 11:51:17"
"6694","50","20170706101054","Shop","AAA05","2","120000","40000","80000","2017-07-06 10:10:54"
"6695","42","20170706081119","Mobile","AAA05","8","480000","160000","320000","2017-07-06 08:11:19"
"6696","50","20170706065416","Mobile","AAA04","2","16000","800","15200","2017-07-06 06:54:16"
"6697","3","20170705050653","Mobile","AAA02","10","150000","23000","127000","2017-07-05 17:06:53"
"6698","66","20170705033425","Shop","AAA04","1","8000","400","7600","2017-07-05 15:34:25"
"6699","39","20170705121845","Shop","AAA05","12","720000","240000","480000","2017-07-05 12:18:45"
"6700","1","20170705113304","PC","AAA05","3","180000","60000","120000","2017-07-05 11:33:04"
"6701","33","20170705084302","Mobile","AAA04","1","8000","400","7600","2017-07-05 08:43:02"
"6702","18","20170705070925","Mobile","AAA01","1","10000","2000","8000","2017-07-05 07:09:25"
"6703","5","20170704025628","Mobile","AAA04","5","40000","2000","38000","2017-07-04 14:56:28"
"6704","22","20170704014653","Shop","AAA04","5","40000","2000","38000","2017-07-04 13:46:53"
"6705","100","20170704123948","PC","AAA04","1","8000","400","7600","2017-07-04 12:39:48"
"6706","12","20170704112350","Mobile","AAA04","1","8000","400","7600","2017-07-04 11:23:50"
"6707","16","20170704094245","Shop","AAA05","4","240000","80000","160000","2017-07-04 09:42:45"
"6708","41","20170704073505","PC","AAA02","6","90000","13800","76200","2017-07-04 07:35:05"
"6709","17","20170703021517","Mobile","AAA04","4","32000","1600","30400","2017-07-03 14:15:17"
"6710","74","20170703122154","PC","AAA01","3","30000","6000","24000","2017-07-03 12:21:54"
"6711","45","20170703105035","PC","AAA05","3","180000","60000","120000","2017-07-03 10:50:35"
"6712","96","20170703094830","Shop","AAA05","7","420000","140000","280000","2017-07-03 09:48:30"
"6713","93","20170628081216","Shop","AAA05","1","60000","20000","40000","2017-06-28 08:12:16"
"6714","72","20170628071752","Mobile","AAA02","7","105000","16100","88900","2017-06-28 07:17:52"
"6715","68","20170627033814","Mobile","AAA02","5","75000","11500","63500","2017-06-27 15:38:14"
"6716","70","20170627025325","Shop","AAA03","2","34000","6000","28000","2017-06-27 14:53:25"
"6717","27","20170627014319","Shop","AAA03","14","238000","42000","196000","2017-06-27 13:43:19"
"6718","37","20170627121301","PC","AAA01","14","140000","28000","112000","2017-06-27 12:13:01"
"6719","3","20170627101607","Shop","AAA04","4","32000","1600","30400","2017-06-27 10:16:07"
"6720","6","20170627084918","Mobile","AAA03","5","85000","15000","70000","2017-06-27 08:49:18"
"6721","10","20170627064301","Shop","AAA03","9","153000","27000","126000","2017-06-27 06:43:01"
"6722","35","20170626060930","Shop","AAA03","4","68000","12000","56000","2017-06-26 18:09:30"
"6723","81","20170626123825","Shop","AAA04","2","16000","800","15200","2017-06-26 12:38:25"
"6724","42","20170626110906","Mobile","AAA03","5","85000","15000","70000","2017-06-26 11:09:06"
"6725","34","20170624010206","PC","AAA01","7","70000","14000","56000","2017-06-24 13:02:06"
"6726","31","20170623040600","Mobile","AAA02","1","15000","2300","12700","2017-06-23 16:06:00"
"6727","93","20170623023019","Shop","AAA01","5","50000","10000","40000","2017-06-23 14:30:19"
"6728","32","20170623123013","Shop","AAA05","9","540000","180000","360000","2017-06-23 12:30:13"
"6729","48","20170623113127","Mobile","AAA03","2","34000","6000","28000","2017-06-23 11:31:27"
"6730","39","20170623084831","PC","AAA01","5","50000","10000","40000","2017-06-23 08:48:31"
"6731","87","20170623075827","Shop","AAA05","5","300000","100000","200000","2017-06-23 07:58:27"
"6732","82","20170623011623","Mobile","AAA02","5","75000","11500","63500","2017-06-23 01:16:23"
"6733","83","20170622035742","Shop","AAA03","9","153000","27000","126000","2017-06-22 15:57:42"
"6734","94","20170622020859","Shop","AAA02","9","135000","20700","114300","2017-06-22 14:08:59"
"6735","36","20170622125206","PC","AAA05","13","780000","260000","520000","2017-06-22 12:52:06"
"6736","15","20170622090611","Shop","AAA02","16","240000","36800","203200","2017-06-22 09:06:11"
"6737","93","20170622080140","Mobile","AAA05","1","60000","20000","40000","2017-06-22 08:01:40"
"6738","3","20170622055946","Mobile","AAA01","10","100000","20000","80000","2017-06-22 05:59:46"
"6739","14","20170621060231","PC","AAA02","7","105000","16100","88900","2017-06-21 18:02:31"
"6740","19","20170621032347","PC","AAA02","4","60000","9200","50800","2017-06-21 15:23:47"
"6741","79","20170621021459","Shop","AAA05","7","420000","140000","280000","2017-06-21 14:14:59"
"6742","59","20170621124449","Shop","AAA02","3","45000","6900","38100","2017-06-21 12:44:49"
"6743","22","20170621112224","Mobile","AAA03","4","68000","12000","56000","2017-06-21 11:22:24"
"6744","36","20170621103019","Mobile","AAA01","5","50000","10000","40000","2017-06-21 10:30:19"
"6745","3","20170621094913","PC","AAA04","15","120000","6000","114000","2017-06-21 09:49:13"
"6746","30","20170621082744","Mobile","AAA03","11","187000","33000","154000","2017-06-21 08:27:44"
"6747","47","20170621071643","Mobile","AAA01","5","50000","10000","40000","2017-06-21 07:16:43"
"6748","93","20170621015554","Shop","AAA03","6","102000","18000","84000","2017-06-21 01:55:54"
"6749","78","20170620052114","Shop","AAA01","4","40000","8000","32000","2017-06-20 17:21:14"
"6750","49","20170620034828","Mobile","AAA01","12","120000","24000","96000","2017-06-20 15:48:28"
"6751","30","20170620021026","Shop","AAA04","3","24000","1200","22800","2017-06-20 14:10:26"
"6752","57","20170620121048","Mobile","AAA05","6","360000","120000","240000","2017-06-20 12:10:48"
"6753","79","20170620102330","Shop","AAA02","9","135000","20700","114300","2017-06-20 10:23:30"
"6754","89","20170620093936","Shop","AAA04","11","88000","4400","83600","2017-06-20 09:39:36"
"6755","69","20170620074258","PC","AAA03","4","68000","12000","56000","2017-06-20 07:42:58"
"6756","22","20170619012759","PC","AAA04","9","72000","3600","68400","2017-06-19 13:27:59"
"6757","75","20170619115802","Mobile","AAA05","4","240000","80000","160000","2017-06-19 11:58:02"
"6758","69","20170619100935","PC","AAA03","6","102000","18000","84000","2017-06-19 10:09:35"
"6759","98","20170618065439","PC","AAA02","3","45000","6900","38100","2017-06-18 06:54:39"
"6760","98","20170615113126","Mobile","AAA01","2","20000","4000","16000","2017-06-15 23:31:26"
"6761","97","20170615040237","Shop","AAA02","5","75000","11500","63500","2017-06-15 04:02:37"
"6762","82","20170614030102","Mobile","AAA03","3","51000","9000","42000","2017-06-14 15:01:02"
"6763","89","20170614022424","Mobile","AAA04","21","168000","8400","159600","2017-06-14 14:24:24"
"6764","25","20170614121943","Mobile","AAA01","1","10000","2000","8000","2017-06-14 12:19:43"
"6765","79","20170614105215","Mobile","AAA01","3","30000","6000","24000","2017-06-14 10:52:15"
"6766","3","20170614094756","Mobile","AAA01","17","170000","34000","136000","2017-06-14 09:47:56"
"6767","25","20170614074610","PC","AAA03","8","136000","24000","112000","2017-06-14 07:46:10"
"6768","30","20170613015855","Shop","AAA01","8","80000","16000","64000","2017-06-13 13:58:55"
"6769","55","20170613011719","PC","AAA03","3","51000","9000","42000","2017-06-13 13:17:19"
"6770","26","20170613105238","PC","AAA03","4","68000","12000","56000","2017-06-13 10:52:38"
"6771","23","20170613085237","Shop","AAA04","7","56000","2800","53200","2017-06-13 08:52:37"
"6772","19","20170613080205","Mobile","AAA02","1","15000","2300","12700","2017-06-13 08:02:05"
"6773","8","20170613072357","Mobile","AAA03","8","136000","24000","112000","2017-06-13 07:23:57"
"6774","80","20170612025455","PC","AAA05","4","240000","80000","160000","2017-06-12 14:54:55"
"6775","90","20170612013715","PC","AAA04","1","8000","400","7600","2017-06-12 13:37:15"
"6776","43","20170612105710","PC","AAA01","11","110000","22000","88000","2017-06-12 10:57:10"
"6777","92","20170612103332","PC","AAA03","9","153000","27000","126000","2017-06-12 10:33:32"
"6778","35","20170612092545","Mobile","AAA03","7","119000","21000","98000","2017-06-12 09:25:45"
"6779","94","20170608115323","PC","AAA03","5","85000","15000","70000","2017-06-08 11:53:23"
"6780","34","20170608084007","Mobile","AAA01","9","90000","18000","72000","2017-06-08 08:40:07"
"6781","13","20170608070025","PC","AAA05","2","120000","40000","80000","2017-06-08 07:00:25"
"6782","6","20170607022804","Mobile","AAA03","3","51000","9000","42000","2017-06-07 14:28:04"
"6783","47","20170607125034","PC","AAA03","5","85000","15000","70000","2017-06-07 12:50:34"
"6784","23","20170607111011","Mobile","AAA04","8","64000","3200","60800","2017-06-07 11:10:11"
"6785","7","20170607090636","PC","AAA04","6","48000","2400","45600","2017-06-07 09:06:36"
"6786","80","20170607073812","PC","AAA01","6","60000","12000","48000","2017-06-07 07:38:12"
"6787","58","20170606045904","PC","AAA02","9","135000","20700","114300","2017-06-06 16:59:04"
"6788","7","20170606041121","Shop","AAA01","5","50000","10000","40000","2017-06-06 16:11:21"
"6789","84","20170606022851","Mobile","AAA02","1","15000","2300","12700","2017-06-06 14:28:51"
"6790","95","20170606125859","PC","AAA02","3","45000","6900","38100","2017-06-06 12:58:59"
"6791","49","20170606113516","PC","AAA05","2","120000","40000","80000","2017-06-06 11:35:16"
"6792","1","20170606093829","Mobile","AAA05","4","240000","80000","160000","2017-06-06 09:38:29"
"6793","21","20170606080558","Shop","AAA03","3","51000","9000","42000","2017-06-06 08:05:58"
"6794","6","20170605071321","Shop","AAA03","1","17000","3000","14000","2017-06-05 19:13:21"
"6795","82","20170605024142","PC","AAA02","11","165000","25300","139700","2017-06-05 14:41:42"
"6796","95","20170605113620","Mobile","AAA02","1","15000","2300","12700","2017-06-05 11:36:20"
"6797","12","20170605102709","Shop","AAA03","6","102000","18000","84000","2017-06-05 10:27:09"
"6798","14","20170605091814","PC","AAA02","1","15000","2300","12700","2017-06-05 09:18:14"
"6799","77","20170603033251","Mobile","AAA01","3","30000","6000","24000","2017-06-03 15:32:51"
"6800","96","20170602120926","Mobile","AAA02","7","105000","16100","88900","2017-06-02 12:09:26"
"6801","43","20170602110844","PC","AAA03","3","51000","9000","42000","2017-06-02 11:08:44"
"6802","64","20170602084936","Shop","AAA01","7","70000","14000","56000","2017-06-02 08:49:36"
"6803","46","20170602074556","PC","AAA01","8","80000","16000","64000","2017-06-02 07:45:56"
"6804","64","20170601091054","Shop","AAA01","9","90000","18000","72000","2017-06-01 21:10:54"
"6805","67","20170601055805","Shop","AAA05","9","540000","180000","360000","2017-06-01 17:58:05"
"6806","56","20170601033118","Shop","AAA01","10","100000","20000","80000","2017-06-01 15:31:18"
"6807","28","20170601105412","PC","AAA02","2","30000","4600","25400","2017-06-01 10:54:12"
"6808","10","20170601094222","Mobile","AAA03","9","153000","27000","126000","2017-06-01 09:42:22"
"6809","35","20170601082811","Shop","AAA04","2","16000","800","15200","2017-06-01 08:28:11"
"6810","55","20170601065723","Mobile","AAA04","4","32000","1600","30400","2017-06-01 06:57:23"
"6811","14","20170531115510","PC","AAA04","1","8000","400","7600","2017-05-31 11:55:10"
"6812","54","20170531103551","Mobile","AAA01","1","10000","2000","8000","2017-05-31 10:35:51"
"6813","18","20170531081021","PC","AAA01","6","60000","12000","48000","2017-05-31 08:10:21"
"6814","86","20170531064958","Mobile","AAA03","3","51000","9000","42000","2017-05-31 06:49:58"
"6815","22","20170530024219","Mobile","AAA05","1","60000","20000","40000","2017-05-30 14:42:19"
"6816","80","20170530021324","Mobile","AAA03","5","85000","15000","70000","2017-05-30 14:13:24"
"6817","28","20170530111250","Shop","AAA04","8","64000","3200","60800","2017-05-30 11:12:50"
"6818","76","20170530082847","Mobile","AAA01","10","100000","20000","80000","2017-05-30 08:28:47"
"6819","87","20170529045120","PC","AAA03","6","102000","18000","84000","2017-05-29 16:51:20"
"6820","24","20170529032459","PC","AAA01","9","90000","18000","72000","2017-05-29 15:24:59"
"6821","39","20170529020410","Shop","AAA02","13","195000","29900","165100","2017-05-29 14:04:10"
"6822","47","20170529115652","Shop","AAA05","4","240000","80000","160000","2017-05-29 11:56:52"
"6823","47","20170529104246","PC","AAA03","7","119000","21000","98000","2017-05-29 10:42:46"
"6824","38","20170529092442","Shop","AAA04","7","56000","2800","53200","2017-05-29 09:24:42"
"6825","21","20170525053524","Shop","AAA04","6","48000","2400","45600","2017-05-25 17:35:24"
"6826","18","20170525040933","Mobile","AAA01","6","60000","12000","48000","2017-05-25 16:09:33"
"6827","42","20170525031623","PC","AAA02","3","45000","6900","38100","2017-05-25 15:16:23"
"6828","73","20170525020607","Shop","AAA05","1","60000","20000","40000","2017-05-25 14:06:07"
"6829","16","20170525125815","PC","AAA03","8","136000","24000","112000","2017-05-25 12:58:15"
"6830","91","20170525115408","PC","AAA02","3","45000","6900","38100","2017-05-25 11:54:08"
"6831","6","20170525101339","Mobile","AAA03","1","17000","3000","14000","2017-05-25 10:13:39"
"6832","11","20170525084053","PC","AAA01","5","50000","10000","40000","2017-05-25 08:40:53"
"6833","42","20170525074054","Mobile","AAA05","2","120000","40000","80000","2017-05-25 07:40:54"
"6834","99","20170524054827","PC","AAA05","2","120000","40000","80000","2017-05-24 17:48:27"
"6835","27","20170524042327","Shop","AAA03","5","85000","15000","70000","2017-05-24 16:23:27"
"6836","15","20170524031009","Mobile","AAA05","13","780000","260000","520000","2017-05-24 15:10:09"
"6837","92","20170524125238","Shop","AAA03","1","17000","3000","14000","2017-05-24 12:52:38"
"6838","82","20170524105239","PC","AAA02","9","135000","20700","114300","2017-05-24 10:52:39"
"6839","89","20170524081854","PC","AAA05","7","420000","140000","280000","2017-05-24 08:18:54"
"6840","7","20170524070120","PC","AAA04","2","16000","800","15200","2017-05-24 07:01:20"
"6841","35","20170523031756","Mobile","AAA03","4","68000","12000","56000","2017-05-23 15:17:56"
"6842","10","20170523024618","Shop","AAA04","4","32000","1600","30400","2017-05-23 14:46:18"
"6843","11","20170523014210","Mobile","AAA05","3","180000","60000","120000","2017-05-23 13:42:10"
"6844","26","20170523125438","Shop","AAA03","4","68000","12000","56000","2017-05-23 12:54:38"
"6845","2","20170523114033","Shop","AAA01","2","20000","4000","16000","2017-05-23 11:40:33"
"6846","9","20170523080939","Shop","AAA03","3","51000","9000","42000","2017-05-23 08:09:39"
"6847","18","20170523061640","Shop","AAA05","2","120000","40000","80000","2017-05-23 06:16:40"
"6848","70","20170522042451","PC","AAA03","9","153000","27000","126000","2017-05-22 16:24:51"
"6849","25","20170522022637","PC","AAA03","4","68000","12000","56000","2017-05-22 14:26:37"
"6850","22","20170522011314","Mobile","AAA01","7","70000","14000","56000","2017-05-22 13:13:14"
"6851","77","20170522121835","PC","AAA02","5","75000","11500","63500","2017-05-22 12:18:35"
"6852","92","20170522112833","Shop","AAA03","3","51000","9000","42000","2017-05-22 11:28:33"
"6853","72","20170522094153","PC","AAA03","2","34000","6000","28000","2017-05-22 09:41:53"
"6854","19","20170518074134","PC","AAA02","1","15000","2300","12700","2017-05-18 07:41:34"
"6855","92","20170517085100","Shop","AAA02","10","150000","23000","127000","2017-05-17 20:51:00"
"6856","15","20170517075725","PC","AAA05","8","480000","160000","320000","2017-05-17 19:57:25"
"6857","12","20170517051814","Mobile","AAA04","2","16000","800","15200","2017-05-17 17:18:14"
"6858","75","20170517040630","Mobile","AAA04","1","8000","400","7600","2017-05-17 16:06:30"
"6859","55","20170517022442","Mobile","AAA01","7","70000","14000","56000","2017-05-17 14:24:42"
"6860","30","20170517012105","PC","AAA03","4","68000","12000","56000","2017-05-17 13:21:05"
"6861","81","20170517114952","Mobile","AAA02","1","15000","2300","12700","2017-05-17 11:49:52"
"6862","68","20170517104037","PC","AAA01","6","60000","12000","48000","2017-05-17 10:40:37"
"6863","68","20170517090833","Shop","AAA03","3","51000","9000","42000","2017-05-17 09:08:33"
"6864","70","20170516083608","Shop","AAA05","6","360000","120000","240000","2017-05-16 20:36:08"
"6865","15","20170516053702","PC","AAA03","12","204000","36000","168000","2017-05-16 17:37:02"
"6866","57","20170516041217","PC","AAA04","7","56000","2800","53200","2017-05-16 16:12:17"
"6867","86","20170516015757","PC","AAA04","4","32000","1600","30400","2017-05-16 13:57:57"
"6868","88","20170516123241","PC","AAA05","2","120000","40000","80000","2017-05-16 12:32:41"
"6869","30","20170516103458","Shop","AAA02","7","105000","16100","88900","2017-05-16 10:34:58"
"6870","42","20170516095231","Shop","AAA02","6","90000","13800","76200","2017-05-16 09:52:31"
"6871","84","20170516082528","PC","AAA01","4","40000","8000","32000","2017-05-16 08:25:28"
"6872","30","20170516064243","PC","AAA02","3","45000","6900","38100","2017-05-16 06:42:43"
"6873","63","20170515024513","Shop","AAA03","2","34000","6000","28000","2017-05-15 14:45:13"
"6874","33","20170515010751","Shop","AAA05","3","180000","60000","120000","2017-05-15 13:07:51"
"6875","81","20170515115843","Mobile","AAA03","2","34000","6000","28000","2017-05-15 11:58:43"
"6876","42","20170515092529","Mobile","AAA05","7","420000","140000","280000","2017-05-15 09:25:29"
"6877","8","20170511114230","Mobile","AAA02","5","75000","11500","63500","2017-05-11 23:42:30"
"6878","74","20170511112824","Mobile","AAA04","6","48000","2400","45600","2017-05-11 11:28:24"
"6879","94","20170511103112","Mobile","AAA04","11","88000","4400","83600","2017-05-11 10:31:12"
"6880","95","20170511085217","PC","AAA01","5","50000","10000","40000","2017-05-11 08:52:17"
"6881","67","20170510072556","Mobile","AAA03","10","170000","30000","140000","2017-05-10 19:25:56"
"6882","48","20170510032340","Shop","AAA03","1","17000","3000","14000","2017-05-10 15:23:40"
"6883","37","20170510014501","Shop","AAA04","14","112000","5600","106400","2017-05-10 13:45:01"
"6884","15","20170510115414","Mobile","AAA02","11","165000","25300","139700","2017-05-10 11:54:14"
"6885","39","20170510103635","Mobile","AAA05","1","60000","20000","40000","2017-05-10 10:36:35"
"6886","91","20170510083243","Shop","AAA02","1","15000","2300","12700","2017-05-10 08:32:43"
"6887","19","20170510071701","PC","AAA04","3","24000","1200","22800","2017-05-10 07:17:01"
"6888","61","20170509102915","Mobile","AAA02","5","75000","11500","63500","2017-05-09 10:29:15"
"6889","86","20170509085037","PC","AAA05","4","240000","80000","160000","2017-05-09 08:50:37"
"6890","6","20170509070838","Shop","AAA03","2","34000","6000","28000","2017-05-09 07:08:38"
"6891","91","20170508103839","Shop","AAA03","3","51000","9000","42000","2017-05-08 10:38:39"
"6892","36","20170508084546","Mobile","AAA03","12","204000","36000","168000","2017-05-08 08:45:46"
"6893","65","20170504105445","Mobile","AAA02","5","75000","11500","63500","2017-05-04 22:54:45"
"6894","43","20170504082055","PC","AAA05","7","420000","140000","280000","2017-05-04 20:20:55"
"6895","49","20170504031723","Mobile","AAA02","3","45000","6900","38100","2017-05-04 15:17:23"
"6896","27","20170504015907","Mobile","AAA04","11","88000","4400","83600","2017-05-04 13:59:07"
"6897","38","20170504124540","Shop","AAA03","5","85000","15000","70000","2017-05-04 12:45:40"
"6898","60","20170504104543","Shop","AAA04","5","40000","2000","38000","2017-05-04 10:45:43"
"6899","94","20170504080932","PC","AAA01","3","30000","6000","24000","2017-05-04 08:09:32"
"6900","11","20170504071605","Mobile","AAA02","5","75000","11500","63500","2017-05-04 07:16:05"
"6901","53","20170503023251","Shop","AAA02","3","45000","6900","38100","2017-05-03 14:32:51"
"6902","100","20170503013048","PC","AAA03","5","85000","15000","70000","2017-05-03 13:30:48"
"6903","50","20170503011439","Mobile","AAA03","3","51000","9000","42000","2017-05-03 13:14:39"
"6904","28","20170503120356","Shop","AAA05","8","480000","160000","320000","2017-05-03 12:03:56"
"6905","34","20170503105648","Shop","AAA05","2","120000","40000","80000","2017-05-03 10:56:48"
"6906","96","20170503102835","Shop","AAA04","4","32000","1600","30400","2017-05-03 10:28:35"
"6907","60","20170503082408","Mobile","AAA04","6","48000","2400","45600","2017-05-03 08:24:08"
"6908","81","20170503072626","Shop","AAA02","1","15000","2300","12700","2017-05-03 07:26:26"
"6909","27","20170502060731","Mobile","AAA02","7","105000","16100","88900","2017-05-02 18:07:31"
"6910","40","20170502031410","PC","AAA03","9","153000","27000","126000","2017-05-02 15:14:10"
"6911","74","20170502015515","Mobile","AAA05","1","60000","20000","40000","2017-05-02 13:55:15"
"6912","23","20170502124221","Mobile","AAA05","9","540000","180000","360000","2017-05-02 12:42:21"
"6913","100","20170502121411","PC","AAA03","2","34000","6000","28000","2017-05-02 12:14:11"
"6914","70","20170502103859","PC","AAA02","4","60000","9200","50800","2017-05-02 10:38:59"
"6915","44","20170502091419","PC","AAA04","10","80000","4000","76000","2017-05-02 09:14:19"
"6916","98","20170501045241","Shop","AAA01","2","20000","4000","16000","2017-05-01 16:52:41"
"6917","87","20170501031219","Mobile","AAA05","1","60000","20000","40000","2017-05-01 15:12:19"
"6918","64","20170501020547","Mobile","AAA05","9","540000","180000","360000","2017-05-01 14:05:47"
"6919","1","20170501124327","Mobile","AAA05","3","180000","60000","120000","2017-05-01 12:43:27"
"6920","55","20170501112210","Shop","AAA01","7","70000","14000","56000","2017-05-01 11:22:10"
"6921","67","20170501100909","PC","AAA05","4","240000","80000","160000","2017-05-01 10:09:09"
"6922","23","20170429083745","PC","AAA05","4","240000","80000","160000","2017-04-29 08:37:45"
"6923","38","20170428111151","PC","AAA01","5","50000","10000","40000","2017-04-28 23:11:51"
"6924","94","20170428122055","PC","AAA01","10","100000","20000","80000","2017-04-28 12:20:55"
"6925","36","20170428094140","PC","AAA04","9","72000","3600","68400","2017-04-28 09:41:40"
"6926","5","20170428084839","Mobile","AAA02","7","105000","16100","88900","2017-04-28 08:48:39"
"6927","34","20170428065507","Shop","AAA03","6","102000","18000","84000","2017-04-28 06:55:07"
"6928","71","20170427125329","Mobile","AAA04","4","32000","1600","30400","2017-04-27 12:53:29"
"6929","58","20170427105548","Shop","AAA01","5","50000","10000","40000","2017-04-27 10:55:48"
"6930","35","20170427072922","Mobile","AAA02","1","15000","2300","12700","2017-04-27 07:29:22"
"6931","53","20170426061034","Shop","AAA01","3","30000","6000","24000","2017-04-26 18:10:34"
"6932","100","20170426040924","Shop","AAA03","1","17000","3000","14000","2017-04-26 16:09:24"
"6933","58","20170426013949","PC","AAA05","2","120000","40000","80000","2017-04-26 13:39:49"
"6934","87","20170426123331","Shop","AAA02","7","105000","16100","88900","2017-04-26 12:33:31"
"6935","62","20170426105608","Mobile","AAA02","10","150000","23000","127000","2017-04-26 10:56:08"
"6936","79","20170426104014","PC","AAA01","3","30000","6000","24000","2017-04-26 10:40:14"
"6937","67","20170426090645","Mobile","AAA04","2","16000","800","15200","2017-04-26 09:06:45"
"6938","42","20170426080845","Mobile","AAA02","5","75000","11500","63500","2017-04-26 08:08:45"
"6939","28","20170426070615","Shop","AAA03","6","102000","18000","84000","2017-04-26 07:06:15"
"6940","58","20170425101440","PC","AAA01","1","10000","2000","8000","2017-04-25 22:14:40"
"6941","83","20170425072913","Mobile","AAA03","4","68000","12000","56000","2017-04-25 19:29:13"
"6942","37","20170425041031","Mobile","AAA04","15","120000","6000","114000","2017-04-25 16:10:31"
"6943","49","20170425031133","Mobile","AAA05","2","120000","40000","80000","2017-04-25 15:11:33"
"6944","74","20170425015429","Shop","AAA04","2","16000","800","15200","2017-04-25 13:54:29"
"6945","28","20170425013742","Shop","AAA01","6","60000","12000","48000","2017-04-25 13:37:42"
"6946","31","20170425114509","PC","AAA05","1","60000","20000","40000","2017-04-25 11:45:09"
"6947","75","20170425073005","PC","AAA05","2","120000","40000","80000","2017-04-25 07:30:05"
"6948","18","20170424064006","Shop","AAA03","2","34000","6000","28000","2017-04-24 18:40:06"
"6949","13","20170424024554","PC","AAA03","2","34000","6000","28000","2017-04-24 14:45:54"
"6950","56","20170424014605","Shop","AAA05","11","660000","220000","440000","2017-04-24 13:46:05"
"6951","74","20170424010214","PC","AAA01","1","10000","2000","8000","2017-04-24 13:02:14"
"6952","64","20170424111709","Shop","AAA03","10","170000","30000","140000","2017-04-24 11:17:09"
"6953","3","20170424102337","Mobile","AAA05","19","1140000","380000","760000","2017-04-24 10:23:37"
"6954","31","20170424094239","PC","AAA02","7","105000","16100","88900","2017-04-24 09:42:39"
"6955","18","20170421025613","PC","AAA02","3","45000","6900","38100","2017-04-21 14:56:13"
"6956","65","20170421020319","Shop","AAA02","5","75000","11500","63500","2017-04-21 14:03:19"
"6957","73","20170421123902","Shop","AAA04","1","8000","400","7600","2017-04-21 12:39:02"
"6958","11","20170421111830","PC","AAA05","11","660000","220000","440000","2017-04-21 11:18:30"
"6959","11","20170421092711","PC","AAA05","8","480000","160000","320000","2017-04-21 09:27:11"
"6960","97","20170421081951","Shop","AAA04","7","56000","2800","53200","2017-04-21 08:19:51"
"6961","2","20170421072508","Shop","AAA03","7","119000","21000","98000","2017-04-21 07:25:08"
"6962","96","20170420085000","PC","AAA04","5","40000","2000","38000","2017-04-20 20:50:00"
"6963","91","20170420052533","PC","AAA04","4","32000","1600","30400","2017-04-20 17:25:33"
"6964","96","20170420043553","Mobile","AAA02","1","15000","2300","12700","2017-04-20 16:35:53"
"6965","10","20170420035643","Mobile","AAA05","7","420000","140000","280000","2017-04-20 15:56:43"
"6966","88","20170420023758","Mobile","AAA01","2","20000","4000","16000","2017-04-20 14:37:58"
"6967","65","20170420015517","Mobile","AAA04","5","40000","2000","38000","2017-04-20 13:55:17"
"6968","15","20170420095026","Mobile","AAA02","13","195000","29900","165100","2017-04-20 09:50:26"
"6969","98","20170420081954","Shop","AAA05","1","60000","20000","40000","2017-04-20 08:19:54"
"6970","94","20170420070754","Mobile","AAA05","2","120000","40000","80000","2017-04-20 07:07:54"
"6971","24","20170419094956","Mobile","AAA03","8","136000","24000","112000","2017-04-19 21:49:56"
"6972","69","20170419074054","PC","AAA05","3","180000","60000","120000","2017-04-19 19:40:54"
"6973","16","20170419012132","Mobile","AAA05","7","420000","140000","280000","2017-04-19 13:21:32"
"6974","30","20170419121727","Shop","AAA02","4","60000","9200","50800","2017-04-19 12:17:27"
"6975","59","20170419102028","PC","AAA02","2","30000","4600","25400","2017-04-19 10:20:28"
"6976","8","20170419084018","PC","AAA04","11","88000","4400","83600","2017-04-19 08:40:18"
"6977","61","20170419072453","Shop","AAA01","3","30000","6000","24000","2017-04-19 07:24:53"
"6978","11","20170418042627","Shop","AAA02","2","30000","4600","25400","2017-04-18 16:26:27"
"6979","46","20170418034930","Shop","AAA01","9","90000","18000","72000","2017-04-18 15:49:30"
"6980","53","20170418022322","Mobile","AAA01","3","30000","6000","24000","2017-04-18 14:23:22"
"6981","61","20170418114445","Mobile","AAA05","6","360000","120000","240000","2017-04-18 11:44:45"
"6982","42","20170418101519","Mobile","AAA01","4","40000","8000","32000","2017-04-18 10:15:19"
"6983","3","20170418083155","PC","AAA04","6","48000","2400","45600","2017-04-18 08:31:55"
"6984","54","20170418063303","Shop","AAA04","10","80000","4000","76000","2017-04-18 06:33:03"
"6985","3","20170417025657","PC","AAA05","10","600000","200000","400000","2017-04-17 14:56:57"
"6986","77","20170417125105","Mobile","AAA01","3","30000","6000","24000","2017-04-17 12:51:05"
"6987","46","20170417111349","PC","AAA02","9","135000","20700","114300","2017-04-17 11:13:49"
"6988","46","20170417102330","Shop","AAA02","1","15000","2300","12700","2017-04-17 10:23:30"
"6989","93","20170417091738","Mobile","AAA05","6","360000","120000","240000","2017-04-17 09:17:38"
"6990","94","20170414033853","PC","AAA03","11","187000","33000","154000","2017-04-14 03:38:53"
"6991","41","20170413053611","PC","AAA04","4","32000","1600","30400","2017-04-13 17:36:11"
"6992","30","20170413043016","Shop","AAA02","6","90000","13800","76200","2017-04-13 16:30:16"
"6993","36","20170413033814","PC","AAA05","5","300000","100000","200000","2017-04-13 15:38:14"
"6994","64","20170413020307","Mobile","AAA02","1","15000","2300","12700","2017-04-13 14:03:07"
"6995","42","20170413125418","Shop","AAA01","9","90000","18000","72000","2017-04-13 12:54:18"
"6996","39","20170413115854","Mobile","AAA04","8","64000","3200","60800","2017-04-13 11:58:54"
"6997","79","20170413103838","Mobile","AAA04","8","64000","3200","60800","2017-04-13 10:38:38"
"6998","70","20170413090051","Shop","AAA04","2","16000","800","15200","2017-04-13 09:00:51"
"6999","20","20170413081739","Shop","AAA05","4","240000","80000","160000","2017-04-13 08:17:39"
"7000","14","20170413064217","PC","AAA01","2","20000","4000","16000","2017-04-13 06:42:17"
"7001","25","20170412081938","Mobile","AAA02","9","135000","20700","114300","2017-04-12 20:19:38"
"7002","72","20170412050748","Shop","AAA02","3","45000","6900","38100","2017-04-12 17:07:48"
"7003","56","20170412041545","Shop","AAA02","6","90000","13800","76200","2017-04-12 16:15:45"
"7004","60","20170412012318","Mobile","AAA04","3","24000","1200","22800","2017-04-12 13:23:18"
"7005","39","20170412115541","PC","AAA03","4","68000","12000","56000","2017-04-12 11:55:41"
"7006","55","20170412103926","PC","AAA05","12","720000","240000","480000","2017-04-12 10:39:26"
"7007","56","20170412092332","Mobile","AAA05","4","240000","80000","160000","2017-04-12 09:23:32"
"7008","9","20170412122344","Shop","AAA04","5","40000","2000","38000","2017-04-12 00:23:44"
"7009","36","20170411121826","Shop","AAA04","16","128000","6400","121600","2017-04-11 12:18:26"
"7010","97","20170411104231","PC","AAA03","4","68000","12000","56000","2017-04-11 10:42:31"
"7011","96","20170411095209","PC","AAA04","3","24000","1200","22800","2017-04-11 09:52:09"
"7012","61","20170411082047","PC","AAA01","5","50000","10000","40000","2017-04-11 08:20:47"
"7013","48","20170410091405","Shop","AAA04","5","40000","2000","38000","2017-04-10 21:14:05"
"7014","8","20170410062638","Mobile","AAA01","1","10000","2000","8000","2017-04-10 18:26:38"
"7015","21","20170410030759","Mobile","AAA05","9","540000","180000","360000","2017-04-10 15:07:59"
"7016","92","20170410012631","PC","AAA04","4","32000","1600","30400","2017-04-10 13:26:31"
"7017","1","20170410121926","Mobile","AAA05","7","420000","140000","280000","2017-04-10 12:19:26"
"7018","44","20170410113211","PC","AAA05","7","420000","140000","280000","2017-04-10 11:32:11"
"7019","67","20170410104744","Shop","AAA02","3","45000","6900","38100","2017-04-10 10:47:44"
"7020","48","20170410082906","PC","AAA03","4","68000","12000","56000","2017-04-10 08:29:06"
"7021","66","20170407045650","Mobile","AAA02","3","45000","6900","38100","2017-04-07 16:56:50"
"7022","15","20170407015417","PC","AAA02","4","60000","9200","50800","2017-04-07 13:54:17"
"7023","2","20170407121347","Mobile","AAA03","3","51000","9000","42000","2017-04-07 12:13:47"
"7024","58","20170407100724","PC","AAA04","5","40000","2000","38000","2017-04-07 10:07:24"
"7025","10","20170407084718","Mobile","AAA01","3","30000","6000","24000","2017-04-07 08:47:18"
"7026","15","20170407075201","Mobile","AAA03","14","238000","42000","196000","2017-04-07 07:52:01"
"7027","15","20170406104528","Shop","AAA04","9","72000","3600","68400","2017-04-06 10:45:28"
"7028","44","20170406093714","Shop","AAA02","7","105000","16100","88900","2017-04-06 09:37:14"
"7029","76","20170406123039","PC","AAA03","5","85000","15000","70000","2017-04-06 00:30:39"
"7030","35","20170405105052","PC","AAA04","1","8000","400","7600","2017-04-05 10:50:52"
"7031","89","20170405101809","PC","AAA03","23","391000","69000","322000","2017-04-05 10:18:09"
"7032","58","20170405093214","Shop","AAA01","3","30000","6000","24000","2017-04-05 09:32:14"
"7033","3","20170405084223","Shop","AAA03","20","340000","60000","280000","2017-04-05 08:42:23"
"7034","46","20170405070346","PC","AAA04","5","40000","2000","38000","2017-04-05 07:03:46"
"7035","89","20170404084631","Mobile","AAA05","15","900000","300000","600000","2017-04-04 20:46:31"
"7036","48","20170404052341","Mobile","AAA01","9","90000","18000","72000","2017-04-04 17:23:41"
"7037","47","20170404034328","PC","AAA01","7","70000","14000","56000","2017-04-04 15:43:28"
"7038","97","20170404012424","Shop","AAA04","2","16000","800","15200","2017-04-04 13:24:24"
"7039","55","20170404123008","PC","AAA05","7","420000","140000","280000","2017-04-04 12:30:08"
"7040","79","20170404112704","PC","AAA04","1","8000","400","7600","2017-04-04 11:27:04"
"7041","96","20170404102459","Mobile","AAA04","10","80000","4000","76000","2017-04-04 10:24:59"
"7042","17","20170404101014","Mobile","AAA03","4","68000","12000","56000","2017-04-04 10:10:14"
"7043","34","20170404085030","Shop","AAA05","7","420000","140000","280000","2017-04-04 08:50:30"
"7044","23","20170404012150","PC","AAA03","12","204000","36000","168000","2017-04-04 01:21:50"
"7045","2","20170403010713","Mobile","AAA05","5","300000","100000","200000","2017-04-03 13:07:13"
"7046","39","20170403121843","PC","AAA03","2","34000","6000","28000","2017-04-03 12:18:43"
"7047","69","20170403103629","Shop","AAA05","5","300000","100000","200000","2017-04-03 10:36:29"
"7048","22","20170403090232","PC","AAA05","6","360000","120000","240000","2017-04-03 09:02:32"
"7049","28","20170330020850","Shop","AAA03","4","68000","12000","56000","2017-03-30 02:08:50"
"7050","78","20170329024911","PC","AAA05","2","120000","40000","80000","2017-03-29 14:49:11"
"7051","92","20170329011051","Mobile","AAA05","9","540000","180000","360000","2017-03-29 13:10:51"
"7052","77","20170329123256","Mobile","AAA04","3","24000","1200","22800","2017-03-29 12:32:56"
"7053","97","20170329115158","Mobile","AAA01","8","80000","16000","64000","2017-03-29 11:51:58"
"7054","55","20170329103948","Shop","AAA03","11","187000","33000","154000","2017-03-29 10:39:48"
"7055","3","20170329095355","Mobile","AAA05","6","360000","120000","240000","2017-03-29 09:53:55"
"7056","38","20170329084629","Mobile","AAA01","6","60000","12000","48000","2017-03-29 08:46:29"
"7057","21","20170329060449","PC","AAA03","6","102000","18000","84000","2017-03-29 06:04:49"
"7058","54","20170328034539","PC","AAA05","3","180000","60000","120000","2017-03-28 15:45:39"
"7059","3","20170328022053","PC","AAA02","5","75000","11500","63500","2017-03-28 14:20:53"
"7060","50","20170328011607","PC","AAA03","12","204000","36000","168000","2017-03-28 13:16:07"
"7061","13","20170328123515","Mobile","AAA01","4","40000","8000","32000","2017-03-28 12:35:15"
"7062","23","20170328114302","PC","AAA01","7","70000","14000","56000","2017-03-28 11:43:02"
"7063","97","20170328095819","Shop","AAA02","5","75000","11500","63500","2017-03-28 09:58:19"
"7064","73","20170328085330","Mobile","AAA01","8","80000","16000","64000","2017-03-28 08:53:30"
"7065","95","20170328074624","PC","AAA04","4","32000","1600","30400","2017-03-28 07:46:24"
"7066","61","20170328125353","PC","AAA02","1","15000","2300","12700","2017-03-28 00:53:53"
"7067","36","20170327030626","Mobile","AAA05","11","660000","220000","440000","2017-03-27 15:06:26"
"7068","94","20170327014421","Mobile","AAA05","13","780000","260000","520000","2017-03-27 13:44:21"
"7069","95","20170327015442","PC","AAA02","14","210000","32200","177800","2017-03-27 13:54:42"
"7070","4","20170327102937","Shop","AAA01","3","30000","6000","24000","2017-03-27 10:29:37"
"7071","100","20170327091740","PC","AAA04","2","16000","800","15200","2017-03-27 09:17:40"
"7072","100","20170325102336","Shop","AAA01","1","10000","2000","8000","2017-03-25 10:23:36"
"7073","67","20170324024535","PC","AAA01","3","30000","6000","24000","2017-03-24 14:45:35"
"7074","7","20170324015421","Mobile","AAA01","5","50000","10000","40000","2017-03-24 13:54:21"
"7075","19","20170324124841","Mobile","AAA01","4","40000","8000","32000","2017-03-24 12:48:41"
"7076","47","20170324112415","PC","AAA05","9","540000","180000","360000","2017-03-24 11:24:15"
"7077","57","20170324104040","Shop","AAA03","4","68000","12000","56000","2017-03-24 10:40:40"
"7078","20","20170324091429","Shop","AAA01","7","70000","14000","56000","2017-03-24 09:14:29"
"7079","10","20170324074407","PC","AAA05","7","420000","140000","280000","2017-03-24 07:44:07"
"7080","41","20170324011450","PC","AAA01","6","60000","12000","48000","2017-03-24 01:14:50"
"7081","66","20170323075825","Mobile","AAA02","11","165000","25300","139700","2017-03-23 07:58:25"
"7082","84","20170322035331","Shop","AAA02","9","135000","20700","114300","2017-03-22 15:53:31"
"7083","41","20170322020854","Shop","AAA02","3","45000","6900","38100","2017-03-22 14:08:54"
"7084","31","20170322010619","PC","AAA03","6","102000","18000","84000","2017-03-22 13:06:19"
"7085","1","20170322115246","Shop","AAA04","6","48000","2400","45600","2017-03-22 11:52:46"
"7086","83","20170322105527","Mobile","AAA04","12","96000","4800","91200","2017-03-22 10:55:27"
"7087","60","20170322092650","Mobile","AAA04","1","8000","400","7600","2017-03-22 09:26:50"
"7088","67","20170322080524","Shop","AAA04","10","80000","4000","76000","2017-03-22 08:05:24"
"7089","72","20170322122024","Shop","AAA03","8","136000","24000","112000","2017-03-22 00:20:24"
"7090","72","20170321074451","Mobile","AAA01","1","10000","2000","8000","2017-03-21 07:44:51"
"7091","64","20170320033313","Shop","AAA01","8","80000","16000","64000","2017-03-20 15:33:13"
"7092","63","20170320021804","Shop","AAA05","5","300000","100000","200000","2017-03-20 14:18:04"
"7093","47","20170320121047","Mobile","AAA02","12","180000","27600","152400","2017-03-20 12:10:47"
"7094","50","20170320112731","Mobile","AAA02","4","60000","9200","50800","2017-03-20 11:27:31"
"7095","70","20170320101304","PC","AAA05","6","360000","120000","240000","2017-03-20 10:13:04"
"7096","72","20170320081346","Shop","AAA05","8","480000","160000","320000","2017-03-20 08:13:46"
"7097","18","20170317053025","Mobile","AAA01","5","50000","10000","40000","2017-03-17 05:30:25"
"7098","55","20170316090452","PC","AAA05","1","60000","20000","40000","2017-03-16 21:04:52"
"7099","67","20170316070247","Shop","AAA01","10","100000","20000","80000","2017-03-16 19:02:47"
"7100","25","20170316040445","Shop","AAA04","8","64000","3200","60800","2017-03-16 16:04:45"
"7101","6","20170316031252","Shop","AAA05","9","540000","180000","360000","2017-03-16 15:12:52"
"7102","66","20170316022138","PC","AAA02","1","15000","2300","12700","2017-03-16 14:21:38"
"7103","79","20170316125347","PC","AAA01","3","30000","6000","24000","2017-03-16 12:53:47"
"7104","72","20170316115530","PC","AAA04","5","40000","2000","38000","2017-03-16 11:55:30"
"7105","34","20170316105704","Mobile","AAA05","4","240000","80000","160000","2017-03-16 10:57:04"
"7106","18","20170316102448","Mobile","AAA03","7","119000","21000","98000","2017-03-16 10:24:48"
"7107","71","20170316091948","Shop","AAA01","1","10000","2000","8000","2017-03-16 09:19:48"
"7108","1","20170316080850","Shop","AAA02","3","45000","6900","38100","2017-03-16 08:08:50"
"7109","96","20170316070327","Shop","AAA03","2","34000","6000","28000","2017-03-16 07:03:27"
"7110","48","20170315030156","Mobile","AAA05","1","60000","20000","40000","2017-03-15 15:01:56"
"7111","44","20170315014410","Mobile","AAA01","3","30000","6000","24000","2017-03-15 13:44:10"
"7112","77","20170315011209","Mobile","AAA01","6","60000","12000","48000","2017-03-15 13:12:09"
"7113","76","20170315115906","PC","AAA04","1","8000","400","7600","2017-03-15 11:59:06"
"7114","31","20170315110109","PC","AAA02","1","15000","2300","12700","2017-03-15 11:01:09"
"7115","52","20170315095512","Mobile","AAA04","1","8000","400","7600","2017-03-15 09:55:12"
"7116","38","20170315075935","PC","AAA05","11","660000","220000","440000","2017-03-15 07:59:35"
"7117","96","20170314092831","Mobile","AAA03","5","85000","15000","70000","2017-03-14 21:28:31"
"7118","19","20170314035409","Mobile","AAA01","6","60000","12000","48000","2017-03-14 15:54:09"
"7119","61","20170314022200","PC","AAA04","3","24000","1200","22800","2017-03-14 14:22:00"
"7120","42","20170314125049","Mobile","AAA02","8","120000","18400","101600","2017-03-14 12:50:49"
"7121","94","20170314100014","PC","AAA04","9","72000","3600","68400","2017-03-14 10:00:14"
"7122","93","20170314083813","Shop","AAA03","2","34000","6000","28000","2017-03-14 08:38:13"
"7123","6","20170314075317","PC","AAA05","1","60000","20000","40000","2017-03-14 07:53:17"
"7124","13","20170313060214","Mobile","AAA03","2","34000","6000","28000","2017-03-13 18:02:14"
"7125","30","20170313125857","Shop","AAA04","2","16000","800","15200","2017-03-13 12:58:57"
"7126","25","20170313115341","Mobile","AAA01","1","10000","2000","8000","2017-03-13 11:53:41"
"7127","54","20170313103826","Shop","AAA03","8","136000","24000","112000","2017-03-13 10:38:26"
"7128","96","20170313094525","Mobile","AAA01","7","70000","14000","56000","2017-03-13 09:45:25"
"7129","68","20170308113137","Shop","AAA01","4","40000","8000","32000","2017-03-08 23:31:37"
"7130","60","20170308034942","Shop","AAA01","5","50000","10000","40000","2017-03-08 15:49:42"
"7131","74","20170308030237","PC","AAA03","5","85000","15000","70000","2017-03-08 15:02:37"
"7132","11","20170308112136","Mobile","AAA03","8","136000","24000","112000","2017-03-08 11:21:36"
"7133","68","20170308085135","Mobile","AAA01","2","20000","4000","16000","2017-03-08 08:51:35"
"7134","1","20170308071217","PC","AAA01","5","50000","10000","40000","2017-03-08 07:12:17"
"7135","62","20170307103937","Mobile","AAA05","12","720000","240000","480000","2017-03-07 22:39:37"
"7136","46","20170307125030","PC","AAA04","2","16000","800","15200","2017-03-07 12:50:30"
"7137","17","20170307105144","Shop","AAA03","4","68000","12000","56000","2017-03-07 10:51:44"
"7138","47","20170307085013","Shop","AAA01","11","110000","22000","88000","2017-03-07 08:50:13"
"7139","92","20170307065735","Mobile","AAA03","9","153000","27000","126000","2017-03-07 06:57:35"
"7140","67","20170307014228","Shop","AAA04","10","80000","4000","76000","2017-03-07 01:42:28"
"7141","68","20170306033533","Mobile","AAA02","1","15000","2300","12700","2017-03-06 15:35:33"
"7142","63","20170306021559","Shop","AAA01","5","50000","10000","40000","2017-03-06 14:15:59"
"7143","99","20170306110844","Shop","AAA03","1","17000","3000","14000","2017-03-06 11:08:44"
"7144","6","20170306093617","PC","AAA03","1","17000","3000","14000","2017-03-06 09:36:17"
"7145","48","20170304011744","PC","AAA01","6","60000","12000","48000","2017-03-04 13:17:44"
"7146","43","20170303050845","Mobile","AAA05","4","240000","80000","160000","2017-03-03 17:08:45"
"7147","18","20170303030935","PC","AAA05","8","480000","160000","320000","2017-03-03 15:09:35"
"7148","56","20170303012143","Shop","AAA03","7","119000","21000","98000","2017-03-03 13:21:43"
"7149","5","20170303114447","Mobile","AAA04","12","96000","4800","91200","2017-03-03 11:44:47"
"7150","14","20170303113642","Shop","AAA04","6","48000","2400","45600","2017-03-03 11:36:42"
"7151","8","20170303101506","PC","AAA05","4","240000","80000","160000","2017-03-03 10:15:06"
"7152","12","20170303085841","Mobile","AAA01","1","10000","2000","8000","2017-03-03 08:58:41"
"7153","92","20170303063951","Mobile","AAA02","5","75000","11500","63500","2017-03-03 06:39:51"
"7154","22","20170302122514","PC","AAA03","2","34000","6000","28000","2017-03-02 12:25:14"
"7155","12","20170302105351","Mobile","AAA04","3","24000","1200","22800","2017-03-02 10:53:51"
"7156","21","20170302092302","Shop","AAA02","3","45000","6900","38100","2017-03-02 09:23:02"
"7157","92","20170302080857","Shop","AAA03","7","119000","21000","98000","2017-03-02 08:08:57"
"7158","58","20170302072959","Shop","AAA05","4","240000","80000","160000","2017-03-02 07:29:59"
"7159","54","20170301070453","PC","AAA03","5","85000","15000","70000","2017-03-01 19:04:53"
"7160","30","20170301032836","Shop","AAA01","4","40000","8000","32000","2017-03-01 15:28:36"
"7161","67","20170301030930","Mobile","AAA03","5","85000","15000","70000","2017-03-01 15:09:30"
"7162","59","20170301015136","Shop","AAA02","3","45000","6900","38100","2017-03-01 13:51:36"
"7163","46","20170301125327","PC","AAA03","12","204000","36000","168000","2017-03-01 12:53:27"
"7164","89","20170301112440","Shop","AAA05","10","600000","200000","400000","2017-03-01 11:24:40"
"7165","49","20170301094755","Mobile","AAA04","8","64000","3200","60800","2017-03-01 09:47:55"
"7166","50","20170301085640","Mobile","AAA05","10","600000","200000","400000","2017-03-01 08:56:40"
"7167","12","20170301074533","Shop","AAA02","4","60000","9200","50800","2017-03-01 07:45:33"
"7168","2","20170301122519","Mobile","AAA01","3","30000","6000","24000","2017-03-01 00:25:19"
"7169","93","20170228070503","Mobile","AAA03","1","17000","3000","14000","2017-02-28 19:05:03"
"7170","7","20170228115814","Mobile","AAA04","3","24000","1200","22800","2017-02-28 11:58:14"
"7171","93","20170228100143","PC","AAA05","8","480000","160000","320000","2017-02-28 10:01:43"
"7172","35","20170228082032","PC","AAA05","4","240000","80000","160000","2017-02-28 08:20:32"
"7173","1","20170228070342","Shop","AAA05","4","240000","80000","160000","2017-02-28 07:03:42"
"7174","44","20170227112321","Shop","AAA02","6","90000","13800","76200","2017-02-27 23:23:21"
"7175","11","20170227125652","Mobile","AAA01","11","110000","22000","88000","2017-02-27 12:56:52"
"7176","20","20170227120252","Shop","AAA04","3","24000","1200","22800","2017-02-27 12:02:52"
"7177","97","20170227103508","PC","AAA02","10","150000","23000","127000","2017-02-27 10:35:08"
"7178","94","20170227093503","Shop","AAA01","5","50000","10000","40000","2017-02-27 09:35:03"
"7179","19","20170224090620","PC","AAA03","1","17000","3000","14000","2017-02-24 09:06:20"
"7180","31","20170223075526","Shop","AAA04","7","56000","2800","53200","2017-02-23 19:55:26"
"7181","38","20170223024820","PC","AAA05","2","120000","40000","80000","2017-02-23 14:48:20"
"7182","98","20170223013138","Mobile","AAA04","1","8000","400","7600","2017-02-23 13:31:38"
"7183","49","20170223115141","Mobile","AAA05","1","60000","20000","40000","2017-02-23 11:51:41"
"7184","16","20170223111302","Mobile","AAA02","1","15000","2300","12700","2017-02-23 11:13:02"
"7185","41","20170223104646","Shop","AAA05","4","240000","80000","160000","2017-02-23 10:46:46"
"7186","3","20170223093924","PC","AAA05","13","780000","260000","520000","2017-02-23 09:39:24"
"7187","25","20170223083410","Shop","AAA02","6","90000","13800","76200","2017-02-23 08:34:10"
"7188","22","20170223125338","PC","AAA04","3","24000","1200","22800","2017-02-23 00:53:38"
"7189","78","20170222090314","PC","AAA04","7","56000","2800","53200","2017-02-22 09:03:14"
"7190","8","20170222073127","Mobile","AAA01","6","60000","12000","48000","2017-02-22 07:31:27"
"7191","18","20170221031904","PC","AAA03","5","85000","15000","70000","2017-02-21 15:19:04"
"7192","36","20170221020931","PC","AAA03","4","68000","12000","56000","2017-02-21 14:09:31"
"7193","20","20170221122335","Shop","AAA05","2","120000","40000","80000","2017-02-21 12:23:35"
"7194","68","20170221121039","PC","AAA03","5","85000","15000","70000","2017-02-21 12:10:39"
"7195","42","20170221102434","PC","AAA01","8","80000","16000","64000","2017-02-21 10:24:34"
"7196","94","20170221095410","PC","AAA02","6","90000","13800","76200","2017-02-21 09:54:10"
"7197","33","20170221081112","Shop","AAA01","5","50000","10000","40000","2017-02-21 08:11:12"
"7198","56","20170221070450","Shop","AAA01","7","70000","14000","56000","2017-02-21 07:04:50"
"7199","51","20170220102003","PC","AAA02","7","105000","16100","88900","2017-02-20 22:20:03"
"7200","65","20170220063307","Mobile","AAA05","2","120000","40000","80000","2017-02-20 18:33:07"
"7201","7","20170220024846","PC","AAA01","5","50000","10000","40000","2017-02-20 14:48:46"
"7202","2","20170220123438","PC","AAA03","5","85000","15000","70000","2017-02-20 12:34:38"
"7203","36","20170220113713","Shop","AAA04","8","64000","3200","60800","2017-02-20 11:37:13"
"7204","22","20170220100235","Mobile","AAA02","4","60000","9200","50800","2017-02-20 10:02:35"
"7205","28","20170220075809","Shop","AAA05","5","300000","100000","200000","2017-02-20 07:58:09"
"7206","75","20170216051821","Mobile","AAA02","1","15000","2300","12700","2017-02-16 05:18:21"
"7207","51","20170215050543","PC","AAA02","7","105000","16100","88900","2017-02-15 17:05:43"
"7208","58","20170215031344","Shop","AAA05","4","240000","80000","160000","2017-02-15 15:13:44"
"7209","21","20170215015801","PC","AAA01","10","100000","20000","80000","2017-02-15 13:58:01"
"7210","9","20170215102410","Mobile","AAA05","2","120000","40000","80000","2017-02-15 10:24:10"
"7211","40","20170215090944","PC","AAA01","4","40000","8000","32000","2017-02-15 09:09:44"
"7212","64","20170215074620","Mobile","AAA05","2","120000","40000","80000","2017-02-15 07:46:20"
"7213","30","20170215042230","PC","AAA01","5","50000","10000","40000","2017-02-15 04:22:30"
"7214","36","20170214121428","Shop","AAA04","9","72000","3600","68400","2017-02-14 12:14:28"
"7215","62","20170214110318","PC","AAA02","6","90000","13800","76200","2017-02-14 11:03:18"
"7216","100","20170214094240","Mobile","AAA04","1","8000","400","7600","2017-02-14 09:42:40"
"7217","85","20170214075250","Shop","AAA01","3","30000","6000","24000","2017-02-14 07:52:50"
"7218","9","20170213032611","PC","AAA01","1","10000","2000","8000","2017-02-13 15:26:11"
"7219","84","20170213012519","PC","AAA05","2","120000","40000","80000","2017-02-13 13:25:19"
"7220","93","20170213123434","Mobile","AAA05","3","180000","60000","120000","2017-02-13 12:34:34"
"7221","14","20170213113458","Shop","AAA01","3","30000","6000","24000","2017-02-13 11:34:58"
"7222","24","20170213103816","Shop","AAA02","4","60000","9200","50800","2017-02-13 10:38:16"
"7223","47","20170213092448","PC","AAA02","9","135000","20700","114300","2017-02-13 09:24:48"
"7224","73","20170209070552","Mobile","AAA05","2","120000","40000","80000","2017-02-09 19:05:52"
"7225","56","20170209031729","PC","AAA01","7","70000","14000","56000","2017-02-09 15:17:29"
"7226","97","20170209021057","Mobile","AAA02","7","105000","16100","88900","2017-02-09 14:10:57"
"7227","59","20170209124607","Mobile","AAA01","4","40000","8000","32000","2017-02-09 12:46:07"
"7228","77","20170209103831","PC","AAA04","3","24000","1200","22800","2017-02-09 10:38:31"
"7229","97","20170209094225","PC","AAA03","3","51000","9000","42000","2017-02-09 09:42:25"
"7230","58","20170209082044","Mobile","AAA05","5","300000","100000","200000","2017-02-09 08:20:44"
"7231","33","20170209065915","Mobile","AAA05","5","300000","100000","200000","2017-02-09 06:59:15"
"7232","7","20170208105805","PC","AAA05","8","480000","160000","320000","2017-02-08 22:58:05"
"7233","3","20170208040628","PC","AAA01","8","80000","16000","64000","2017-02-08 16:06:28"
"7234","25","20170208022002","Shop","AAA01","2","20000","4000","16000","2017-02-08 14:20:02"
"7235","27","20170208010959","Shop","AAA02","5","75000","11500","63500","2017-02-08 13:09:59"
"7236","10","20170208100844","Shop","AAA01","11","110000","22000","88000","2017-02-08 10:08:44"
"7237","72","20170208083329","Shop","AAA04","3","24000","1200","22800","2017-02-08 08:33:29"
"7238","99","20170208080014","Mobile","AAA05","3","180000","60000","120000","2017-02-08 08:00:14"
"7239","80","20170208061951","Mobile","AAA02","8","120000","18400","101600","2017-02-08 06:19:51"
"7240","84","20170207041607","Shop","AAA04","1","8000","400","7600","2017-02-07 16:16:07"
"7241","76","20170207032921","Mobile","AAA05","7","420000","140000","280000","2017-02-07 15:29:21"
"7242","58","20170207020120","Mobile","AAA05","3","180000","60000","120000","2017-02-07 14:01:20"
"7243","50","20170207103405","PC","AAA05","16","960000","320000","640000","2017-02-07 10:34:05"
"7244","95","20170207085008","Shop","AAA03","3","51000","9000","42000","2017-02-07 08:50:08"
"7245","63","20170207073737","Shop","AAA03","3","51000","9000","42000","2017-02-07 07:37:37"
"7246","46","20170206084023","PC","AAA01","9","90000","18000","72000","2017-02-06 08:40:23"
"7247","39","20170204083310","Shop","AAA04","3","24000","1200","22800","2017-02-04 20:33:10"
"7248","89","20170203081929","Mobile","AAA01","12","120000","24000","96000","2017-02-03 08:19:29"
"7249","18","20170202053012","Mobile","AAA04","4","32000","1600","30400","2017-02-02 17:30:12"
"7250","75","20170202043614","PC","AAA01","2","20000","4000","16000","2017-02-02 16:36:14"
"7251","93","20170202033121","PC","AAA02","4","60000","9200","50800","2017-02-02 15:31:21"
"7252","79","20170202020815","PC","AAA01","8","80000","16000","64000","2017-02-02 14:08:15"
"7253","80","20170202010731","PC","AAA03","6","102000","18000","84000","2017-02-02 13:07:31"
"7254","55","20170202115412","Shop","AAA03","7","119000","21000","98000","2017-02-02 11:54:12"
"7255","54","20170202084009","Shop","AAA04","2","16000","800","15200","2017-02-02 08:40:09"
"7256","48","20170202063942","PC","AAA01","9","90000","18000","72000","2017-02-02 06:39:42"
"7257","23","20170201022358","Shop","AAA04","2","16000","800","15200","2017-02-01 14:23:58"
"7258","8","20170201124017","PC","AAA01","4","40000","8000","32000","2017-02-01 12:40:17"
"7259","65","20170201111814","Mobile","AAA05","9","540000","180000","360000","2017-02-01 11:18:14"
"7260","51","20170201101151","Mobile","AAA05","6","360000","120000","240000","2017-02-01 10:11:51"
"7261","73","20170201084736","PC","AAA03","5","85000","15000","70000","2017-02-01 08:47:36"
"7262","22","20170201073223","Mobile","AAA02","2","30000","4600","25400","2017-02-01 07:32:23"
"7263","8","20170131022417","Shop","AAA01","11","110000","22000","88000","2017-01-31 14:24:17"
"7264","10","20170131013142","Mobile","AAA03","10","170000","30000","140000","2017-01-31 13:31:42"
"7265","42","20170131121437","Mobile","AAA05","6","360000","120000","240000","2017-01-31 12:14:37"
"7266","36","20170131113240","Shop","AAA04","12","96000","4800","91200","2017-01-31 11:32:40"
"7267","92","20170131101332","PC","AAA02","10","150000","23000","127000","2017-01-31 10:13:32"
"7268","91","20170131084233","Mobile","AAA05","6","360000","120000","240000","2017-01-31 08:42:33"
"7269","47","20170130055752","Mobile","AAA01","18","180000","36000","144000","2017-01-30 17:57:52"
"7270","72","20170130041650","PC","AAA03","1","17000","3000","14000","2017-01-30 16:16:50"
"7271","21","20170130013020","PC","AAA04","6","48000","2400","45600","2017-01-30 13:30:20"
"7272","64","20170130120711","Shop","AAA03","8","136000","24000","112000","2017-01-30 12:07:11"
"7273","78","20170130111533","PC","AAA05","10","600000","200000","400000","2017-01-30 11:15:33"
"7274","29","20170130101144","Shop","AAA01","1","10000","2000","8000","2017-01-30 10:11:44"
"7275","24","20170130091601","Shop","AAA03","6","102000","18000","84000","2017-01-30 09:16:01"
"7276","29","20170127012330","PC","AAA01","3","30000","6000","24000","2017-01-27 13:23:30"
"7277","25","20170127110435","PC","AAA02","9","135000","20700","114300","2017-01-27 11:04:35"
"7278","46","20170127093009","Shop","AAA01","8","80000","16000","64000","2017-01-27 09:30:09"
"7279","49","20170127080720","PC","AAA04","1","8000","400","7600","2017-01-27 08:07:20"
"7280","64","20170127064538","Shop","AAA04","8","64000","3200","60800","2017-01-27 06:45:38"
"7281","36","20170126100000","Mobile","AAA05","13","780000","260000","520000","2017-01-26 10:00:00"
"7282","41","20170126084248","Shop","AAA04","6","48000","2400","45600","2017-01-26 08:42:48"
"7283","50","20170126074542","Mobile","AAA01","7","70000","14000","56000","2017-01-26 07:45:42"
"7284","72","20170126022230","Shop","AAA03","7","119000","21000","98000","2017-01-26 02:22:30"
"7285","75","20170125042626","Mobile","AAA03","4","68000","12000","56000","2017-01-25 16:26:26"
"7286","78","20170125022209","PC","AAA02","1","15000","2300","12700","2017-01-25 14:22:09"
"7287","21","20170125020416","PC","AAA02","6","90000","13800","76200","2017-01-25 14:04:16"
"7288","27","20170125125232","PC","AAA02","8","120000","18400","101600","2017-01-25 12:52:32"
"7289","7","20170125114147","Mobile","AAA02","3","45000","6900","38100","2017-01-25 11:41:47"
"7290","8","20170125093705","PC","AAA04","12","96000","4800","91200","2017-01-25 09:37:05"
"7291","81","20170124032658","Shop","AAA01","3","30000","6000","24000","2017-01-24 15:26:58"
"7292","70","20170124022902","Shop","AAA03","6","102000","18000","84000","2017-01-24 14:29:02"
"7293","23","20170124125609","Mobile","AAA05","3","180000","60000","120000","2017-01-24 12:56:09"
"7294","99","20170124114017","Mobile","AAA01","7","70000","14000","56000","2017-01-24 11:40:17"
"7295","41","20170124095946","Mobile","AAA04","7","56000","2800","53200","2017-01-24 09:59:46"
"7296","4","20170124084325","PC","AAA05","1","60000","20000","40000","2017-01-24 08:43:25"
"7297","47","20170124080838","Mobile","AAA05","1","60000","20000","40000","2017-01-24 08:08:38"
"7298","89","20170124071510","Shop","AAA04","8","64000","3200","60800","2017-01-24 07:15:10"
"7299","66","20170123045909","Shop","AAA05","2","120000","40000","80000","2017-01-23 16:59:09"
"7300","76","20170123024808","PC","AAA03","9","153000","27000","126000","2017-01-23 14:48:08"
"7301","53","20170123013045","Mobile","AAA03","1","17000","3000","14000","2017-01-23 13:30:45"
"7302","4","20170123124435","PC","AAA05","7","420000","140000","280000","2017-01-23 12:44:35"
"7303","58","20170123103957","Shop","AAA03","1","17000","3000","14000","2017-01-23 10:39:57"
"7304","18","20170123083047","PC","AAA02","6","90000","13800","76200","2017-01-23 08:30:47"
"7305","76","20170119091125","Mobile","AAA04","3","24000","1200","22800","2017-01-19 21:11:25"
"7306","1","20170119044917","Shop","AAA04","6","48000","2400","45600","2017-01-19 16:49:17"
"7307","3","20170119033239","Mobile","AAA01","15","150000","30000","120000","2017-01-19 15:32:39"
"7308","41","20170119020910","PC","AAA04","3","24000","1200","22800","2017-01-19 14:09:10"
"7309","79","20170119125411","Shop","AAA03","4","68000","12000","56000","2017-01-19 12:54:11"
"7310","73","20170119111017","PC","AAA01","5","50000","10000","40000","2017-01-19 11:10:17"
"7311","83","20170119063256","PC","AAA01","8","80000","16000","64000","2017-01-19 06:32:56"
"7312","92","20170118114649","Shop","AAA01","5","50000","10000","40000","2017-01-18 23:46:49"
"7313","60","20170118084702","Mobile","AAA02","4","60000","9200","50800","2017-01-18 08:47:02"
"7314","30","20170118070546","Mobile","AAA03","6","102000","18000","84000","2017-01-18 07:05:46"
"7315","34","20170117063054","Mobile","AAA03","3","51000","9000","42000","2017-01-17 18:30:54"
"7316","62","20170117032711","Shop","AAA03","8","136000","24000","112000","2017-01-17 15:27:11"
"7317","18","20170117022158","PC","AAA01","1","10000","2000","8000","2017-01-17 14:21:58"
"7318","81","20170117120727","PC","AAA04","1","8000","400","7600","2017-01-17 12:07:27"
"7319","83","20170117105152","Mobile","AAA04","6","48000","2400","45600","2017-01-17 10:51:52"
"7320","13","20170117094046","Mobile","AAA04","2","16000","800","15200","2017-01-17 09:40:46"
"7321","76","20170117081234","Mobile","AAA04","5","40000","2000","38000","2017-01-17 08:12:34"
"7322","9","20170117063241","Shop","AAA03","5","85000","15000","70000","2017-01-17 06:32:41"
"7323","94","20170116052306","Shop","AAA03","2","34000","6000","28000","2017-01-16 17:23:06"
"7324","63","20170116041443","PC","AAA03","6","102000","18000","84000","2017-01-16 16:14:43"
"7325","79","20170116030601","Mobile","AAA05","4","240000","80000","160000","2017-01-16 15:06:01"
"7326","93","20170116012612","Mobile","AAA02","3","45000","6900","38100","2017-01-16 13:26:12"
"7327","21","20170116113212","Mobile","AAA01","3","30000","6000","24000","2017-01-16 11:32:12"
"7328","10","20170116100552","PC","AAA02","4","60000","9200","50800","2017-01-16 10:05:52"
"7329","45","20170116080825","Shop","AAA05","6","360000","120000","240000","2017-01-16 08:08:25"
"7330","31","20170114075134","PC","AAA04","3","24000","1200","22800","2017-01-14 07:51:34"
"7331","1","20170113044349","Shop","AAA04","10","80000","4000","76000","2017-01-13 16:43:49"
"7332","37","20170113033755","Mobile","AAA05","19","1140000","380000","760000","2017-01-13 15:37:55"
"7333","54","20170113021812","Shop","AAA03","5","85000","15000","70000","2017-01-13 14:18:12"
"7334","87","20170113011004","Shop","AAA01","1","10000","2000","8000","2017-01-13 13:10:04"
"7335","85","20170113115114","Mobile","AAA05","4","240000","80000","160000","2017-01-13 11:51:14"
"7336","31","20170113093828","Mobile","AAA05","6","360000","120000","240000","2017-01-13 09:38:28"
"7337","55","20170113075951","Mobile","AAA05","6","360000","120000","240000","2017-01-13 07:59:51"
"7338","21","20170112081004","PC","AAA05","11","660000","220000","440000","2017-01-12 20:10:04"
"7339","86","20170112023006","Shop","AAA05","6","360000","120000","240000","2017-01-12 14:30:06"
"7340","50","20170112010715","PC","AAA02","1","15000","2300","12700","2017-01-12 13:07:15"
"7341","74","20170112104015","PC","AAA05","3","180000","60000","120000","2017-01-12 10:40:15"
"7342","7","20170112091555","Mobile","AAA04","3","24000","1200","22800","2017-01-12 09:15:55"
"7343","100","20170112072830","PC","AAA05","3","180000","60000","120000","2017-01-12 07:28:30"
"7344","79","20170111121306","Shop","AAA04","2","16000","800","15200","2017-01-11 12:13:06"
"7345","18","20170111105537","PC","AAA02","6","90000","13800","76200","2017-01-11 10:55:37"
"7346","12","20170111091635","Mobile","AAA02","3","45000","6900","38100","2017-01-11 09:16:35"
"7347","96","20170111083834","Shop","AAA01","5","50000","10000","40000","2017-01-11 08:38:34"
"7348","72","20170111071633","Shop","AAA01","6","60000","12000","48000","2017-01-11 07:16:33"
"7349","36","20170110103641","Shop","AAA03","1","17000","3000","14000","2017-01-10 22:36:41"
"7350","58","20170110061259","Mobile","AAA05","3","180000","60000","120000","2017-01-10 18:12:59"
"7351","14","20170110034716","Shop","AAA02","4","60000","9200","50800","2017-01-10 15:47:16"
"7352","30","20170110031329","PC","AAA04","4","32000","1600","30400","2017-01-10 15:13:29"
"7353","89","20170110015259","Shop","AAA03","8","136000","24000","112000","2017-01-10 13:52:59"
"7354","3","20170110121810","PC","AAA03","10","170000","30000","140000","2017-01-10 12:18:10"
"7355","1","20170110111006","PC","AAA04","1","8000","400","7600","2017-01-10 11:10:06"
"7356","31","20170110104310","PC","AAA01","8","80000","16000","64000","2017-01-10 10:43:10"
"7357","47","20170110094608","Shop","AAA04","7","56000","2800","53200","2017-01-10 09:46:08"
"7358","68","20170110063527","Shop","AAA05","1","60000","20000","40000","2017-01-10 06:35:27"
"7359","79","20170109082218","Mobile","AAA05","8","480000","160000","320000","2017-01-09 08:22:18"
"7360","67","20170105052404","Shop","AAA02","1","15000","2300","12700","2017-01-05 17:24:04"
"7361","10","20170105041745","Shop","AAA01","12","120000","24000","96000","2017-01-05 16:17:45"
"7362","67","20170105033324","Mobile","AAA04","9","72000","3600","68400","2017-01-05 15:33:24"
"7363","25","20170105015353","PC","AAA05","6","360000","120000","240000","2017-01-05 13:53:53"
"7364","22","20170105124813","PC","AAA01","2","20000","4000","16000","2017-01-05 12:48:13"
"7365","46","20170105115410","Mobile","AAA04","1","8000","400","7600","2017-01-05 11:54:10"
"7366","22","20170105094229","Shop","AAA01","2","20000","4000","16000","2017-01-05 09:42:29"
"7367","92","20170105075956","Shop","AAA02","7","105000","16100","88900","2017-01-05 07:59:56"
"7368","18","20170105120519","Mobile","AAA02","10","150000","23000","127000","2017-01-05 00:05:19"
"7369","76","20170104094522","Shop","AAA03","1","17000","3000","14000","2017-01-04 09:45:22"
"7370","46","20170104083433","Mobile","AAA04","6","48000","2400","45600","2017-01-04 08:34:33"
"7371","17","20170104072028","Shop","AAA03","6","102000","18000","84000","2017-01-04 07:20:28"
"7372","97","20170103115526","Mobile","AAA04","1","8000","400","7600","2017-01-03 11:55:26"
"7373","26","20170103111110","PC","AAA02","2","30000","4600","25400","2017-01-03 11:11:10"
"7374","39","20170103102805","Mobile","AAA04","3","24000","1200","22800","2017-01-03 10:28:05"
"7375","87","20170103084926","Mobile","AAA05","8","480000","160000","320000","2017-01-03 08:49:26"
"7376","23","20170103072757","Shop","AAA02","1","15000","2300","12700","2017-01-03 07:27:57"
"7377","54","20170102035920","Shop","AAA03","9","153000","27000","126000","2017-01-02 15:59:20"
"7378","4","20170102023616","PC","AAA05","5","300000","100000","200000","2017-01-02 14:36:16"
"7379","65","20170102124240","Shop","AAA01","4","40000","8000","32000","2017-01-02 12:42:40"
"7380","47","20170102111933","Mobile","AAA03","4","68000","12000","56000","2017-01-02 11:19:33"
"7381","69","20170102094916","PC","AAA03","1","17000","3000","14000","2017-01-02 09:49:16"
"7382","45","20161230112805","Shop","AAA05","6","360000","120000","240000","2016-12-30 11:28:05"
"7383","11","20161230065808","Mobile","AAA02","10","150000","23000","127000","2016-12-30 06:58:08"
"7384","70","20161229073556","Mobile","AAA01","1","10000","2000","8000","2016-12-29 19:35:56"
"7385","75","20161229124540","Shop","AAA01","1","10000","2000","8000","2016-12-29 12:45:40"
"7386","8","20161229113851","Mobile","AAA05","1","60000","20000","40000","2016-12-29 11:38:51"
"7387","57","20161229100210","Shop","AAA05","2","120000","40000","80000","2016-12-29 10:02:10"
"7388","92","20161229064138","PC","AAA02","4","60000","9200","50800","2016-12-29 06:41:38"
"7389","29","20161228013942","PC","AAA02","4","60000","9200","50800","2016-12-28 13:39:42"
"7390","3","20161228120241","Mobile","AAA05","10","600000","200000","400000","2016-12-28 12:02:41"
"7391","82","20161228102119","Shop","AAA02","3","45000","6900","38100","2016-12-28 10:21:19"
"7392","11","20161228083141","Shop","AAA05","13","780000","260000","520000","2016-12-28 08:31:41"
"7393","98","20161228070417","PC","AAA03","1","17000","3000","14000","2016-12-28 07:04:17"
"7394","16","20161227010357","PC","AAA04","13","104000","5200","98800","2016-12-27 13:03:57"
"7395","32","20161227105654","Mobile","AAA01","9","90000","18000","72000","2016-12-27 10:56:54"
"7396","100","20161227094935","Shop","AAA02","2","30000","4600","25400","2016-12-27 09:49:35"
"7397","94","20161227064635","PC","AAA04","11","88000","4400","83600","2016-12-27 06:46:35"
"7398","48","20161226025707","Mobile","AAA01","5","50000","10000","40000","2016-12-26 14:57:07"
"7399","25","20161226110548","Shop","AAA02","7","105000","16100","88900","2016-12-26 11:05:48"
"7400","62","20161226092926","Mobile","AAA01","9","90000","18000","72000","2016-12-26 09:29:26"
"7401","80","20161224052923","Mobile","AAA03","7","119000","21000","98000","2016-12-24 17:29:23"
"7402","6","20161223090021","PC","AAA03","7","119000","21000","98000","2016-12-23 21:00:21"
"7403","85","20161223061637","Shop","AAA01","3","30000","6000","24000","2016-12-23 18:16:37"
"7404","32","20161223022519","PC","AAA03","3","51000","9000","42000","2016-12-23 14:25:19"
"7405","86","20161223125053","Shop","AAA03","1","17000","3000","14000","2016-12-23 12:50:53"
"7406","100","20161223112242","Mobile","AAA04","3","24000","1200","22800","2016-12-23 11:22:42"
"7407","95","20161223094201","Mobile","AAA03","4","68000","12000","56000","2016-12-23 09:42:01"
"7408","40","20161223073312","Shop","AAA01","10","100000","20000","80000","2016-12-23 07:33:12"
"7409","20","20161222061735","Mobile","AAA04","2","16000","800","15200","2016-12-22 18:17:35"
"7410","37","20161222112641","PC","AAA03","1","17000","3000","14000","2016-12-22 11:26:41"
"7411","83","20161222095017","Mobile","AAA03","13","221000","39000","182000","2016-12-22 09:50:17"
"7412","85","20161222083415","PC","AAA03","6","102000","18000","84000","2016-12-22 08:34:15"
"7413","78","20161222074612","PC","AAA04","2","16000","800","15200","2016-12-22 07:46:12"
"7414","84","20161221073508","Mobile","AAA04","3","24000","1200","22800","2016-12-21 19:35:08"
"7415","43","20161221044449","PC","AAA03","11","187000","33000","154000","2016-12-21 16:44:49"
"7416","95","20161221024042","Shop","AAA03","6","102000","18000","84000","2016-12-21 14:40:42"
"7417","70","20161221021543","PC","AAA02","7","105000","16100","88900","2016-12-21 14:15:43"
"7418","90","20161221013101","PC","AAA04","3","24000","1200","22800","2016-12-21 13:31:01"
"7419","74","20161221122550","PC","AAA05","3","180000","60000","120000","2016-12-21 12:25:50"
"7420","50","20161221113631","PC","AAA04","6","48000","2400","45600","2016-12-21 11:36:31"
"7421","3","20161221102027","Shop","AAA03","10","170000","30000","140000","2016-12-21 10:20:27"
"7422","19","20161221084652","PC","AAA05","1","60000","20000","40000","2016-12-21 08:46:52"
"7423","97","20161220082044","Mobile","AAA01","8","80000","16000","64000","2016-12-20 20:20:44"
"7424","14","20161220024738","Shop","AAA04","1","8000","400","7600","2016-12-20 14:47:38"
"7425","21","20161220013042","Mobile","AAA02","8","120000","18400","101600","2016-12-20 13:30:42"
"7426","47","20161220115439","Shop","AAA01","8","80000","16000","64000","2016-12-20 11:54:39"
"7427","67","20161220100048","Mobile","AAA05","5","300000","100000","200000","2016-12-20 10:00:48"
"7428","58","20161220092156","PC","AAA04","2","16000","800","15200","2016-12-20 09:21:56"
"7429","20","20161220083059","PC","AAA05","2","120000","40000","80000","2016-12-20 08:30:59"
"7430","47","20161220080041","PC","AAA05","7","420000","140000","280000","2016-12-20 08:00:41"
"7431","83","20161220071627","Shop","AAA01","9","90000","18000","72000","2016-12-20 07:16:27"
"7432","22","20161219112305","Mobile","AAA01","5","50000","10000","40000","2016-12-19 23:23:05"
"7433","89","20161219024236","Shop","AAA01","14","140000","28000","112000","2016-12-19 14:42:36"
"7434","67","20161219125618","Shop","AAA03","6","102000","18000","84000","2016-12-19 12:56:18"
"7435","87","20161219104532","Mobile","AAA01","5","50000","10000","40000","2016-12-19 10:45:32"
"7436","100","20161219092111","PC","AAA05","3","180000","60000","120000","2016-12-19 09:21:11"
"7437","27","20161215070504","PC","AAA05","8","480000","160000","320000","2016-12-15 19:05:04"
"7438","17","20161215040009","Shop","AAA04","10","80000","4000","76000","2016-12-15 16:00:09"
"7439","25","20161215023809","Shop","AAA03","1","17000","3000","14000","2016-12-15 14:38:09"
"7440","76","20161215012315","Shop","AAA04","2","16000","800","15200","2016-12-15 13:23:15"
"7441","94","20161215115023","PC","AAA03","10","170000","30000","140000","2016-12-15 11:50:23"
"7442","44","20161215101856","Shop","AAA04","10","80000","4000","76000","2016-12-15 10:18:56"
"7443","45","20161215083429","PC","AAA03","1","17000","3000","14000","2016-12-15 08:34:29"
"7444","16","20161214072353","Mobile","AAA02","16","240000","36800","203200","2016-12-14 19:23:53"
"7445","77","20161214022421","PC","AAA01","3","30000","6000","24000","2016-12-14 14:24:21"
"7446","86","20161214124842","Shop","AAA04","2","16000","800","15200","2016-12-14 12:48:42"
"7447","18","20161214102847","Shop","AAA05","2","120000","40000","80000","2016-12-14 10:28:47"
"7448","43","20161214094543","PC","AAA05","8","480000","160000","320000","2016-12-14 09:45:43"
"7449","5","20161214084309","PC","AAA03","4","68000","12000","56000","2016-12-14 08:43:09"
"7450","5","20161214070050","PC","AAA05","1","60000","20000","40000","2016-12-14 07:00:50"
"7451","17","20161213065247","Mobile","AAA02","5","75000","11500","63500","2016-12-13 18:52:47"
"7452","94","20161213034407","Mobile","AAA04","1","8000","400","7600","2016-12-13 15:44:07"
"7453","25","20161213021742","Mobile","AAA03","1","17000","3000","14000","2016-12-13 14:17:42"
"7454","6","20161213013432","Shop","AAA02","4","60000","9200","50800","2016-12-13 13:34:32"
"7455","81","20161213125117","Mobile","AAA03","4","68000","12000","56000","2016-12-13 12:51:17"
"7456","23","20161213110024","PC","AAA04","1","8000","400","7600","2016-12-13 11:00:24"
"7457","85","20161213100524","Mobile","AAA04","5","40000","2000","38000","2016-12-13 10:05:24"
"7458","23","20161213083253","Mobile","AAA02","7","105000","16100","88900","2016-12-13 08:32:53"
"7459","39","20161212014838","Mobile","AAA04","3","24000","1200","22800","2016-12-12 13:48:38"
"7460","99","20161212115803","Shop","AAA03","5","85000","15000","70000","2016-12-12 11:58:03"
"7461","28","20161212101109","Shop","AAA01","8","80000","16000","64000","2016-12-12 10:11:09"
"7462","95","20161212081959","Mobile","AAA02","6","90000","13800","76200","2016-12-12 08:19:59"
"7463","38","20161207091854","Mobile","AAA04","11","88000","4400","83600","2016-12-07 09:18:54"
"7464","97","20161207075815","Shop","AAA05","6","360000","120000","240000","2016-12-07 07:58:15"
"7465","50","20161207023257","PC","AAA05","5","300000","100000","200000","2016-12-07 02:32:57"
"7466","96","20161206122004","Shop","AAA01","3","30000","6000","24000","2016-12-06 12:20:04"
"7467","63","20161206102207","Mobile","AAA01","3","30000","6000","24000","2016-12-06 10:22:07"
"7468","59","20161206083802","Shop","AAA03","4","68000","12000","56000","2016-12-06 08:38:02"
"7469","17","20161206081012","Mobile","AAA05","3","180000","60000","120000","2016-12-06 08:10:12"
"7470","62","20161206063736","Shop","AAA03","1","17000","3000","14000","2016-12-06 06:37:36"
"7471","5","20161205090133","PC","AAA03","5","85000","15000","70000","2016-12-05 21:01:33"
"7472","28","20161205060456","PC","AAA03","6","102000","18000","84000","2016-12-05 18:04:56"
"7473","79","20161205024917","PC","AAA02","3","45000","6900","38100","2016-12-05 14:49:17"
"7474","65","20161205113130","Shop","AAA01","6","60000","12000","48000","2016-12-05 11:31:30"
"7475","25","20161205095516","Mobile","AAA04","8","64000","3200","60800","2016-12-05 09:55:16"
"7476","55","20161201053157","PC","AAA03","12","204000","36000","168000","2016-12-01 17:31:57"
"7477","50","20161201022442","Mobile","AAA03","10","170000","30000","140000","2016-12-01 14:24:42"
"7478","63","20161201123205","Shop","AAA05","2","120000","40000","80000","2016-12-01 12:32:05"
"7479","92","20161201112104","PC","AAA05","4","240000","80000","160000","2016-12-01 11:21:04"
"7480","84","20161201091421","PC","AAA05","1","60000","20000","40000","2016-12-01 09:14:21"
"7481","47","20161201074757","Mobile","AAA01","10","100000","20000","80000","2016-12-01 07:47:57"
"7482","90","20161130044112","Mobile","AAA04","1","8000","400","7600","2016-11-30 16:41:12"
"7483","23","20161130033320","Mobile","AAA04","1","8000","400","7600","2016-11-30 15:33:20"
"7484","98","20161130103345","Mobile","AAA02","2","30000","4600","25400","2016-11-30 10:33:45"
"7485","13","20161130085439","Mobile","AAA01","1","10000","2000","8000","2016-11-30 08:54:39"
"7486","43","20161130075224","Shop","AAA02","9","135000","20700","114300","2016-11-30 07:52:24"
"7487","32","20161129053224","Mobile","AAA02","19","285000","43700","241300","2016-11-29 17:32:24"
"7488","73","20161129020326","Shop","AAA04","9","72000","3600","68400","2016-11-29 14:03:26"
"7489","69","20161129124704","Shop","AAA04","1","8000","400","7600","2016-11-29 12:47:04"
"7490","57","20161129115243","Shop","AAA02","1","15000","2300","12700","2016-11-29 11:52:43"
"7491","36","20161129102533","Shop","AAA02","6","90000","13800","76200","2016-11-29 10:25:33"
"7492","38","20161129084934","Shop","AAA03","7","119000","21000","98000","2016-11-29 08:49:34"
"7493","49","20161129074204","PC","AAA01","7","70000","14000","56000","2016-11-29 07:42:04"
"7494","59","20161128082037","Shop","AAA05","1","60000","20000","40000","2016-11-28 20:20:37"
"7495","15","20161128044803","Shop","AAA04","17","136000","6800","129200","2016-11-28 16:48:03"
"7496","9","20161128042549","Shop","AAA01","3","30000","6000","24000","2016-11-28 16:25:49"
"7497","97","20161128033613","PC","AAA02","2","30000","4600","25400","2016-11-28 15:36:13"
"7498","49","20161128015210","PC","AAA03","10","170000","30000","140000","2016-11-28 13:52:10"
"7499","11","20161128010103","Shop","AAA01","2","20000","4000","16000","2016-11-28 13:01:03"
"7500","3","20161128121349","PC","AAA05","11","660000","220000","440000","2016-11-28 12:13:49"
"7501","17","20161128101018","Shop","AAA02","4","60000","9200","50800","2016-11-28 10:10:18"
"7502","6","20161128085443","Mobile","AAA02","1","15000","2300","12700","2016-11-28 08:54:43"
"7503","41","20161124074955","PC","AAA03","7","119000","21000","98000","2016-11-24 07:49:55"
"7504","96","20161123115612","PC","AAA03","7","119000","21000","98000","2016-11-23 11:56:12"
"7505","46","20161123095447","Mobile","AAA05","8","480000","160000","320000","2016-11-23 09:54:47"
"7506","25","20161123085552","PC","AAA05","2","120000","40000","80000","2016-11-23 08:55:52"
"7507","6","20161123070008","Shop","AAA03","5","85000","15000","70000","2016-11-23 07:00:08"
"7508","47","20161122105618","PC","AAA03","11","187000","33000","154000","2016-11-22 22:56:18"
"7509","39","20161122073942","Mobile","AAA03","3","51000","9000","42000","2016-11-22 19:39:42"
"7510","44","20161122123213","PC","AAA01","3","30000","6000","24000","2016-11-22 12:32:13"
"7511","66","20161122112908","PC","AAA03","1","17000","3000","14000","2016-11-22 11:29:08"
"7512","56","20161122071653","Mobile","AAA01","3","30000","6000","24000","2016-11-22 07:16:53"
"7513","48","20161121065737","Shop","AAA04","6","48000","2400","45600","2016-11-21 18:57:37"
"7514","10","20161121041133","Mobile","AAA01","7","70000","14000","56000","2016-11-21 16:11:33"
"7515","7","20161121024257","Mobile","AAA03","6","102000","18000","84000","2016-11-21 14:42:57"
"7516","75","20161121125502","Mobile","AAA05","5","300000","100000","200000","2016-11-21 12:55:02"
"7517","50","20161121113532","Shop","AAA03","9","153000","27000","126000","2016-11-21 11:35:32"
"7518","84","20161121102326","PC","AAA04","6","48000","2400","45600","2016-11-21 10:23:26"
"7519","44","20161121085341","Mobile","AAA05","2","120000","40000","80000","2016-11-21 08:53:41"
"7520","75","20161117042515","PC","AAA05","2","120000","40000","80000","2016-11-17 16:25:15"
"7521","76","20161117012440","PC","AAA03","4","68000","12000","56000","2016-11-17 13:24:40"
"7522","50","20161117115336","Mobile","AAA05","12","720000","240000","480000","2016-11-17 11:53:36"
"7523","82","20161117074947","Shop","AAA02","4","60000","9200","50800","2016-11-17 07:49:47"
"7524","30","20161116075821","Shop","AAA01","4","40000","8000","32000","2016-11-16 19:58:21"
"7525","96","20161116031536","Mobile","AAA01","3","30000","6000","24000","2016-11-16 15:15:36"
"7526","48","20161116023126","Shop","AAA04","7","56000","2800","53200","2016-11-16 14:31:26"
"7527","47","20161116123905","Shop","AAA04","5","40000","2000","38000","2016-11-16 12:39:05"
"7528","19","20161116112712","Shop","AAA05","2","120000","40000","80000","2016-11-16 11:27:12"
"7529","5","20161116095336","PC","AAA02","6","90000","13800","76200","2016-11-16 09:53:36"
"7530","85","20161116082305","Mobile","AAA01","4","40000","8000","32000","2016-11-16 08:23:05"
"7531","72","20161116060940","Mobile","AAA03","4","68000","12000","56000","2016-11-16 06:09:40"
"7532","57","20161115031100","PC","AAA03","1","17000","3000","14000","2016-11-15 15:11:00"
"7533","92","20161115014316","Mobile","AAA01","9","90000","18000","72000","2016-11-15 13:43:16"
"7534","35","20161115115717","PC","AAA01","4","40000","8000","32000","2016-11-15 11:57:17"
"7535","70","20161115103704","Shop","AAA01","9","90000","18000","72000","2016-11-15 10:37:04"
"7536","77","20161115085205","Shop","AAA01","4","40000","8000","32000","2016-11-15 08:52:05"
"7537","8","20161115074325","Mobile","AAA03","6","102000","18000","84000","2016-11-15 07:43:25"
"7538","6","20161114062339","PC","AAA03","4","68000","12000","56000","2016-11-14 18:23:39"
"7539","70","20161114125040","Mobile","AAA01","12","120000","24000","96000","2016-11-14 12:50:40"
"7540","60","20161114083211","Mobile","AAA05","1","60000","20000","40000","2016-11-14 08:32:11"
"7541","16","20161110122300","PC","AAA05","14","840000","280000","560000","2016-11-10 00:23:00"
"7542","21","20161109054031","PC","AAA03","12","204000","36000","168000","2016-11-09 05:40:31"
"7543","66","20161108034739","PC","AAA02","3","45000","6900","38100","2016-11-08 15:47:39"
"7544","2","20161108022412","PC","AAA05","3","180000","60000","120000","2016-11-08 14:24:12"
"7545","50","20161108125747","Shop","AAA03","7","119000","21000","98000","2016-11-08 12:57:47"
"7546","27","20161108111302","PC","AAA02","9","135000","20700","114300","2016-11-08 11:13:02"
"7547","71","20161108100429","PC","AAA05","1","60000","20000","40000","2016-11-08 10:04:29"
"7548","96","20161108091417","Mobile","AAA03","5","85000","15000","70000","2016-11-08 09:14:17"
"7549","50","20161108072353","Shop","AAA03","5","85000","15000","70000","2016-11-08 07:23:53"
"7550","54","20161107075545","Mobile","AAA01","9","90000","18000","72000","2016-11-07 19:55:45"
"7551","34","20161107125947","PC","AAA03","12","204000","36000","168000","2016-11-07 12:59:47"
"7552","54","20161107113640","PC","AAA04","8","64000","3200","60800","2016-11-07 11:36:40"
"7553","33","20161107103405","Shop","AAA03","5","85000","15000","70000","2016-11-07 10:34:05"
"7554","58","20161107092248","Mobile","AAA04","6","48000","2400","45600","2016-11-07 09:22:48"
"7555","98","20161105033337","PC","AAA02","2","30000","4600","25400","2016-11-05 03:33:37"
"7556","18","20161104095251","PC","AAA05","7","420000","140000","280000","2016-11-04 09:52:51"
"7557","70","20161104083918","Mobile","AAA05","6","360000","120000","240000","2016-11-04 08:39:18"
"7558","34","20161104060059","Shop","AAA05","6","360000","120000","240000","2016-11-04 06:00:59"
"7559","15","20161103055223","Shop","AAA03","6","102000","18000","84000","2016-11-03 17:52:23"
"7560","32","20161103122945","Shop","AAA01","10","100000","20000","80000","2016-11-03 12:29:45"
"7561","78","20161103112356","Mobile","AAA04","10","80000","4000","76000","2016-11-03 11:23:56"
"7562","97","20161103102151","PC","AAA05","3","180000","60000","120000","2016-11-03 10:21:51"
"7563","92","20161103085030","Shop","AAA03","11","187000","33000","154000","2016-11-03 08:50:30"
"7564","69","20161102052658","PC","AAA04","5","40000","2000","38000","2016-11-02 17:26:58"
"7565","3","20161102031321","PC","AAA05","4","240000","80000","160000","2016-11-02 15:13:21"
"7566","80","20161102020032","Shop","AAA04","1","8000","400","7600","2016-11-02 14:00:32"
"7567","52","20161102012011","PC","AAA05","3","180000","60000","120000","2016-11-02 13:20:11"
"7568","52","20161102120745","Mobile","AAA01","3","30000","6000","24000","2016-11-02 12:07:45"
"7569","16","20161102111313","Shop","AAA05","8","480000","160000","320000","2016-11-02 11:13:13"
"7570","51","20161102084232","PC","AAA05","10","600000","200000","400000","2016-11-02 08:42:32"
"7571","15","20161102063600","Mobile","AAA02","5","75000","11500","63500","2016-11-02 06:36:00"
"7572","73","20161102012944","PC","AAA04","4","32000","1600","30400","2016-11-02 01:29:44"
"7573","72","20161101010415","Mobile","AAA03","1","17000","3000","14000","2016-11-01 13:04:15"
"7574","21","20161101114247","PC","AAA02","7","105000","16100","88900","2016-11-01 11:42:47"
"7575","56","20161101101703","PC","AAA04","15","120000","6000","114000","2016-11-01 10:17:03"
"7576","7","20161101085342","PC","AAA01","6","60000","12000","48000","2016-11-01 08:53:42"
"7577","67","20161031085601","PC","AAA01","6","60000","12000","48000","2016-10-31 20:56:01"
"7578","77","20161031053646","Shop","AAA04","1","8000","400","7600","2016-10-31 17:36:46"
"7579","84","20161031043945","PC","AAA02","1","15000","2300","12700","2016-10-31 16:39:45"
"7580","35","20161031032133","Mobile","AAA01","1","10000","2000","8000","2016-10-31 15:21:33"
"7581","29","20161031021623","PC","AAA02","6","90000","13800","76200","2016-10-31 14:16:23"
"7582","35","20161031124342","PC","AAA02","2","30000","4600","25400","2016-10-31 12:43:42"
"7583","37","20161031114113","PC","AAA02","14","210000","32200","177800","2016-10-31 11:41:13"
"7584","84","20161031100512","Mobile","AAA04","1","8000","400","7600","2016-10-31 10:05:12"
"7585","96","20161031084256","Mobile","AAA05","8","480000","160000","320000","2016-10-31 08:42:56"
"7586","70","20161028012943","PC","AAA03","5","85000","15000","70000","2016-10-28 13:29:43"
"7587","20","20161028121406","PC","AAA01","1","10000","2000","8000","2016-10-28 12:14:06"
"7588","60","20161028112029","PC","AAA05","5","300000","100000","200000","2016-10-28 11:20:29"
"7589","74","20161028085242","PC","AAA04","6","48000","2400","45600","2016-10-28 08:52:42"
"7590","90","20161027094219","Shop","AAA01","6","60000","12000","48000","2016-10-27 21:42:19"
"7591","71","20161027041645","Shop","AAA02","4","60000","9200","50800","2016-10-27 16:16:45"
"7592","39","20161027025012","Mobile","AAA04","6","48000","2400","45600","2016-10-27 14:50:12"
"7593","71","20161027014219","Mobile","AAA04","3","24000","1200","22800","2016-10-27 13:42:19"
"7594","44","20161027115050","PC","AAA04","1","8000","400","7600","2016-10-27 11:50:50"
"7595","61","20161027094431","Mobile","AAA01","3","30000","6000","24000","2016-10-27 09:44:31"
"7596","44","20161027083828","Shop","AAA01","5","50000","10000","40000","2016-10-27 08:38:28"
"7597","27","20161026104919","Shop","AAA01","15","150000","30000","120000","2016-10-26 22:49:19"
"7598","81","20161026063531","PC","AAA01","9","90000","18000","72000","2016-10-26 18:35:31"
"7599","44","20161026021158","Mobile","AAA01","7","70000","14000","56000","2016-10-26 14:11:58"
"7600","62","20161026013535","Shop","AAA04","9","72000","3600","68400","2016-10-26 13:35:35"
"7601","18","20161026111535","PC","AAA03","3","51000","9000","42000","2016-10-26 11:15:35"
"7602","80","20161026094633","Shop","AAA02","4","60000","9200","50800","2016-10-26 09:46:33"
"7603","44","20161026060450","Mobile","AAA01","4","40000","8000","32000","2016-10-26 06:04:50"
"7604","68","20161025095752","Mobile","AAA05","1","60000","20000","40000","2016-10-25 21:57:52"
"7605","49","20161025060603","PC","AAA05","2","120000","40000","80000","2016-10-25 18:06:03"
"7606","57","20161025040901","Mobile","AAA05","3","180000","60000","120000","2016-10-25 16:09:01"
"7607","94","20161025025554","Mobile","AAA05","17","1020000","340000","680000","2016-10-25 14:55:54"
"7608","47","20161025014146","Mobile","AAA02","11","165000","25300","139700","2016-10-25 13:41:46"
"7609","37","20161025113303","Shop","AAA02","6","90000","13800","76200","2016-10-25 11:33:03"
"7610","54","20161025100351","Shop","AAA04","6","48000","2400","45600","2016-10-25 10:03:51"
"7611","13","20161025085020","PC","AAA03","1","17000","3000","14000","2016-10-25 08:50:20"
"7612","29","20161025073446","Mobile","AAA03","7","119000","21000","98000","2016-10-25 07:34:46"
"7613","59","20161024091422","Mobile","AAA01","2","20000","4000","16000","2016-10-24 21:14:22"
"7614","22","20161024110834","PC","AAA02","1","15000","2300","12700","2016-10-24 11:08:34"
"7615","81","20161024090709","Shop","AAA05","5","300000","100000","200000","2016-10-24 09:07:09"
"7616","65","20161019052930","Shop","AAA02","7","105000","16100","88900","2016-10-19 05:29:30"
"7617","1","20161018105152","Shop","AAA05","6","360000","120000","240000","2016-10-18 22:51:52"
"7618","55","20161018013942","Shop","AAA03","5","85000","15000","70000","2016-10-18 13:39:42"
"7619","27","20161018124515","PC","AAA05","4","240000","80000","160000","2016-10-18 12:45:15"
"7620","2","20161018110847","Shop","AAA05","3","180000","60000","120000","2016-10-18 11:08:47"
"7621","2","20161018092904","Mobile","AAA01","2","20000","4000","16000","2016-10-18 09:29:04"
"7622","51","20161018081656","Shop","AAA05","2","120000","40000","80000","2016-10-18 08:16:56"
"7623","44","20161018064123","Shop","AAA04","5","40000","2000","38000","2016-10-18 06:41:23"
"7624","64","20161017042139","PC","AAA03","3","51000","9000","42000","2016-10-17 16:21:39"
"7625","68","20161017024902","PC","AAA01","4","40000","8000","32000","2016-10-17 14:49:02"
"7626","92","20161017010140","Mobile","AAA04","6","48000","2400","45600","2016-10-17 13:01:40"
"7627","27","20161017110040","Shop","AAA01","15","150000","30000","120000","2016-10-17 11:00:40"
"7628","95","20161013032604","Shop","AAA01","2","20000","4000","16000","2016-10-13 15:26:04"
"7629","95","20161013015557","Mobile","AAA02","5","75000","11500","63500","2016-10-13 13:55:57"
"7630","93","20161013122107","Mobile","AAA01","2","20000","4000","16000","2016-10-13 12:21:07"
"7631","4","20161013110059","Mobile","AAA03","2","34000","6000","28000","2016-10-13 11:00:59"
"7632","24","20161013092208","PC","AAA05","5","300000","100000","200000","2016-10-13 09:22:08"
"7633","64","20161012033518","Shop","AAA02","4","60000","9200","50800","2016-10-12 15:35:18"
"7634","37","20161012122734","PC","AAA02","2","30000","4600","25400","2016-10-12 12:27:34"
"7635","66","20161012103203","Mobile","AAA05","11","660000","220000","440000","2016-10-12 10:32:03"
"7636","18","20161012093001","PC","AAA03","3","51000","9000","42000","2016-10-12 09:30:01"
"7637","15","20161012073036","Mobile","AAA01","9","90000","18000","72000","2016-10-12 07:30:36"
"7638","100","20161011042124","Mobile","AAA02","4","60000","9200","50800","2016-10-11 16:21:24"
"7639","99","20161011030130","Shop","AAA05","4","240000","80000","160000","2016-10-11 15:01:30"
"7640","36","20161011123322","Shop","AAA04","9","72000","3600","68400","2016-10-11 12:33:22"
"7641","28","20161011094514","PC","AAA05","7","420000","140000","280000","2016-10-11 09:45:14"
"7642","23","20161011073504","PC","AAA03","2","34000","6000","28000","2016-10-11 07:35:04"
"7643","13","20161010043612","Shop","AAA05","2","120000","40000","80000","2016-10-10 16:36:12"
"7644","16","20161010043143","Mobile","AAA01","5","50000","10000","40000","2016-10-10 16:31:43"
"7645","4","20161010024503","Mobile","AAA03","4","68000","12000","56000","2016-10-10 14:45:03"
"7646","5","20161010011117","Mobile","AAA04","12","96000","4800","91200","2016-10-10 13:11:17"
"7647","65","20161010103219","PC","AAA04","11","88000","4400","83600","2016-10-10 10:32:19"
"7648","94","20161010091242","PC","AAA05","3","180000","60000","120000","2016-10-10 09:12:42"
"7649","4","20161007064925","Shop","AAA02","5","75000","11500","63500","2016-10-07 06:49:25"
"7650","4","20161006115559","Mobile","AAA05","1","60000","20000","40000","2016-10-06 23:55:59"
"7651","74","20161006075635","Shop","AAA04","6","48000","2400","45600","2016-10-06 19:56:35"
"7652","67","20161006043048","PC","AAA03","5","85000","15000","70000","2016-10-06 16:30:48"
"7653","75","20161006032720","Mobile","AAA01","3","30000","6000","24000","2016-10-06 15:27:20"
"7654","62","20161006112633","Shop","AAA05","11","660000","220000","440000","2016-10-06 11:26:33"
"7655","52","20161006083644","Shop","AAA03","1","17000","3000","14000","2016-10-06 08:36:44"
"7656","43","20161006065245","Mobile","AAA05","16","960000","320000","640000","2016-10-06 06:52:45"
"7657","91","20161005050512","PC","AAA04","8","64000","3200","60800","2016-10-05 17:05:12"
"7658","84","20161005035924","PC","AAA02","1","15000","2300","12700","2016-10-05 15:59:24"
"7659","51","20161005023930","PC","AAA03","4","68000","12000","56000","2016-10-05 14:39:30"
"7660","93","20161005010939","Shop","AAA03","1","17000","3000","14000","2016-10-05 13:09:39"
"7661","64","20161005123407","Shop","AAA02","4","60000","9200","50800","2016-10-05 12:34:07"
"7662","10","20161005100523","PC","AAA03","9","153000","27000","126000","2016-10-05 10:05:23"
"7663","16","20161005091322","PC","AAA05","4","240000","80000","160000","2016-10-05 09:13:22"
"7664","63","20161005065820","Shop","AAA04","4","32000","1600","30400","2016-10-05 06:58:20"
"7665","20","20161004072313","Shop","AAA03","1","17000","3000","14000","2016-10-04 19:23:13"
"7666","88","20161004031925","Mobile","AAA04","6","48000","2400","45600","2016-10-04 15:19:25"
"7667","98","20161004010847","PC","AAA04","2","16000","800","15200","2016-10-04 13:08:47"
"7668","61","20161004114741","PC","AAA02","5","75000","11500","63500","2016-10-04 11:47:41"
"7669","75","20161004110556","PC","AAA03","5","85000","15000","70000","2016-10-04 11:05:56"
"7670","10","20161004093927","Mobile","AAA03","9","153000","27000","126000","2016-10-04 09:39:27"
"7671","89","20161003113110","Shop","AAA01","13","130000","26000","104000","2016-10-03 11:31:10"
"7672","4","20161003100738","Shop","AAA01","6","60000","12000","48000","2016-10-03 10:07:38"
"7673","73","20161003085427","Shop","AAA04","17","136000","6800","129200","2016-10-03 08:54:27"
"7674","67","20160928013356","Shop","AAA03","3","51000","9000","42000","2016-09-28 13:33:56"
"7675","36","20160928103506","PC","AAA04","12","96000","4800","91200","2016-09-28 10:35:06"
"7676","63","20160928085947","Mobile","AAA05","8","480000","160000","320000","2016-09-28 08:59:47"
"7677","90","20160927015450","PC","AAA03","1","17000","3000","14000","2016-09-27 13:54:50"
"7678","19","20160927125910","Shop","AAA04","2","16000","800","15200","2016-09-27 12:59:10"
"7679","38","20160927113205","PC","AAA03","2","34000","6000","28000","2016-09-27 11:32:05"
"7680","66","20160927102423","Mobile","AAA01","5","50000","10000","40000","2016-09-27 10:24:23"
"7681","28","20160927084907","Mobile","AAA02","8","120000","18400","101600","2016-09-27 08:49:07"
"7682","10","20160927075629","PC","AAA02","13","195000","29900","165100","2016-09-27 07:56:29"
"7683","98","20160926065232","PC","AAA05","1","60000","20000","40000","2016-09-26 18:52:32"
"7684","11","20160926034953","PC","AAA02","1","15000","2300","12700","2016-09-26 15:49:53"
"7685","36","20160926022132","Shop","AAA01","10","100000","20000","80000","2016-09-26 14:21:32"
"7686","76","20160926121339","Shop","AAA04","3","24000","1200","22800","2016-09-26 12:13:39"
"7687","37","20160926104641","PC","AAA02","4","60000","9200","50800","2016-09-26 10:46:41"
"7688","79","20160926092953","PC","AAA02","7","105000","16100","88900","2016-09-26 09:29:53"
"7689","30","20160922104810","Mobile","AAA03","10","170000","30000","140000","2016-09-22 22:48:10"
"7690","15","20160922061015","PC","AAA04","5","40000","2000","38000","2016-09-22 18:10:15"
"7691","88","20160922043941","Mobile","AAA03","4","68000","12000","56000","2016-09-22 16:39:41"
"7692","40","20160922023343","PC","AAA05","2","120000","40000","80000","2016-09-22 14:33:43"
"7693","94","20160922012122","Shop","AAA02","11","165000","25300","139700","2016-09-22 13:21:22"
"7694","78","20160922102155","Shop","AAA02","2","30000","4600","25400","2016-09-22 10:21:55"
"7695","62","20160922091341","Shop","AAA03","12","204000","36000","168000","2016-09-22 09:13:41"
"7696","100","20160922072557","PC","AAA04","2","16000","800","15200","2016-09-22 07:25:57"
"7697","45","20160921110523","PC","AAA02","3","45000","6900","38100","2016-09-21 23:05:23"
"7698","74","20160920082303","Mobile","AAA01","4","40000","8000","32000","2016-09-20 20:23:03"
"7699","26","20160920035728","Shop","AAA04","6","48000","2400","45600","2016-09-20 15:57:28"
"7700","73","20160920023205","PC","AAA02","5","75000","11500","63500","2016-09-20 14:32:05"
"7701","7","20160920010653","Shop","AAA01","4","40000","8000","32000","2016-09-20 13:06:53"
"7702","31","20160920055934","Shop","AAA03","3","51000","9000","42000","2016-09-20 05:59:34"
"7703","18","20160919102602","Shop","AAA02","3","45000","6900","38100","2016-09-19 22:26:02"
"7704","82","20160919043424","Shop","AAA05","6","360000","120000","240000","2016-09-19 16:34:24"
"7705","36","20160919104508","Mobile","AAA02","13","195000","29900","165100","2016-09-19 10:45:08"
"7706","35","20160919091400","Mobile","AAA01","1","10000","2000","8000","2016-09-19 09:14:00"
"7707","91","20160917125904","Mobile","AAA04","6","48000","2400","45600","2016-09-17 00:59:04"
"7708","27","20160916054613","PC","AAA05","7","420000","140000","280000","2016-09-16 05:46:13"
"7709","42","20160915010507","Shop","AAA03","13","221000","39000","182000","2016-09-15 13:05:07"
"7710","25","20160915104630","Shop","AAA01","9","90000","18000","72000","2016-09-15 10:46:30"
"7711","67","20160915093909","PC","AAA03","9","153000","27000","126000","2016-09-15 09:39:09"
"7712","21","20160915080540","PC","AAA03","8","136000","24000","112000","2016-09-15 08:05:40"
"7713","97","20160915061827","Mobile","AAA01","5","50000","10000","40000","2016-09-15 06:18:27"
"7714","8","20160914023521","Shop","AAA02","6","90000","13800","76200","2016-09-14 14:35:21"
"7715","70","20160914011655","Shop","AAA03","6","102000","18000","84000","2016-09-14 13:16:55"
"7716","69","20160914122541","PC","AAA01","5","50000","10000","40000","2016-09-14 12:25:41"
"7717","95","20160914103841","PC","AAA02","6","90000","13800","76200","2016-09-14 10:38:41"
"7718","52","20160914080040","Mobile","AAA05","3","180000","60000","120000","2016-09-14 08:00:40"
"7719","80","20160914054800","PC","AAA02","2","30000","4600","25400","2016-09-14 05:48:00"
"7720","91","20160913023240","Shop","AAA03","5","85000","15000","70000","2016-09-13 14:32:40"
"7721","19","20160913010050","Mobile","AAA03","3","51000","9000","42000","2016-09-13 13:00:50"
"7722","54","20160913114920","Shop","AAA03","10","170000","30000","140000","2016-09-13 11:49:20"
"7723","22","20160913103727","Mobile","AAA02","3","45000","6900","38100","2016-09-13 10:37:27"
"7724","35","20160913083527","PC","AAA02","3","45000","6900","38100","2016-09-13 08:35:27"
"7725","94","20160913071852","Mobile","AAA03","6","102000","18000","84000","2016-09-13 07:18:52"
"7726","38","20160912101659","Mobile","AAA05","6","360000","120000","240000","2016-09-12 22:16:59"
"7727","2","20160912051942","Shop","AAA04","3","24000","1200","22800","2016-09-12 17:19:42"
"7728","52","20160912045223","Shop","AAA05","1","60000","20000","40000","2016-09-12 16:52:23"
"7729","8","20160912013549","PC","AAA05","2","120000","40000","80000","2016-09-12 13:35:49"
"7730","1","20160912123326","PC","AAA01","6","60000","12000","48000","2016-09-12 12:33:26"
"7731","80","20160912114719","Shop","AAA04","3","24000","1200","22800","2016-09-12 11:47:19"
"7732","10","20160912095302","PC","AAA01","3","30000","6000","24000","2016-09-12 09:53:02"
"7733","73","20160909105728","PC","AAA02","6","90000","13800","76200","2016-09-09 22:57:28"
"7734","74","20160909020924","PC","AAA03","5","85000","15000","70000","2016-09-09 14:09:24"
"7735","18","20160909010158","Shop","AAA01","4","40000","8000","32000","2016-09-09 13:01:58"
"7736","74","20160909120916","Shop","AAA03","6","102000","18000","84000","2016-09-09 12:09:16"
"7737","95","20160909092513","Mobile","AAA04","2","16000","800","15200","2016-09-09 09:25:13"
"7738","15","20160909074627","PC","AAA03","2","34000","6000","28000","2016-09-09 07:46:27"
"7739","24","20160908021121","PC","AAA04","8","64000","3200","60800","2016-09-08 14:11:21"
"7740","49","20160908010507","PC","AAA05","6","360000","120000","240000","2016-09-08 13:05:07"
"7741","41","20160908090434","PC","AAA01","5","50000","10000","40000","2016-09-08 09:04:34"
"7742","51","20160908075010","PC","AAA02","1","15000","2300","12700","2016-09-08 07:50:10"
"7743","72","20160907084156","Mobile","AAA02","3","45000","6900","38100","2016-09-07 20:41:56"
"7744","4","20160907063322","Mobile","AAA05","5","300000","100000","200000","2016-09-07 18:33:22"
"7745","98","20160907042159","Mobile","AAA01","3","30000","6000","24000","2016-09-07 16:21:59"
"7746","46","20160907032647","Mobile","AAA04","12","96000","4800","91200","2016-09-07 15:26:47"
"7747","31","20160907020333","Shop","AAA05","2","120000","40000","80000","2016-09-07 14:03:33"
"7748","98","20160907110023","Shop","AAA03","4","68000","12000","56000","2016-09-07 11:00:23"
"7749","34","20160907091704","PC","AAA04","10","80000","4000","76000","2016-09-07 09:17:04"
"7750","46","20160907071947","PC","AAA04","3","24000","1200","22800","2016-09-07 07:19:47"
"7751","10","20160906030901","PC","AAA01","8","80000","16000","64000","2016-09-06 15:09:01"
"7752","84","20160906025212","Shop","AAA03","3","51000","9000","42000","2016-09-06 14:52:12"
"7753","28","20160906125443","Mobile","AAA05","3","180000","60000","120000","2016-09-06 12:54:43"
"7754","87","20160906100342","Mobile","AAA05","2","120000","40000","80000","2016-09-06 10:03:42"
"7755","75","20160906084936","Shop","AAA03","5","85000","15000","70000","2016-09-06 08:49:36"
"7756","89","20160906062308","Shop","AAA04","7","56000","2800","53200","2016-09-06 06:23:08"
"7757","75","20160905082625","Mobile","AAA01","3","30000","6000","24000","2016-09-05 20:26:25"
"7758","21","20160905053451","Mobile","AAA03","9","153000","27000","126000","2016-09-05 17:34:51"
"7759","100","20160905033304","Mobile","AAA04","1","8000","400","7600","2016-09-05 15:33:04"
"7760","34","20160905124557","Mobile","AAA05","10","600000","200000","400000","2016-09-05 12:45:57"
"7761","21","20160905100606","PC","AAA05","7","420000","140000","280000","2016-09-05 10:06:06"
"7762","49","20160905085723","Mobile","AAA01","5","50000","10000","40000","2016-09-05 08:57:23"
"7763","51","20160901083429","Mobile","AAA03","17","289000","51000","238000","2016-09-01 08:34:29"
"7764","50","20160901072634","Mobile","AAA02","7","105000","16100","88900","2016-09-01 07:26:34"
"7765","1","20160831011115","Mobile","AAA05","8","480000","160000","320000","2016-08-31 13:11:15"
"7766","86","20160831115053","Mobile","AAA02","5","75000","11500","63500","2016-08-31 11:50:53"
"7767","54","20160831102234","Shop","AAA05","2","120000","40000","80000","2016-08-31 10:22:34"
"7768","56","20160831085243","Shop","AAA02","4","60000","9200","50800","2016-08-31 08:52:43"
"7769","94","20160830110952","Mobile","AAA04","2","16000","800","15200","2016-08-30 23:09:52"
"7770","44","20160830035505","Mobile","AAA02","2","30000","4600","25400","2016-08-30 03:55:05"
"7771","87","20160829052505","PC","AAA03","5","85000","15000","70000","2016-08-29 17:25:05"
"7772","40","20160829044418","PC","AAA05","7","420000","140000","280000","2016-08-29 16:44:18"
"7773","99","20160829025246","PC","AAA03","2","34000","6000","28000","2016-08-29 14:52:46"
"7774","84","20160829124337","PC","AAA02","1","15000","2300","12700","2016-08-29 12:43:37"
"7775","20","20160829090401","Mobile","AAA05","5","300000","100000","200000","2016-08-29 09:04:01"
"7776","42","20160826033543","Mobile","AAA04","14","112000","5600","106400","2016-08-26 03:35:43"
"7777","56","20160825081444","PC","AAA02","2","30000","4600","25400","2016-08-25 20:14:44"
"7778","11","20160825043331","Mobile","AAA04","13","104000","5200","98800","2016-08-25 16:33:31"
"7779","80","20160825032943","PC","AAA04","5","40000","2000","38000","2016-08-25 15:29:43"
"7780","2","20160825022604","PC","AAA03","7","119000","21000","98000","2016-08-25 14:26:04"
"7781","63","20160825125802","Mobile","AAA05","5","300000","100000","200000","2016-08-25 12:58:02"
"7782","67","20160825111437","PC","AAA03","7","119000","21000","98000","2016-08-25 11:14:37"
"7783","47","20160825091658","Mobile","AAA05","2","120000","40000","80000","2016-08-25 09:16:58"
"7784","56","20160825074559","PC","AAA03","7","119000","21000","98000","2016-08-25 07:45:59"
"7785","59","20160824102224","Shop","AAA03","1","17000","3000","14000","2016-08-24 22:22:24"
"7786","73","20160824065752","PC","AAA03","13","221000","39000","182000","2016-08-24 18:57:52"
"7787","70","20160824030836","Mobile","AAA01","6","60000","12000","48000","2016-08-24 15:08:36"
"7788","44","20160824014822","Mobile","AAA04","4","32000","1600","30400","2016-08-24 13:48:22"
"7789","88","20160824011315","PC","AAA04","6","48000","2400","45600","2016-08-24 13:13:15"
"7790","91","20160824111934","Shop","AAA05","2","120000","40000","80000","2016-08-24 11:19:34"
"7791","97","20160824100055","Shop","AAA03","9","153000","27000","126000","2016-08-24 10:00:55"
"7792","43","20160824083402","Mobile","AAA05","5","300000","100000","200000","2016-08-24 08:34:02"
"7793","28","20160824072548","PC","AAA03","7","119000","21000","98000","2016-08-24 07:25:48"
"7794","27","20160823042254","Mobile","AAA01","10","100000","20000","80000","2016-08-23 16:22:54"
"7795","43","20160823020431","Mobile","AAA01","5","50000","10000","40000","2016-08-23 14:04:31"
"7796","70","20160823115702","PC","AAA02","6","90000","13800","76200","2016-08-23 11:57:02"
"7797","86","20160823092926","PC","AAA02","3","45000","6900","38100","2016-08-23 09:29:26"
"7798","71","20160823073038","Mobile","AAA05","6","360000","120000","240000","2016-08-23 07:30:38"
"7799","47","20160823122849","Shop","AAA05","9","540000","180000","360000","2016-08-23 00:28:49"
"7800","47","20160822023437","Shop","AAA02","7","105000","16100","88900","2016-08-22 14:34:37"
"7801","62","20160822113617","Shop","AAA05","8","480000","160000","320000","2016-08-22 11:36:17"
"7802","60","20160822095747","Mobile","AAA04","6","48000","2400","45600","2016-08-22 09:57:47"
"7803","5","20160819083518","Mobile","AAA03","5","85000","15000","70000","2016-08-19 08:35:18"
"7804","69","20160819072321","PC","AAA02","3","45000","6900","38100","2016-08-19 07:23:21"
"7805","74","20160818080115","PC","AAA04","3","24000","1200","22800","2016-08-18 20:01:15"
"7806","85","20160818033504","Mobile","AAA05","4","240000","80000","160000","2016-08-18 15:35:04"
"7807","83","20160818021035","Shop","AAA02","17","255000","39100","215900","2016-08-18 14:10:35"
"7808","8","20160818120431","Shop","AAA02","12","180000","27600","152400","2016-08-18 12:04:31"
"7809","45","20160818111641","Shop","AAA01","4","40000","8000","32000","2016-08-18 11:16:41"
"7810","86","20160818092849","PC","AAA03","3","51000","9000","42000","2016-08-18 09:28:49"
"7811","62","20160818074537","Shop","AAA04","6","48000","2400","45600","2016-08-18 07:45:37"
"7812","45","20160817025338","PC","AAA03","2","34000","6000","28000","2016-08-17 14:53:38"
"7813","48","20160817013431","Mobile","AAA02","6","90000","13800","76200","2016-08-17 13:34:31"
"7814","64","20160817112945","Mobile","AAA04","11","88000","4400","83600","2016-08-17 11:29:45"
"7815","7","20160817101847","Shop","AAA02","7","105000","16100","88900","2016-08-17 10:18:47"
"7816","80","20160817082643","Mobile","AAA05","13","780000","260000","520000","2016-08-17 08:26:43"
"7817","14","20160817070957","PC","AAA03","5","85000","15000","70000","2016-08-17 07:09:57"
"7818","53","20160817122214","PC","AAA05","2","120000","40000","80000","2016-08-17 00:22:14"
"7819","55","20160816123912","Mobile","AAA04","1","8000","400","7600","2016-08-16 12:39:12"
"7820","10","20160816120503","Shop","AAA03","7","119000","21000","98000","2016-08-16 12:05:03"
"7821","62","20160816104907","Mobile","AAA02","8","120000","18400","101600","2016-08-16 10:49:07"
"7822","11","20160816080036","PC","AAA03","3","51000","9000","42000","2016-08-16 08:00:36"
"7823","51","20160815102215","Shop","AAA03","2","34000","6000","28000","2016-08-15 22:22:15"
"7824","76","20160815065500","Shop","AAA01","7","70000","14000","56000","2016-08-15 18:55:00"
"7825","93","20160815115306","Shop","AAA01","2","20000","4000","16000","2016-08-15 11:53:06"
"7826","30","20160815101546","PC","AAA02","3","45000","6900","38100","2016-08-15 10:15:46"
"7827","2","20160815085750","Shop","AAA05","6","360000","120000","240000","2016-08-15 08:57:50"
"7828","58","20160811010659","PC","AAA02","3","45000","6900","38100","2016-08-11 13:06:59"
"7829","56","20160811114624","Shop","AAA03","13","221000","39000","182000","2016-08-11 11:46:24"
"7830","93","20160811094156","Shop","AAA05","3","180000","60000","120000","2016-08-11 09:41:56"
"7831","36","20160811075057","PC","AAA02","6","90000","13800","76200","2016-08-11 07:50:57"
"7832","11","20160810011747","PC","AAA04","3","24000","1200","22800","2016-08-10 13:17:47"
"7833","51","20160810110948","Mobile","AAA02","6","90000","13800","76200","2016-08-10 11:09:48"
"7834","87","20160810101213","PC","AAA04","4","32000","1600","30400","2016-08-10 10:12:13"
"7835","93","20160810080419","Shop","AAA04","4","32000","1600","30400","2016-08-10 08:04:19"
"7836","47","20160810064021","Mobile","AAA04","10","80000","4000","76000","2016-08-10 06:40:21"
"7837","5","20160809035836","Mobile","AAA01","12","120000","24000","96000","2016-08-09 15:58:36"
"7838","84","20160809022130","PC","AAA04","1","8000","400","7600","2016-08-09 14:21:30"
"7839","50","20160809124508","Mobile","AAA04","9","72000","3600","68400","2016-08-09 12:45:08"
"7840","27","20160809113223","Shop","AAA01","1","10000","2000","8000","2016-08-09 11:32:23"
"7841","17","20160809093942","PC","AAA02","3","45000","6900","38100","2016-08-09 09:39:42"
"7842","21","20160809081705","Mobile","AAA02","1","15000","2300","12700","2016-08-09 08:17:05"
"7843","1","20160809070823","Shop","AAA05","2","120000","40000","80000","2016-08-09 07:08:23"
"7844","65","20160809014211","Shop","AAA03","5","85000","15000","70000","2016-08-09 01:42:11"
"7845","73","20160808082944","Shop","AAA04","6","48000","2400","45600","2016-08-08 20:29:44"
"7846","59","20160808043739","PC","AAA02","3","45000","6900","38100","2016-08-08 16:37:39"
"7847","97","20160808042103","PC","AAA03","6","102000","18000","84000","2016-08-08 16:21:03"
"7848","76","20160808023153","Shop","AAA02","6","90000","13800","76200","2016-08-08 14:31:53"
"7849","88","20160808011912","PC","AAA02","4","60000","9200","50800","2016-08-08 13:19:12"
"7850","62","20160808121331","Shop","AAA05","2","120000","40000","80000","2016-08-08 12:13:31"
"7851","33","20160808102615","Shop","AAA03","1","17000","3000","14000","2016-08-08 10:26:15"
"7852","28","20160808084317","PC","AAA02","5","75000","11500","63500","2016-08-08 08:43:17"
"7853","66","20160806102750","Mobile","AAA02","1","15000","2300","12700","2016-08-06 10:27:50"
"7854","57","20160805080047","Shop","AAA05","4","240000","80000","160000","2016-08-05 08:00:47"
"7855","42","20160805065216","Shop","AAA04","3","24000","1200","22800","2016-08-05 06:52:16"
"7856","89","20160804033936","Shop","AAA05","1","60000","20000","40000","2016-08-04 15:39:36"
"7857","71","20160804015549","PC","AAA04","8","64000","3200","60800","2016-08-04 13:55:49"
"7858","43","20160804115726","Shop","AAA02","2","30000","4600","25400","2016-08-04 11:57:26"
"7859","80","20160804101059","Shop","AAA03","7","119000","21000","98000","2016-08-04 10:10:59"
"7860","10","20160803082901","PC","AAA05","5","300000","100000","200000","2016-08-03 20:29:01"
"7861","54","20160803063810","Mobile","AAA04","4","32000","1600","30400","2016-08-03 18:38:10"
"7862","17","20160803035242","Shop","AAA03","3","51000","9000","42000","2016-08-03 15:52:42"
"7863","30","20160803023744","Shop","AAA01","6","60000","12000","48000","2016-08-03 14:37:44"
"7864","82","20160803105339","PC","AAA04","10","80000","4000","76000","2016-08-03 10:53:39"
"7865","76","20160803095728","PC","AAA04","9","72000","3600","68400","2016-08-03 09:57:28"
"7866","21","20160803090311","Mobile","AAA03","14","238000","42000","196000","2016-08-03 09:03:11"
"7867","45","20160803074247","Mobile","AAA02","1","15000","2300","12700","2016-08-03 07:42:47"
"7868","27","20160802052925","Shop","AAA05","8","480000","160000","320000","2016-08-02 17:29:25"
"7869","1","20160802034241","PC","AAA05","10","600000","200000","400000","2016-08-02 15:42:41"
"7870","1","20160802024911","Shop","AAA05","8","480000","160000","320000","2016-08-02 14:49:11"
"7871","80","20160802013123","Mobile","AAA04","6","48000","2400","45600","2016-08-02 13:31:23"
"7872","83","20160802095442","Mobile","AAA01","7","70000","14000","56000","2016-08-02 09:54:42"
"7873","72","20160802080358","PC","AAA01","2","20000","4000","16000","2016-08-02 08:03:58"
"7874","89","20160802062600","PC","AAA01","10","100000","20000","80000","2016-08-02 06:26:00"
"7875","10","20160801101539","Mobile","AAA05","2","120000","40000","80000","2016-08-01 22:15:39"
"7876","91","20160801085418","Shop","AAA01","3","30000","6000","24000","2016-08-01 20:54:18"
"7877","57","20160801055858","Shop","AAA03","1","17000","3000","14000","2016-08-01 17:58:58"
"7878","99","20160801042202","Shop","AAA04","1","8000","400","7600","2016-08-01 16:22:02"
"7879","86","20160801031704","Shop","AAA05","2","120000","40000","80000","2016-08-01 15:17:04"
"7880","53","20160801023001","Mobile","AAA05","2","120000","40000","80000","2016-08-01 14:30:01"
"7881","29","20160801124147","Mobile","AAA02","5","75000","11500","63500","2016-08-01 12:41:47"
"7882","81","20160801104349","Shop","AAA04","3","24000","1200","22800","2016-08-01 10:43:49"
"7883","83","20160730074302","PC","AAA02","8","120000","18400","101600","2016-07-30 07:43:02"
"7884","53","20160729062331","Mobile","AAA01","3","30000","6000","24000","2016-07-29 18:23:31"
"7885","53","20160729125007","Mobile","AAA04","1","8000","400","7600","2016-07-29 12:50:07"
"7886","62","20160729103907","Mobile","AAA02","2","30000","4600","25400","2016-07-29 10:39:07"
"7887","57","20160729090501","PC","AAA03","7","119000","21000","98000","2016-07-29 09:05:01"
"7888","67","20160729073639","Mobile","AAA01","8","80000","16000","64000","2016-07-29 07:36:39"
"7889","14","20160728033739","Mobile","AAA03","3","51000","9000","42000","2016-07-28 15:37:39"
"7890","50","20160728020655","PC","AAA04","12","96000","4800","91200","2016-07-28 14:06:55"
"7891","60","20160728010252","Mobile","AAA01","5","50000","10000","40000","2016-07-28 13:02:52"
"7892","81","20160728093550","Mobile","AAA05","9","540000","180000","360000","2016-07-28 09:35:50"
"7893","34","20160728082510","PC","AAA05","9","540000","180000","360000","2016-07-28 08:25:10"
"7894","42","20160727063401","Mobile","AAA02","3","45000","6900","38100","2016-07-27 18:34:01"
"7895","96","20160727013922","Shop","AAA02","2","30000","4600","25400","2016-07-27 13:39:22"
"7896","58","20160727123521","Mobile","AAA04","1","8000","400","7600","2016-07-27 12:35:21"
"7897","51","20160727105529","Shop","AAA05","6","360000","120000","240000","2016-07-27 10:55:29"
"7898","50","20160727085913","PC","AAA01","9","90000","18000","72000","2016-07-27 08:59:13"
"7899","14","20160727072744","Shop","AAA01","4","40000","8000","32000","2016-07-27 07:27:44"
"7900","88","20160726034140","Mobile","AAA02","6","90000","13800","76200","2016-07-26 15:41:40"
"7901","70","20160726015258","PC","AAA02","11","165000","25300","139700","2016-07-26 13:52:58"
"7902","88","20160726123141","Mobile","AAA03","3","51000","9000","42000","2016-07-26 12:31:41"
"7903","69","20160726105212","Shop","AAA02","1","15000","2300","12700","2016-07-26 10:52:12"
"7904","59","20160726013335","Shop","AAA05","1","60000","20000","40000","2016-07-26 01:33:35"
"7905","50","20160725022019","Mobile","AAA05","8","480000","160000","320000","2016-07-25 14:20:19"
"7906","90","20160725115830","Mobile","AAA05","2","120000","40000","80000","2016-07-25 11:58:30"
"7907","95","20160725105926","Shop","AAA01","5","50000","10000","40000","2016-07-25 10:59:26"
"7908","42","20160725101415","PC","AAA02","12","180000","27600","152400","2016-07-25 10:14:15"
"7909","21","20160725084835","Shop","AAA02","2","30000","4600","25400","2016-07-25 08:48:35"
"7910","91","20160723013005","Mobile","AAA03","2","34000","6000","28000","2016-07-23 13:30:05"
"7911","81","20160722073011","PC","AAA01","9","90000","18000","72000","2016-07-22 19:30:11"
"7912","63","20160722030612","PC","AAA02","5","75000","11500","63500","2016-07-22 15:06:12"
"7913","74","20160722015057","PC","AAA03","4","68000","12000","56000","2016-07-22 13:50:57"
"7914","87","20160722123223","PC","AAA03","5","85000","15000","70000","2016-07-22 12:32:23"
"7915","10","20160722112755","Mobile","AAA05","8","480000","160000","320000","2016-07-22 11:27:55"
"7916","87","20160722091952","PC","AAA02","5","75000","11500","63500","2016-07-22 09:19:52"
"7917","39","20160722065702","Shop","AAA05","5","300000","100000","200000","2016-07-22 06:57:02"
"7918","39","20160721123441","Shop","AAA01","1","10000","2000","8000","2016-07-21 12:34:41"
"7919","32","20160721111907","Mobile","AAA01","8","80000","16000","64000","2016-07-21 11:19:07"
"7920","77","20160721101646","Mobile","AAA02","3","45000","6900","38100","2016-07-21 10:16:46"
"7921","51","20160721085617","Shop","AAA05","9","540000","180000","360000","2016-07-21 08:56:17"
"7922","38","20160721074758","PC","AAA04","5","40000","2000","38000","2016-07-21 07:47:58"
"7923","97","20160720093009","Mobile","AAA01","7","70000","14000","56000","2016-07-20 21:30:09"
"7924","50","20160720060713","PC","AAA04","7","56000","2800","53200","2016-07-20 18:07:13"
"7925","49","20160720114306","Mobile","AAA04","2","16000","800","15200","2016-07-20 11:43:06"
"7926","4","20160720103817","PC","AAA01","1","10000","2000","8000","2016-07-20 10:38:17"
"7927","75","20160720085359","Shop","AAA03","1","17000","3000","14000","2016-07-20 08:53:59"
"7928","73","20160720074807","Mobile","AAA01","8","80000","16000","64000","2016-07-20 07:48:07"
"7929","90","20160719091811","Mobile","AAA04","2","16000","800","15200","2016-07-19 21:18:11"
"7930","52","20160719040945","Shop","AAA03","1","17000","3000","14000","2016-07-19 16:09:45"
"7931","11","20160719012404","Mobile","AAA02","2","30000","4600","25400","2016-07-19 13:24:04"
"7932","95","20160719122852","PC","AAA05","2","120000","40000","80000","2016-07-19 12:28:52"
"7933","50","20160719110253","Mobile","AAA02","6","90000","13800","76200","2016-07-19 11:02:53"
"7934","86","20160719092044","Shop","AAA02","4","60000","9200","50800","2016-07-19 09:20:44"
"7935","43","20160719075713","PC","AAA02","4","60000","9200","50800","2016-07-19 07:57:13"
"7936","90","20160718092453","Shop","AAA04","3","24000","1200","22800","2016-07-18 21:24:53"
"7937","85","20160718054101","Shop","AAA05","6","360000","120000","240000","2016-07-18 17:41:01"
"7938","64","20160718035924","PC","AAA01","5","50000","10000","40000","2016-07-18 15:59:24"
"7939","19","20160718020742","PC","AAA05","2","120000","40000","80000","2016-07-18 14:07:42"
"7940","94","20160718123740","Mobile","AAA04","10","80000","4000","76000","2016-07-18 12:37:40"
"7941","89","20160718113901","Shop","AAA02","6","90000","13800","76200","2016-07-18 11:39:01"
"7942","2","20160718095436","Mobile","AAA02","2","30000","4600","25400","2016-07-18 09:54:36"
"7943","53","20160714042549","Mobile","AAA03","5","85000","15000","70000","2016-07-14 04:25:49"
"7944","53","20160713113927","PC","AAA03","1","17000","3000","14000","2016-07-13 11:39:27"
"7945","40","20160713104857","Shop","AAA04","1","8000","400","7600","2016-07-13 10:48:57"
"7946","1","20160713082200","Mobile","AAA05","1","60000","20000","40000","2016-07-13 08:22:00"
"7947","11","20160713071058","Shop","AAA03","2","34000","6000","28000","2016-07-13 07:10:58"
"7948","83","20160712065112","Mobile","AAA02","7","105000","16100","88900","2016-07-12 18:51:12"
"7949","47","20160712104734","Shop","AAA03","10","170000","30000","140000","2016-07-12 10:47:34"
"7950","21","20160712100715","Shop","AAA01","3","30000","6000","24000","2016-07-12 10:07:15"
"7951","97","20160712090845","Shop","AAA01","6","60000","12000","48000","2016-07-12 09:08:45"
"7952","51","20160712074720","Shop","AAA05","10","600000","200000","400000","2016-07-12 07:47:20"
"7953","14","20160712025643","PC","AAA04","2","16000","800","15200","2016-07-12 02:56:43"
"7954","28","20160711081845","PC","AAA01","11","110000","22000","88000","2016-07-11 08:18:45"
"7955","28","20160708082807","Mobile","AAA05","3","180000","60000","120000","2016-07-08 08:28:07"
"7956","1","20160707091815","Mobile","AAA02","10","150000","23000","127000","2016-07-07 21:18:15"
"7957","55","20160707063951","Mobile","AAA01","8","80000","16000","64000","2016-07-07 18:39:51"
"7958","50","20160707122535","PC","AAA02","5","75000","11500","63500","2016-07-07 12:25:35"
"7959","65","20160707094920","Mobile","AAA02","4","60000","9200","50800","2016-07-07 09:49:20"
"7960","9","20160707074923","PC","AAA02","1","15000","2300","12700","2016-07-07 07:49:23"
"7961","96","20160706043502","Shop","AAA04","6","48000","2400","45600","2016-07-06 16:35:02"
"7962","21","20160706032510","Shop","AAA02","7","105000","16100","88900","2016-07-06 15:25:10"
"7963","24","20160706021701","Mobile","AAA03","2","34000","6000","28000","2016-07-06 14:17:01"
"7964","22","20160706011355","Mobile","AAA05","1","60000","20000","40000","2016-07-06 13:13:55"
"7965","89","20160706105453","PC","AAA03","2","34000","6000","28000","2016-07-06 10:54:53"
"7966","69","20160706093702","Shop","AAA02","7","105000","16100","88900","2016-07-06 09:37:02"
"7967","1","20160706080257","PC","AAA01","2","20000","4000","16000","2016-07-06 08:02:57"
"7968","10","20160705111754","Mobile","AAA04","1","8000","400","7600","2016-07-05 23:17:54"
"7969","18","20160705062744","Mobile","AAA04","3","24000","1200","22800","2016-07-05 06:27:44"
"7970","64","20160704082918","Shop","AAA04","8","64000","3200","60800","2016-07-04 20:29:18"
"7971","89","20160704015923","PC","AAA01","8","80000","16000","64000","2016-07-04 13:59:23"
"7972","12","20160704010125","Mobile","AAA01","3","30000","6000","24000","2016-07-04 13:01:25"
"7973","66","20160704120306","Shop","AAA05","2","120000","40000","80000","2016-07-04 12:03:06"
"7974","35","20160704110534","Mobile","AAA03","3","51000","9000","42000","2016-07-04 11:05:34"
"7975","73","20160704085754","Shop","AAA01","1","10000","2000","8000","2016-07-04 08:57:54"
"7976","92","20160701012735","Shop","AAA04","8","64000","3200","60800","2016-07-01 01:27:35"
"7977","92","20160630062750","Shop","AAA05","7","420000","140000","280000","2016-06-30 18:27:50"
"7978","40","20160630010815","Mobile","AAA03","3","51000","9000","42000","2016-06-30 13:08:15"
"7979","38","20160630112340","PC","AAA03","8","136000","24000","112000","2016-06-30 11:23:40"
"7980","72","20160629010118","Mobile","AAA01","1","10000","2000","8000","2016-06-29 13:01:18"
"7981","24","20160629102800","Shop","AAA01","3","30000","6000","24000","2016-06-29 10:28:00"
"7982","68","20160629090918","PC","AAA01","7","70000","14000","56000","2016-06-29 09:09:18"
"7983","67","20160629074938","Mobile","AAA05","1","60000","20000","40000","2016-06-29 07:49:38"
"7984","63","20160628052856","PC","AAA05","3","180000","60000","120000","2016-06-28 17:28:56"
"7985","78","20160628034533","Mobile","AAA05","5","300000","100000","200000","2016-06-28 15:45:33"
"7986","67","20160628015454","Shop","AAA03","4","68000","12000","56000","2016-06-28 13:54:54"
"7987","4","20160628124040","Mobile","AAA02","2","30000","4600","25400","2016-06-28 12:40:40"
"7988","21","20160628111434","PC","AAA01","10","100000","20000","80000","2016-06-28 11:14:34"
"7989","84","20160628085909","Shop","AAA02","1","15000","2300","12700","2016-06-28 08:59:09"
"7990","56","20160628075250","Mobile","AAA04","3","24000","1200","22800","2016-06-28 07:52:50"
"7991","3","20160627013839","Mobile","AAA05","10","600000","200000","400000","2016-06-27 13:38:39"
"7992","41","20160627123035","Shop","AAA01","8","80000","16000","64000","2016-06-27 12:30:35"
"7993","34","20160627111137","Shop","AAA02","12","180000","27600","152400","2016-06-27 11:11:37"
"7994","45","20160627091950","Mobile","AAA02","4","60000","9200","50800","2016-06-27 09:19:50"
"7995","48","20160622075844","Shop","AAA03","11","187000","33000","154000","2016-06-22 19:58:44"
"7996","20","20160622021125","Mobile","AAA04","7","56000","2800","53200","2016-06-22 14:11:25"
"7997","45","20160622124528","PC","AAA03","7","119000","21000","98000","2016-06-22 12:45:28"
"7998","57","20160622105315","Shop","AAA04","4","32000","1600","30400","2016-06-22 10:53:15"
"7999","50","20160622095154","Shop","AAA04","6","48000","2400","45600","2016-06-22 09:51:54"
"8000","80","20160622081756","PC","AAA03","4","68000","12000","56000","2016-06-22 08:17:56"
"8001","29","20160622061841","Shop","AAA04","9","72000","3600","68400","2016-06-22 06:18:41"
"8002","97","20160621075946","Mobile","AAA04","4","32000","1600","30400","2016-06-21 07:59:46"
"8003","71","20160620031734","Mobile","AAA03","5","85000","15000","70000","2016-06-20 15:17:34"
"8004","54","20160620013430","Shop","AAA03","5","85000","15000","70000","2016-06-20 13:34:30"
"8005","68","20160620123257","Shop","AAA05","1","60000","20000","40000","2016-06-20 12:32:57"
"8006","17","20160620110538","Shop","AAA05","3","180000","60000","120000","2016-06-20 11:05:38"
"8007","29","20160616041014","PC","AAA05","10","600000","200000","400000","2016-06-16 04:10:14"
"8008","78","20160615030540","PC","AAA03","2","34000","6000","28000","2016-06-15 15:05:40"
"8009","13","20160615014034","Shop","AAA02","1","15000","2300","12700","2016-06-15 13:40:34"
"8010","44","20160615122922","Mobile","AAA03","6","102000","18000","84000","2016-06-15 12:29:22"
"8011","51","20160615105202","Mobile","AAA01","9","90000","18000","72000","2016-06-15 10:52:02"
"8012","74","20160615092829","PC","AAA05","7","420000","140000","280000","2016-06-15 09:28:29"
"8013","97","20160615080420","Mobile","AAA02","6","90000","13800","76200","2016-06-15 08:04:20"
"8014","20","20160615064839","Shop","AAA05","10","600000","200000","400000","2016-06-15 06:48:39"
"8015","16","20160614073531","Shop","AAA04","3","24000","1200","22800","2016-06-14 19:35:31"
"8016","37","20160614031859","PC","AAA03","6","102000","18000","84000","2016-06-14 15:18:59"
"8017","50","20160614023728","Shop","AAA04","8","64000","3200","60800","2016-06-14 14:37:28"
"8018","89","20160614125819","Shop","AAA02","10","150000","23000","127000","2016-06-14 12:58:19"
"8019","26","20160614111546","Shop","AAA02","1","15000","2300","12700","2016-06-14 11:15:46"
"8020","8","20160614104518","Shop","AAA02","16","240000","36800","203200","2016-06-14 10:45:18"
"8021","83","20160614094521","PC","AAA05","5","300000","100000","200000","2016-06-14 09:45:21"
"8022","25","20160614070243","PC","AAA01","3","30000","6000","24000","2016-06-14 07:02:43"
"8023","43","20160613033909","PC","AAA01","6","60000","12000","48000","2016-06-13 15:39:09"
"8024","67","20160613011942","Mobile","AAA02","5","75000","11500","63500","2016-06-13 13:19:42"
"8025","87","20160613113649","Shop","AAA04","1","8000","400","7600","2016-06-13 11:36:49"
"8026","35","20160613100543","Shop","AAA01","5","50000","10000","40000","2016-06-13 10:05:43"
"8027","12","20160613092614","PC","AAA04","1","8000","400","7600","2016-06-13 09:26:14"
"8028","51","20160609103448","Shop","AAA02","5","75000","11500","63500","2016-06-09 22:34:48"
"8029","48","20160609035816","Shop","AAA01","1","10000","2000","8000","2016-06-09 15:58:16"
"8030","46","20160609014454","Mobile","AAA03","3","51000","9000","42000","2016-06-09 13:44:54"
"8031","91","20160609124427","Mobile","AAA03","4","68000","12000","56000","2016-06-09 12:44:27"
"8032","26","20160609105745","PC","AAA01","5","50000","10000","40000","2016-06-09 10:57:45"
"8033","35","20160609095906","Mobile","AAA02","2","30000","4600","25400","2016-06-09 09:59:06"
"8034","75","20160609082850","PC","AAA02","3","45000","6900","38100","2016-06-09 08:28:50"
"8035","64","20160609065537","PC","AAA05","2","120000","40000","80000","2016-06-09 06:55:37"
"8036","70","20160608035207","Mobile","AAA03","6","102000","18000","84000","2016-06-08 15:52:07"
"8037","14","20160608125907","Mobile","AAA05","1","60000","20000","40000","2016-06-08 12:59:07"
"8038","55","20160608113935","Mobile","AAA01","2","20000","4000","16000","2016-06-08 11:39:35"
"8039","91","20160608085956","Shop","AAA01","4","40000","8000","32000","2016-06-08 08:59:56"
"8040","28","20160608071805","PC","AAA01","11","110000","22000","88000","2016-06-08 07:18:05"
"8041","16","20160607103021","Shop","AAA01","13","130000","26000","104000","2016-06-07 22:30:21"
"8042","52","20160607030517","PC","AAA01","5","50000","10000","40000","2016-06-07 15:05:17"
"8043","38","20160607011612","Mobile","AAA01","6","60000","12000","48000","2016-06-07 13:16:12"
"8044","10","20160607105431","Shop","AAA05","5","300000","100000","200000","2016-06-07 10:54:31"
"8045","57","20160607085939","Mobile","AAA03","7","119000","21000","98000","2016-06-07 08:59:39"
"8046","25","20160607074253","Shop","AAA05","3","180000","60000","120000","2016-06-07 07:42:53"
"8047","17","20160607123332","PC","AAA05","1","60000","20000","40000","2016-06-07 00:33:32"
"8048","88","20160606090938","Mobile","AAA03","6","102000","18000","84000","2016-06-06 09:09:38"
"8049","54","20160603031723","Mobile","AAA03","2","34000","6000","28000","2016-06-03 15:17:23"
"8050","32","20160603012204","Mobile","AAA05","4","240000","80000","160000","2016-06-03 13:22:04"
"8051","1","20160603115540","Shop","AAA03","8","136000","24000","112000","2016-06-03 11:55:40"
"8052","65","20160603110332","Mobile","AAA02","4","60000","9200","50800","2016-06-03 11:03:32"
"8053","89","20160603103220","Shop","AAA04","13","104000","5200","98800","2016-06-03 10:32:20"
"8054","86","20160603090523","Mobile","AAA05","3","180000","60000","120000","2016-06-03 09:05:23"
"8055","96","20160603075820","PC","AAA01","5","50000","10000","40000","2016-06-03 07:58:20"
"8056","25","20160602093310","Mobile","AAA05","9","540000","180000","360000","2016-06-02 21:33:10"
"8057","55","20160602030229","Mobile","AAA03","6","102000","18000","84000","2016-06-02 15:02:29"
"8058","22","20160602022614","Shop","AAA04","4","32000","1600","30400","2016-06-02 14:26:14"
"8059","49","20160602013616","Mobile","AAA01","10","100000","20000","80000","2016-06-02 13:36:16"
"8060","32","20160602111121","PC","AAA01","7","70000","14000","56000","2016-06-02 11:11:21"
"8061","2","20160602100842","Shop","AAA01","4","40000","8000","32000","2016-06-02 10:08:42"
"8062","42","20160602070923","PC","AAA02","6","90000","13800","76200","2016-06-02 07:09:23"
"8063","95","20160601084027","Mobile","AAA05","3","180000","60000","120000","2016-06-01 08:40:27"
"8064","35","20160601065833","Mobile","AAA03","2","34000","6000","28000","2016-06-01 06:58:33"
"8065","88","20160531020744","Shop","AAA05","1","60000","20000","40000","2016-05-31 14:07:44"
"8066","11","20160531125815","PC","AAA02","2","30000","4600","25400","2016-05-31 12:58:15"
"8067","60","20160531114235","Mobile","AAA03","3","51000","9000","42000","2016-05-31 11:42:35"
"8068","3","20160531100829","PC","AAA04","9","72000","3600","68400","2016-05-31 10:08:29"
"8069","27","20160531085020","PC","AAA04","6","48000","2400","45600","2016-05-31 08:50:20"
"8070","16","20160531081406","Mobile","AAA01","4","40000","8000","32000","2016-05-31 08:14:06"
"8071","20","20160531062616","PC","AAA02","4","60000","9200","50800","2016-05-31 06:26:16"
"8072","12","20160530065718","Shop","AAA05","6","360000","120000","240000","2016-05-30 18:57:18"
"8073","26","20160530031159","PC","AAA04","4","32000","1600","30400","2016-05-30 15:11:59"
"8074","1","20160530013343","Shop","AAA05","2","120000","40000","80000","2016-05-30 13:33:43"
"8075","92","20160530114118","PC","AAA05","6","360000","120000","240000","2016-05-30 11:41:18"
"8076","86","20160530104327","PC","AAA03","1","17000","3000","14000","2016-05-30 10:43:27"
"8077","5","20160530085654","Shop","AAA01","4","40000","8000","32000","2016-05-30 08:56:54"
"8078","85","20160526022050","PC","AAA03","2","34000","6000","28000","2016-05-26 14:20:50"
"8079","3","20160526125916","Shop","AAA02","1","15000","2300","12700","2016-05-26 12:59:16"
"8080","79","20160526111743","Shop","AAA04","2","16000","800","15200","2016-05-26 11:17:43"
"8081","29","20160526081616","PC","AAA02","5","75000","11500","63500","2016-05-26 08:16:16"
"8082","17","20160526065524","PC","AAA03","5","85000","15000","70000","2016-05-26 06:55:24"
"8083","28","20160525073949","Mobile","AAA04","5","40000","2000","38000","2016-05-25 19:39:49"
"8084","49","20160525050324","Mobile","AAA03","7","119000","21000","98000","2016-05-25 17:03:24"
"8085","46","20160525041358","Mobile","AAA02","7","105000","16100","88900","2016-05-25 16:13:58"
"8086","49","20160525030723","PC","AAA03","8","136000","24000","112000","2016-05-25 15:07:23"
"8087","32","20160525013209","Shop","AAA02","3","45000","6900","38100","2016-05-25 13:32:09"
"8088","85","20160525121525","Shop","AAA01","6","60000","12000","48000","2016-05-25 12:15:25"
"8089","96","20160525112004","Shop","AAA04","4","32000","1600","30400","2016-05-25 11:20:04"
"8090","53","20160525092726","Mobile","AAA03","5","85000","15000","70000","2016-05-25 09:27:26"
"8091","36","20160524072435","PC","AAA02","11","165000","25300","139700","2016-05-24 19:24:35"
"8092","49","20160524033727","PC","AAA04","4","32000","1600","30400","2016-05-24 15:37:27"
"8093","97","20160524023325","Mobile","AAA05","4","240000","80000","160000","2016-05-24 14:33:25"
"8094","89","20160524120536","Shop","AAA05","8","480000","160000","320000","2016-05-24 12:05:36"
"8095","60","20160524103232","PC","AAA05","5","300000","100000","200000","2016-05-24 10:32:32"
"8096","63","20160524090819","Shop","AAA02","5","75000","11500","63500","2016-05-24 09:08:19"
"8097","38","20160523063311","Mobile","AAA02","9","135000","20700","114300","2016-05-23 18:33:11"
"8098","76","20160523045705","PC","AAA04","4","32000","1600","30400","2016-05-23 16:57:05"
"8099","62","20160523025400","PC","AAA05","9","540000","180000","360000","2016-05-23 14:54:00"
"8100","41","20160523020826","Shop","AAA01","2","20000","4000","16000","2016-05-23 14:08:26"
"8101","55","20160523010418","Shop","AAA05","12","720000","240000","480000","2016-05-23 13:04:18"
"8102","98","20160523112345","Mobile","AAA01","1","10000","2000","8000","2016-05-23 11:23:45"
"8103","63","20160523095614","Mobile","AAA03","5","85000","15000","70000","2016-05-23 09:56:14"
"8104","97","20160520040157","Shop","AAA05","4","240000","80000","160000","2016-05-20 04:01:57"
"8105","32","20160519071539","Mobile","AAA03","1","17000","3000","14000","2016-05-19 19:15:39"
"8106","79","20160519022910","Shop","AAA02","4","60000","9200","50800","2016-05-19 14:29:10"
"8107","50","20160519014009","Shop","AAA02","10","150000","23000","127000","2016-05-19 13:40:09"
"8108","81","20160519101819","Mobile","AAA04","6","48000","2400","45600","2016-05-19 10:18:19"
"8109","27","20160519091101","PC","AAA05","2","120000","40000","80000","2016-05-19 09:11:01"
"8110","91","20160519080113","Shop","AAA05","3","180000","60000","120000","2016-05-19 08:01:13"
"8111","42","20160519073922","Shop","AAA01","6","60000","12000","48000","2016-05-19 07:39:22"
"8112","51","20160518091812","Mobile","AAA05","5","300000","100000","200000","2016-05-18 21:18:12"
"8113","73","20160518031239","Mobile","AAA02","8","120000","18400","101600","2016-05-18 15:12:39"
"8114","80","20160518011510","PC","AAA05","6","360000","120000","240000","2016-05-18 13:15:10"
"8115","94","20160518111404","PC","AAA01","12","120000","24000","96000","2016-05-18 11:14:04"
"8116","37","20160518091206","PC","AAA05","9","540000","180000","360000","2016-05-18 09:12:06"
"8117","89","20160518072234","PC","AAA02","9","135000","20700","114300","2016-05-18 07:22:34"
"8118","69","20160517092450","PC","AAA03","1","17000","3000","14000","2016-05-17 21:24:50"
"8119","50","20160517063745","PC","AAA01","7","70000","14000","56000","2016-05-17 18:37:45"
"8120","62","20160517025254","PC","AAA01","3","30000","6000","24000","2016-05-17 14:52:54"
"8121","55","20160517013945","Mobile","AAA01","6","60000","12000","48000","2016-05-17 13:39:45"
"8122","33","20160517120723","Mobile","AAA05","1","60000","20000","40000","2016-05-17 12:07:23"
"8123","56","20160517104845","Mobile","AAA02","8","120000","18400","101600","2016-05-17 10:48:45"
"8124","10","20160517091459","PC","AAA04","8","64000","3200","60800","2016-05-17 09:14:59"
"8125","68","20160517082130","PC","AAA02","6","90000","13800","76200","2016-05-17 08:21:30"
"8126","2","20160517065931","Shop","AAA02","2","30000","4600","25400","2016-05-17 06:59:31"
"8127","72","20160516065106","Shop","AAA05","2","120000","40000","80000","2016-05-16 18:51:06"
"8128","25","20160516122509","Mobile","AAA05","3","180000","60000","120000","2016-05-16 12:25:09"
"8129","50","20160516103424","Mobile","AAA05","12","720000","240000","480000","2016-05-16 10:34:24"
"8130","82","20160516092351","Mobile","AAA05","6","360000","120000","240000","2016-05-16 09:23:51"
"8131","18","20160514123011","Mobile","AAA02","5","75000","11500","63500","2016-05-14 00:30:11"
"8132","34","20160513055509","Shop","AAA01","6","60000","12000","48000","2016-05-13 05:55:09"
"8133","24","20160512012302","Shop","AAA02","7","105000","16100","88900","2016-05-12 13:23:02"
"8134","97","20160512121723","Shop","AAA01","6","60000","12000","48000","2016-05-12 12:17:23"
"8135","98","20160512102257","Mobile","AAA05","4","240000","80000","160000","2016-05-12 10:22:57"
"8136","25","20160512082833","Mobile","AAA01","2","20000","4000","16000","2016-05-12 08:28:33"
"8137","63","20160512071426","PC","AAA02","7","105000","16100","88900","2016-05-12 07:14:26"
"8138","42","20160511060707","PC","AAA01","1","10000","2000","8000","2016-05-11 18:07:07"
"8139","87","20160511125714","Shop","AAA05","2","120000","40000","80000","2016-05-11 12:57:14"
"8140","28","20160511120450","Mobile","AAA01","6","60000","12000","48000","2016-05-11 12:04:50"
"8141","90","20160511102243","Mobile","AAA01","3","30000","6000","24000","2016-05-11 10:22:43"
"8142","91","20160511083851","Shop","AAA01","3","30000","6000","24000","2016-05-11 08:38:51"
"8143","68","20160511072633","Shop","AAA03","3","51000","9000","42000","2016-05-11 07:26:33"
"8144","40","20160510054654","Shop","AAA04","1","8000","400","7600","2016-05-10 17:46:54"
"8145","21","20160510033254","PC","AAA01","13","130000","26000","104000","2016-05-10 15:32:54"
"8146","51","20160510014924","Mobile","AAA04","2","16000","800","15200","2016-05-10 13:49:24"
"8147","67","20160510125338","PC","AAA04","6","48000","2400","45600","2016-05-10 12:53:38"
"8148","92","20160510103654","Mobile","AAA03","3","51000","9000","42000","2016-05-10 10:36:54"
"8149","61","20160510090500","Shop","AAA04","5","40000","2000","38000","2016-05-10 09:05:00"
"8150","7","20160510071207","PC","AAA01","1","10000","2000","8000","2016-05-10 07:12:07"
"8151","38","20160509011526","Shop","AAA04","7","56000","2800","53200","2016-05-09 13:15:26"
"8152","39","20160509120934","Mobile","AAA05","5","300000","100000","200000","2016-05-09 12:09:34"
"8153","21","20160509105644","Mobile","AAA01","8","80000","16000","64000","2016-05-09 10:56:44"
"8154","27","20160506062614","PC","AAA05","13","780000","260000","520000","2016-05-06 18:26:14"
"8155","10","20160506013248","PC","AAA04","14","112000","5600","106400","2016-05-06 13:32:48"
"8156","32","20160506123152","PC","AAA01","4","40000","8000","32000","2016-05-06 12:31:52"
"8157","62","20160506113935","Shop","AAA05","1","60000","20000","40000","2016-05-06 11:39:35"
"8158","87","20160506104540","Shop","AAA01","3","30000","6000","24000","2016-05-06 10:45:40"
"8159","95","20160506091721","PC","AAA02","3","45000","6900","38100","2016-05-06 09:17:21"
"8160","79","20160506081905","Shop","AAA05","1","60000","20000","40000","2016-05-06 08:19:05"
"8161","79","20160506072149","Mobile","AAA02","3","45000","6900","38100","2016-05-06 07:21:49"
"8162","87","20160505103138","Mobile","AAA04","2","16000","800","15200","2016-05-05 22:31:38"
"8163","76","20160505093213","PC","AAA05","1","60000","20000","40000","2016-05-05 21:32:13"
"8164","31","20160505044907","Shop","AAA05","7","420000","140000","280000","2016-05-05 16:49:07"
"8165","22","20160505032501","Mobile","AAA01","3","30000","6000","24000","2016-05-05 15:25:01"
"8166","56","20160505010017","PC","AAA04","7","56000","2800","53200","2016-05-05 13:00:17"
"8167","20","20160505121023","Shop","AAA01","3","30000","6000","24000","2016-05-05 12:10:23"
"8168","54","20160505105015","Mobile","AAA01","2","20000","4000","16000","2016-05-05 10:50:15"
"8169","4","20160505082523","Shop","AAA05","5","300000","100000","200000","2016-05-05 08:25:23"
"8170","62","20160505065819","Shop","AAA05","8","480000","160000","320000","2016-05-05 06:58:19"
"8171","78","20160505040313","Shop","AAA03","2","34000","6000","28000","2016-05-05 04:03:13"
"8172","98","20160504123404","Mobile","AAA04","3","24000","1200","22800","2016-05-04 12:34:04"
"8173","21","20160504113210","Shop","AAA02","9","135000","20700","114300","2016-05-04 11:32:10"
"8174","18","20160504102043","Shop","AAA01","1","10000","2000","8000","2016-05-04 10:20:43"
"8175","85","20160504073825","Mobile","AAA03","1","17000","3000","14000","2016-05-04 07:38:25"
"8176","18","20160503115220","PC","AAA03","3","51000","9000","42000","2016-05-03 23:52:20"
"8177","28","20160502035340","Mobile","AAA04","6","48000","2400","45600","2016-05-02 15:53:40"
"8178","37","20160502020951","PC","AAA01","3","30000","6000","24000","2016-05-02 14:09:51"
"8179","38","20160502121741","PC","AAA04","8","64000","3200","60800","2016-05-02 12:17:41"
"8180","86","20160502111139","Mobile","AAA05","1","60000","20000","40000","2016-05-02 11:11:39"
"8181","14","20160502091224","Mobile","AAA05","6","360000","120000","240000","2016-05-02 09:12:24"
"8182","67","20160501022549","Shop","AAA04","3","24000","1200","22800","2016-05-01 14:25:49"
"8183","69","20160429023456","PC","AAA02","2","30000","4600","25400","2016-04-29 02:34:56"
"8184","73","20160428062816","Shop","AAA01","12","120000","24000","96000","2016-04-28 18:28:16"
"8185","83","20160428043015","Mobile","AAA01","5","50000","10000","40000","2016-04-28 16:30:15"
"8186","9","20160428030617","PC","AAA01","2","20000","4000","16000","2016-04-28 15:06:17"
"8187","21","20160428015750","PC","AAA02","7","105000","16100","88900","2016-04-28 13:57:50"
"8188","85","20160428115105","Shop","AAA04","1","8000","400","7600","2016-04-28 11:51:05"
"8189","20","20160428105855","PC","AAA04","1","8000","400","7600","2016-04-28 10:58:55"
"8190","51","20160428092102","Mobile","AAA03","4","68000","12000","56000","2016-04-28 09:21:02"
"8191","47","20160427061756","Mobile","AAA01","3","30000","6000","24000","2016-04-27 18:17:56"
"8192","10","20160427124203","PC","AAA01","8","80000","16000","64000","2016-04-27 12:42:03"
"8193","41","20160427102842","PC","AAA03","1","17000","3000","14000","2016-04-27 10:28:42"
"8194","3","20160427090755","Shop","AAA02","16","240000","36800","203200","2016-04-27 09:07:55"
"8195","3","20160427071659","Mobile","AAA01","2","20000","4000","16000","2016-04-27 07:16:59"
"8196","100","20160426030338","Shop","AAA02","1","15000","2300","12700","2016-04-26 15:03:38"
"8197","93","20160426125736","Shop","AAA02","1","15000","2300","12700","2016-04-26 12:57:36"
"8198","99","20160426112854","Shop","AAA05","3","180000","60000","120000","2016-04-26 11:28:54"
"8199","6","20160426081144","PC","AAA03","1","17000","3000","14000","2016-04-26 08:11:44"
"8200","56","20160425045456","Shop","AAA01","2","20000","4000","16000","2016-04-25 16:54:56"
"8201","17","20160425034747","PC","AAA03","5","85000","15000","70000","2016-04-25 15:47:47"
"8202","37","20160425015427","PC","AAA02","8","120000","18400","101600","2016-04-25 13:54:27"
"8203","42","20160425123144","PC","AAA01","11","110000","22000","88000","2016-04-25 12:31:44"
"8204","63","20160425105648","Shop","AAA04","2","16000","800","15200","2016-04-25 10:56:48"
"8205","42","20160425081346","Shop","AAA03","9","153000","27000","126000","2016-04-25 08:13:46"
"8206","57","20160421035817","Mobile","AAA02","8","120000","18400","101600","2016-04-21 15:58:17"
"8207","57","20160421021432","Shop","AAA02","1","15000","2300","12700","2016-04-21 14:14:32"
"8208","36","20160421123609","Shop","AAA02","1","15000","2300","12700","2016-04-21 12:36:09"
"8209","37","20160421110000","PC","AAA02","6","90000","13800","76200","2016-04-21 11:00:00"
"8210","28","20160421073628","PC","AAA04","6","48000","2400","45600","2016-04-21 07:36:28"
"8211","80","20160420092001","PC","AAA02","6","90000","13800","76200","2016-04-20 21:20:01"
"8212","1","20160420051242","Mobile","AAA05","12","720000","240000","480000","2016-04-20 17:12:42"
"8213","42","20160420035836","Mobile","AAA01","4","40000","8000","32000","2016-04-20 15:58:36"
"8214","49","20160420024407","PC","AAA04","9","72000","3600","68400","2016-04-20 14:44:07"
"8215","64","20160420013507","Shop","AAA04","2","16000","800","15200","2016-04-20 13:35:07"
"8216","83","20160420113852","PC","AAA03","14","238000","42000","196000","2016-04-20 11:38:52"
"8217","55","20160420111127","Mobile","AAA01","3","30000","6000","24000","2016-04-20 11:11:27"
"8218","10","20160420102631","Mobile","AAA05","8","480000","160000","320000","2016-04-20 10:26:31"
"8219","12","20160420080003","Shop","AAA04","2","16000","800","15200","2016-04-20 08:00:03"
"8220","31","20160420072410","PC","AAA02","3","45000","6900","38100","2016-04-20 07:24:10"
"8221","11","20160419065033","PC","AAA03","6","102000","18000","84000","2016-04-19 18:50:33"
"8222","88","20160419023543","Shop","AAA04","1","8000","400","7600","2016-04-19 14:35:43"
"8223","95","20160419012017","PC","AAA04","5","40000","2000","38000","2016-04-19 13:20:17"
"8224","52","20160419115015","PC","AAA01","8","80000","16000","64000","2016-04-19 11:50:15"
"8225","16","20160419091046","Mobile","AAA04","10","80000","4000","76000","2016-04-19 09:10:46"
"8226","18","20160419080850","PC","AAA05","5","300000","100000","200000","2016-04-19 08:08:50"
"8227","12","20160418073725","Mobile","AAA01","5","50000","10000","40000","2016-04-18 19:37:25"
"8228","24","20160418032342","Shop","AAA01","3","30000","6000","24000","2016-04-18 15:23:42"
"8229","7","20160418122941","PC","AAA02","6","90000","13800","76200","2016-04-18 12:29:41"
"8230","36","20160418101639","Shop","AAA03","9","153000","27000","126000","2016-04-18 10:16:39"
"8231","65","20160418090612","Mobile","AAA05","6","360000","120000","240000","2016-04-18 09:06:12"
"8232","21","20160415030539","Shop","AAA03","9","153000","27000","126000","2016-04-15 15:05:39"
"8233","92","20160415124053","PC","AAA02","10","150000","23000","127000","2016-04-15 12:40:53"
"8234","54","20160415083635","PC","AAA02","3","45000","6900","38100","2016-04-15 08:36:35"
"8235","43","20160414092622","Shop","AAA01","7","70000","14000","56000","2016-04-14 21:26:22"
"8236","10","20160414023333","Shop","AAA03","8","136000","24000","112000","2016-04-14 14:33:33"
"8237","49","20160414124655","Mobile","AAA02","7","105000","16100","88900","2016-04-14 12:46:55"
"8238","33","20160414111519","Mobile","AAA01","2","20000","4000","16000","2016-04-14 11:15:19"
"8239","40","20160414093504","Mobile","AAA01","2","20000","4000","16000","2016-04-14 09:35:04"
"8240","90","20160414084338","Shop","AAA04","1","8000","400","7600","2016-04-14 08:43:38"
"8241","17","20160413035155","Shop","AAA05","3","180000","60000","120000","2016-04-13 15:51:55"
"8242","68","20160413023758","Mobile","AAA01","3","30000","6000","24000","2016-04-13 14:37:58"
"8243","75","20160413011714","Mobile","AAA04","1","8000","400","7600","2016-04-13 13:17:14"
"8244","36","20160413121547","PC","AAA01","11","110000","22000","88000","2016-04-13 12:15:47"
"8245","94","20160413110529","Shop","AAA01","12","120000","24000","96000","2016-04-13 11:05:29"
"8246","21","20160413090159","PC","AAA05","2","120000","40000","80000","2016-04-13 09:01:59"
"8247","18","20160413081543","PC","AAA03","2","34000","6000","28000","2016-04-13 08:15:43"
"8248","45","20160413065016","Mobile","AAA03","4","68000","12000","56000","2016-04-13 06:50:16"
"8249","85","20160412090238","PC","AAA04","10","80000","4000","76000","2016-04-12 21:02:38"
"8250","62","20160412015611","PC","AAA01","8","80000","16000","64000","2016-04-12 13:56:11"
"8251","54","20160412114216","Shop","AAA03","6","102000","18000","84000","2016-04-12 11:42:16"
"8252","43","20160412095526","PC","AAA02","4","60000","9200","50800","2016-04-12 09:55:26"
"8253","33","20160412084136","PC","AAA03","2","34000","6000","28000","2016-04-12 08:41:36"
"8254","66","20160412073956","PC","AAA01","12","120000","24000","96000","2016-04-12 07:39:56"
"8255","87","20160412052136","Mobile","AAA02","5","75000","11500","63500","2016-04-12 05:21:36"
"8256","61","20160411095713","PC","AAA02","2","30000","4600","25400","2016-04-11 21:57:13"
"8257","38","20160411051651","PC","AAA02","1","15000","2300","12700","2016-04-11 17:16:51"
"8258","41","20160411034318","Mobile","AAA03","11","187000","33000","154000","2016-04-11 15:43:18"
"8259","100","20160411010707","PC","AAA01","4","40000","8000","32000","2016-04-11 13:07:07"
"8260","69","20160411121058","PC","AAA01","1","10000","2000","8000","2016-04-11 12:10:58"
"8261","8","20160411104435","Mobile","AAA03","3","51000","9000","42000","2016-04-11 10:44:35"
"8262","51","20160411090538","PC","AAA04","4","32000","1600","30400","2016-04-11 09:05:38"
"8263","12","20160407123634","Mobile","AAA02","3","45000","6900","38100","2016-04-07 12:36:34"
"8264","71","20160407075353","Mobile","AAA01","7","70000","14000","56000","2016-04-07 07:53:53"
"8265","9","20160406124200","Shop","AAA04","4","32000","1600","30400","2016-04-06 12:42:00"
"8266","11","20160406112359","Mobile","AAA01","3","30000","6000","24000","2016-04-06 11:23:59"
"8267","30","20160406094844","PC","AAA05","3","180000","60000","120000","2016-04-06 09:48:44"
"8268","44","20160406083238","Mobile","AAA01","1","10000","2000","8000","2016-04-06 08:32:38"
"8269","89","20160406072858","Mobile","AAA02","3","45000","6900","38100","2016-04-06 07:28:58"
"8270","36","20160405084030","PC","AAA02","7","105000","16100","88900","2016-04-05 20:40:30"
"8271","66","20160405061059","PC","AAA04","5","40000","2000","38000","2016-04-05 18:10:59"
"8272","60","20160405013738","Shop","AAA03","4","68000","12000","56000","2016-04-05 13:37:38"
"8273","44","20160405114858","Shop","AAA04","5","40000","2000","38000","2016-04-05 11:48:58"
"8274","23","20160405105840","Shop","AAA03","4","68000","12000","56000","2016-04-05 10:58:40"
"8275","6","20160405092200","PC","AAA02","3","45000","6900","38100","2016-04-05 09:22:00"
"8276","76","20160405083932","Shop","AAA03","3","51000","9000","42000","2016-04-05 08:39:32"
"8277","3","20160405070705","Mobile","AAA02","11","165000","25300","139700","2016-04-05 07:07:05"
"8278","82","20160404042147","Shop","AAA02","7","105000","16100","88900","2016-04-04 16:21:47"
"8279","19","20160404030630","Mobile","AAA02","2","30000","4600","25400","2016-04-04 15:06:30"
"8280","41","20160404010513","Mobile","AAA03","2","34000","6000","28000","2016-04-04 13:05:13"
"8281","78","20160404115127","Shop","AAA03","5","85000","15000","70000","2016-04-04 11:51:27"
"8282","73","20160404104726","Mobile","AAA05","14","840000","280000","560000","2016-04-04 10:47:26"
"8283","89","20160404094733","Mobile","AAA04","10","80000","4000","76000","2016-04-04 09:47:33"
"8284","56","20160331065911","Mobile","AAA05","13","780000","260000","520000","2016-03-31 18:59:11"
"8285","19","20160331032803","Shop","AAA02","2","30000","4600","25400","2016-03-31 15:28:03"
"8286","94","20160331022937","Mobile","AAA04","9","72000","3600","68400","2016-03-31 14:29:37"
"8287","45","20160331113642","Shop","AAA01","5","50000","10000","40000","2016-03-31 11:36:42"
"8288","7","20160331100446","Mobile","AAA01","5","50000","10000","40000","2016-03-31 10:04:46"
"8289","11","20160331090540","PC","AAA03","7","119000","21000","98000","2016-03-31 09:05:40"
"8290","41","20160330063819","Mobile","AAA01","9","90000","18000","72000","2016-03-30 18:38:19"
"8291","56","20160330032420","PC","AAA05","6","360000","120000","240000","2016-03-30 15:24:20"
"8292","7","20160330014729","Mobile","AAA02","9","135000","20700","114300","2016-03-30 13:47:29"
"8293","44","20160330114447","Shop","AAA05","4","240000","80000","160000","2016-03-30 11:44:47"
"8294","24","20160330103855","Mobile","AAA02","6","90000","13800","76200","2016-03-30 10:38:55"
"8295","58","20160330094405","Mobile","AAA04","1","8000","400","7600","2016-03-30 09:44:05"
"8296","31","20160330081231","PC","AAA02","3","45000","6900","38100","2016-03-30 08:12:31"
"8297","91","20160330064238","Mobile","AAA04","1","8000","400","7600","2016-03-30 06:42:38"
"8298","17","20160329034239","Mobile","AAA05","2","120000","40000","80000","2016-03-29 15:42:39"
"8299","70","20160329010815","Mobile","AAA03","12","204000","36000","168000","2016-03-29 13:08:15"
"8300","50","20160329114732","Shop","AAA05","2","120000","40000","80000","2016-03-29 11:47:32"
"8301","79","20160329102826","Shop","AAA02","5","75000","11500","63500","2016-03-29 10:28:26"
"8302","6","20160329093501","Shop","AAA02","3","45000","6900","38100","2016-03-29 09:35:01"
"8303","33","20160329074656","Shop","AAA03","1","17000","3000","14000","2016-03-29 07:46:56"
"8304","53","20160328080344","PC","AAA05","6","360000","120000","240000","2016-03-28 20:03:44"
"8305","19","20160328053400","PC","AAA02","4","60000","9200","50800","2016-03-28 17:34:00"
"8306","100","20160328042611","Shop","AAA02","5","75000","11500","63500","2016-03-28 16:26:11"
"8307","87","20160328012912","PC","AAA03","6","102000","18000","84000","2016-03-28 13:29:12"
"8308","51","20160328121741","PC","AAA02","1","15000","2300","12700","2016-03-28 12:17:41"
"8309","13","20160328121343","PC","AAA02","4","60000","9200","50800","2016-03-28 12:13:43"
"8310","3","20160328101905","PC","AAA03","7","119000","21000","98000","2016-03-28 10:19:05"
"8311","36","20160328095216","PC","AAA02","5","75000","11500","63500","2016-03-28 09:52:16"
"8312","70","20160324035439","PC","AAA04","14","112000","5600","106400","2016-03-24 15:54:39"
"8313","42","20160324125810","PC","AAA02","5","75000","11500","63500","2016-03-24 12:58:10"
"8314","99","20160324112517","Shop","AAA03","7","119000","21000","98000","2016-03-24 11:25:17"
"8315","32","20160324063058","Mobile","AAA03","4","68000","12000","56000","2016-03-24 06:30:58"
"8316","57","20160323052914","PC","AAA04","6","48000","2400","45600","2016-03-23 17:29:14"
"8317","37","20160323034731","Mobile","AAA05","7","420000","140000","280000","2016-03-23 15:47:31"
"8318","50","20160323025541","Shop","AAA04","7","56000","2800","53200","2016-03-23 14:55:41"
"8319","86","20160323024120","Mobile","AAA02","3","45000","6900","38100","2016-03-23 14:41:20"
"8320","28","20160323015419","PC","AAA03","7","119000","21000","98000","2016-03-23 13:54:19"
"8321","12","20160323011749","PC","AAA03","1","17000","3000","14000","2016-03-23 13:17:49"
"8322","50","20160323114037","Mobile","AAA04","7","56000","2800","53200","2016-03-23 11:40:37"
"8323","49","20160323105101","Shop","AAA01","10","100000","20000","80000","2016-03-23 10:51:01"
"8324","14","20160323074212","PC","AAA04","3","24000","1200","22800","2016-03-23 07:42:12"
"8325","4","20160322114407","PC","AAA05","4","240000","80000","160000","2016-03-22 23:44:07"
"8326","98","20160322082726","PC","AAA02","5","75000","11500","63500","2016-03-22 08:27:26"
"8327","29","20160322071123","PC","AAA04","4","32000","1600","30400","2016-03-22 07:11:23"
"8328","63","20160321064745","PC","AAA02","7","105000","16100","88900","2016-03-21 18:47:45"
"8329","52","20160321042945","Mobile","AAA01","5","50000","10000","40000","2016-03-21 16:29:45"
"8330","34","20160321024502","Mobile","AAA01","6","60000","12000","48000","2016-03-21 14:45:02"
"8331","97","20160321120538","PC","AAA05","1","60000","20000","40000","2016-03-21 12:05:38"
"8332","98","20160321103414","Mobile","AAA04","2","16000","800","15200","2016-03-21 10:34:14"
"8333","79","20160321090407","PC","AAA01","5","50000","10000","40000","2016-03-21 09:04:07"
"8334","67","20160318030552","Mobile","AAA02","7","105000","16100","88900","2016-03-18 03:05:52"
"8335","41","20160317033329","PC","AAA02","2","30000","4600","25400","2016-03-17 15:33:29"
"8336","45","20160317024246","Shop","AAA05","3","180000","60000","120000","2016-03-17 14:42:46"
"8337","8","20160317012020","Mobile","AAA01","4","40000","8000","32000","2016-03-17 13:20:20"
"8338","6","20160317122323","PC","AAA02","5","75000","11500","63500","2016-03-17 12:23:23"
"8339","68","20160317110351","PC","AAA03","2","34000","6000","28000","2016-03-17 11:03:51"
"8340","42","20160317093330","Shop","AAA02","14","210000","32200","177800","2016-03-17 09:33:30"
"8341","79","20160317083047","Shop","AAA04","3","24000","1200","22800","2016-03-17 08:30:47"
"8342","80","20160317074250","Shop","AAA04","6","48000","2400","45600","2016-03-17 07:42:50"
"8343","76","20160316061458","Shop","AAA01","6","60000","12000","48000","2016-03-16 18:14:58"
"8344","37","20160316125121","PC","AAA01","16","160000","32000","128000","2016-03-16 12:51:21"
"8345","76","20160316102912","Mobile","AAA02","5","75000","11500","63500","2016-03-16 10:29:12"
"8346","77","20160316091858","Mobile","AAA02","4","60000","9200","50800","2016-03-16 09:18:58"
"8347","74","20160316081340","Mobile","AAA01","6","60000","12000","48000","2016-03-16 08:13:40"
"8348","100","20160316075628","Shop","AAA05","4","240000","80000","160000","2016-03-16 07:56:28"
"8349","44","20160315052427","Shop","AAA03","3","51000","9000","42000","2016-03-15 17:24:27"
"8350","81","20160315035023","Mobile","AAA01","6","60000","12000","48000","2016-03-15 15:50:23"
"8351","3","20160315012203","Shop","AAA02","6","90000","13800","76200","2016-03-15 13:22:03"
"8352","95","20160315113346","Mobile","AAA04","5","40000","2000","38000","2016-03-15 11:33:46"
"8353","22","20160315102850","Mobile","AAA05","5","300000","100000","200000","2016-03-15 10:28:50"
"8354","56","20160315091520","PC","AAA04","5","40000","2000","38000","2016-03-15 09:15:20"
"8355","13","20160315081830","Mobile","AAA04","5","40000","2000","38000","2016-03-15 08:18:30"
"8356","99","20160315062503","Shop","AAA05","3","180000","60000","120000","2016-03-15 06:25:03"
"8357","62","20160314021954","PC","AAA05","4","240000","80000","160000","2016-03-14 14:19:54"
"8358","12","20160314010612","Mobile","AAA02","3","45000","6900","38100","2016-03-14 13:06:12"
"8359","81","20160314115052","Mobile","AAA01","1","10000","2000","8000","2016-03-14 11:50:52"
"8360","23","20160314102651","Mobile","AAA04","5","40000","2000","38000","2016-03-14 10:26:51"
"8361","47","20160314090444","Shop","AAA02","15","225000","34500","190500","2016-03-14 09:04:44"
"8362","28","20160309053951","PC","AAA02","1","15000","2300","12700","2016-03-09 05:39:51"
"8363","43","20160308043018","Shop","AAA03","9","153000","27000","126000","2016-03-08 16:30:18"
"8364","93","20160308033943","Mobile","AAA05","2","120000","40000","80000","2016-03-08 15:39:43"
"8365","74","20160308013620","PC","AAA02","3","45000","6900","38100","2016-03-08 13:36:20"
"8366","58","20160308121837","Mobile","AAA02","1","15000","2300","12700","2016-03-08 12:18:37"
"8367","35","20160308082353","Shop","AAA03","3","51000","9000","42000","2016-03-08 08:23:53"
"8368","25","20160308065216","PC","AAA01","8","80000","16000","64000","2016-03-08 06:52:16"
"8369","14","20160307061538","PC","AAA01","5","50000","10000","40000","2016-03-07 18:15:38"
"8370","93","20160307010254","Mobile","AAA01","7","70000","14000","56000","2016-03-07 13:02:54"
"8371","25","20160307114912","Mobile","AAA05","4","240000","80000","160000","2016-03-07 11:49:12"
"8372","1","20160301113130","Mobile","AAA01","7","70000","14000","56000","2016-03-01 23:31:30"
"8373","85","20160301052219","PC","AAA01","13","130000","26000","104000","2016-03-01 17:22:19"
"8374","85","20160301022901","Mobile","AAA04","6","48000","2400","45600","2016-03-01 14:29:01"
"8375","69","20160301010707","PC","AAA04","1","8000","400","7600","2016-03-01 13:07:07"
"8376","86","20160301114841","Shop","AAA03","6","102000","18000","84000","2016-03-01 11:48:41"
"8377","16","20160301102556","Mobile","AAA02","3","45000","6900","38100","2016-03-01 10:25:56"
"8378","92","20160301085238","PC","AAA05","8","480000","160000","320000","2016-03-01 08:52:38"
"8379","66","20160301072138","Shop","AAA05","1","60000","20000","40000","2016-03-01 07:21:38"
"8380","92","20160229082714","Mobile","AAA03","6","102000","18000","84000","2016-02-29 20:27:14"
"8381","75","20160229050600","Mobile","AAA05","3","180000","60000","120000","2016-02-29 17:06:00"
"8382","88","20160229025630","Shop","AAA03","4","68000","12000","56000","2016-02-29 14:56:30"
"8383","11","20160229022424","Mobile","AAA05","5","300000","100000","200000","2016-02-29 14:24:24"
"8384","28","20160229093628","PC","AAA04","11","88000","4400","83600","2016-02-29 09:36:28"
"8385","64","20160224023457","Shop","AAA04","2","16000","800","15200","2016-02-24 14:34:57"
"8386","49","20160224125929","PC","AAA01","3","30000","6000","24000","2016-02-24 12:59:29"
"8387","55","20160224121031","Mobile","AAA03","11","187000","33000","154000","2016-02-24 12:10:31"
"8388","88","20160224105700","Shop","AAA05","6","360000","120000","240000","2016-02-24 10:57:00"
"8389","69","20160224101420","Shop","AAA01","4","40000","8000","32000","2016-02-24 10:14:20"
"8390","86","20160224085403","PC","AAA05","3","180000","60000","120000","2016-02-24 08:54:03"
"8391","28","20160224033535","Mobile","AAA02","6","90000","13800","76200","2016-02-24 03:35:35"
"8392","73","20160223013630","Shop","AAA04","2","16000","800","15200","2016-02-23 13:36:30"
"8393","66","20160223120120","Shop","AAA04","4","32000","1600","30400","2016-02-23 12:01:20"
"8394","70","20160223101801","PC","AAA03","1","17000","3000","14000","2016-02-23 10:18:01"
"8395","26","20160223082513","Shop","AAA05","1","60000","20000","40000","2016-02-23 08:25:13"
"8396","90","20160223074409","Shop","AAA01","3","30000","6000","24000","2016-02-23 07:44:09"
"8397","20","20160222022648","Mobile","AAA01","5","50000","10000","40000","2016-02-22 14:26:48"
"8398","52","20160222010835","PC","AAA01","2","20000","4000","16000","2016-02-22 13:08:35"
"8399","82","20160222091038","Mobile","AAA05","7","420000","140000","280000","2016-02-22 09:10:38"
"8400","97","20160218090811","PC","AAA02","3","45000","6900","38100","2016-02-18 21:08:11"
"8401","2","20160218035804","PC","AAA01","2","20000","4000","16000","2016-02-18 15:58:04"
"8402","79","20160218024822","Mobile","AAA02","6","90000","13800","76200","2016-02-18 14:48:22"
"8403","9","20160218123531","Mobile","AAA02","1","15000","2300","12700","2016-02-18 12:35:31"
"8404","53","20160218113602","Shop","AAA01","1","10000","2000","8000","2016-02-18 11:36:02"
"8405","24","20160218104307","Mobile","AAA04","6","48000","2400","45600","2016-02-18 10:43:07"
"8406","41","20160218092332","PC","AAA04","1","8000","400","7600","2016-02-18 09:23:32"
"8407","28","20160218072945","PC","AAA01","5","50000","10000","40000","2016-02-18 07:29:45"
"8408","10","20160217023540","PC","AAA04","12","96000","4800","91200","2016-02-17 14:35:40"
"8409","25","20160217011129","PC","AAA02","3","45000","6900","38100","2016-02-17 13:11:29"
"8410","50","20160217121210","Mobile","AAA05","6","360000","120000","240000","2016-02-17 12:12:10"
"8411","76","20160217075538","PC","AAA01","1","10000","2000","8000","2016-02-17 07:55:38"
"8412","62","20160216063620","Mobile","AAA03","5","85000","15000","70000","2016-02-16 18:36:20"
"8413","74","20160216035048","PC","AAA03","3","51000","9000","42000","2016-02-16 15:50:48"
"8414","81","20160216023907","Mobile","AAA03","6","102000","18000","84000","2016-02-16 14:39:07"
"8415","6","20160216125557","Mobile","AAA01","1","10000","2000","8000","2016-02-16 12:55:57"
"8416","99","20160216114439","PC","AAA02","4","60000","9200","50800","2016-02-16 11:44:39"
"8417","71","20160216101825","Shop","AAA01","4","40000","8000","32000","2016-02-16 10:18:25"
"8418","66","20160216083245","PC","AAA03","1","17000","3000","14000","2016-02-16 08:32:45"
"8419","79","20160216073427","Shop","AAA02","6","90000","13800","76200","2016-02-16 07:34:27"
"8420","16","20160215094815","Mobile","AAA02","12","180000","27600","152400","2016-02-15 21:48:15"
"8421","63","20160215063802","Mobile","AAA04","2","16000","800","15200","2016-02-15 18:38:02"
"8422","94","20160215024552","Mobile","AAA05","1","60000","20000","40000","2016-02-15 14:45:52"
"8423","44","20160215124829","Shop","AAA01","4","40000","8000","32000","2016-02-15 12:48:29"
"8424","1","20160215114725","Shop","AAA03","1","17000","3000","14000","2016-02-15 11:47:25"
"8425","59","20160215101844","Mobile","AAA04","3","24000","1200","22800","2016-02-15 10:18:44"
"8426","62","20160215081721","PC","AAA04","9","72000","3600","68400","2016-02-15 08:17:21"
"8427","68","20160210123612","Shop","AAA04","2","16000","800","15200","2016-02-10 12:36:12"
"8428","19","20160210111121","PC","AAA03","4","68000","12000","56000","2016-02-10 11:11:21"
"8429","19","20160210090702","Shop","AAA03","1","17000","3000","14000","2016-02-10 09:07:02"
"8430","6","20160210065809","PC","AAA03","2","34000","6000","28000","2016-02-10 06:58:09"
"8431","38","20160209035544","PC","AAA02","2","30000","4600","25400","2016-02-09 15:55:44"
"8432","56","20160209022728","Shop","AAA03","1","17000","3000","14000","2016-02-09 14:27:28"
"8433","17","20160209010402","Shop","AAA01","1","10000","2000","8000","2016-02-09 13:04:02"
"8434","15","20160209113508","Shop","AAA01","17","170000","34000","136000","2016-02-09 11:35:08"
"8435","5","20160209104505","Mobile","AAA04","1","8000","400","7600","2016-02-09 10:45:05"
"8436","80","20160209102208","Shop","AAA03","5","85000","15000","70000","2016-02-09 10:22:08"
"8437","95","20160209083104","PC","AAA05","6","360000","120000","240000","2016-02-09 08:31:04"
"8438","13","20160209075907","Shop","AAA05","4","240000","80000","160000","2016-02-09 07:59:07"
"8439","9","20160208071027","PC","AAA01","4","40000","8000","32000","2016-02-08 19:10:27"
"8440","15","20160208024430","Mobile","AAA01","13","130000","26000","104000","2016-02-08 14:44:30"
"8441","37","20160208114635","Mobile","AAA05","5","300000","100000","200000","2016-02-08 11:46:35"
"8442","32","20160208110908","Mobile","AAA02","6","90000","13800","76200","2016-02-08 11:09:08"
"8443","30","20160208103530","PC","AAA03","8","136000","24000","112000","2016-02-08 10:35:30"
"8444","22","20160208092117","PC","AAA02","3","45000","6900","38100","2016-02-08 09:21:17"
"8445","91","20160205111405","Mobile","AAA04","3","24000","1200","22800","2016-02-05 11:14:05"
"8446","43","20160205095858","Mobile","AAA05","5","300000","100000","200000","2016-02-05 09:58:58"
"8447","97","20160205084619","Mobile","AAA04","6","48000","2400","45600","2016-02-05 08:46:19"
"8448","2","20160205071256","Mobile","AAA04","5","40000","2000","38000","2016-02-05 07:12:56"
"8449","16","20160204093847","Shop","AAA04","5","40000","2000","38000","2016-02-04 21:38:47"
"8450","14","20160204040602","Mobile","AAA05","1","60000","20000","40000","2016-02-04 16:06:02"
"8451","55","20160204025032","Mobile","AAA04","5","40000","2000","38000","2016-02-04 14:50:32"
"8452","9","20160204012721","Shop","AAA02","1","15000","2300","12700","2016-02-04 13:27:21"
"8453","39","20160204101135","Shop","AAA03","6","102000","18000","84000","2016-02-04 10:11:35"
"8454","54","20160204091033","Mobile","AAA05","7","420000","140000","280000","2016-02-04 09:10:33"
"8455","14","20160203010042","PC","AAA04","7","56000","2800","53200","2016-02-03 13:00:42"
"8456","21","20160203101828","Shop","AAA05","5","300000","100000","200000","2016-02-03 10:18:28"
"8457","94","20160203090343","PC","AAA02","12","180000","27600","152400","2016-02-03 09:03:43"
"8458","11","20160203074342","Mobile","AAA03","7","119000","21000","98000","2016-02-03 07:43:42"
"8459","94","20160203010410","Mobile","AAA01","2","20000","4000","16000","2016-02-03 01:04:10"
"8460","36","20160202123108","Mobile","AAA01","16","160000","32000","128000","2016-02-02 12:31:08"
"8461","26","20160202110509","Mobile","AAA03","1","17000","3000","14000","2016-02-02 11:05:09"
"8462","28","20160202102133","PC","AAA05","2","120000","40000","80000","2016-02-02 10:21:33"
"8463","47","20160202083023","Mobile","AAA01","2","20000","4000","16000","2016-02-02 08:30:23"
"8464","32","20160202075542","PC","AAA05","14","840000","280000","560000","2016-02-02 07:55:42"
"8465","96","20160201082914","Shop","AAA04","5","40000","2000","38000","2016-02-01 20:29:14"
"8466","66","20160201024346","Mobile","AAA01","2","20000","4000","16000","2016-02-01 14:43:46"
"8467","51","20160201125307","Mobile","AAA05","4","240000","80000","160000","2016-02-01 12:53:07"
"8468","93","20160201120826","PC","AAA04","5","40000","2000","38000","2016-02-01 12:08:26"
"8469","88","20160201094255","Shop","AAA03","4","68000","12000","56000","2016-02-01 09:42:55"
"8470","50","20160128102915","Shop","AAA03","1","17000","3000","14000","2016-01-28 22:29:15"
"8471","94","20160128070557","Shop","AAA01","15","150000","30000","120000","2016-01-28 19:05:57"
"8472","80","20160128025740","Mobile","AAA01","5","50000","10000","40000","2016-01-28 14:57:40"
"8473","63","20160128012033","PC","AAA03","3","51000","9000","42000","2016-01-28 13:20:33"
"8474","55","20160128112545","Mobile","AAA03","4","68000","12000","56000","2016-01-28 11:25:45"
"8475","56","20160128093324","PC","AAA04","5","40000","2000","38000","2016-01-28 09:33:24"
"8476","41","20160128072136","Shop","AAA04","1","8000","400","7600","2016-01-28 07:21:36"
"8477","1","20160127093126","PC","AAA02","3","45000","6900","38100","2016-01-27 09:31:26"
"8478","43","20160127072538","Shop","AAA05","5","300000","100000","200000","2016-01-27 07:25:38"
"8479","4","20160126104027","Shop","AAA05","5","300000","100000","200000","2016-01-26 10:40:27"
"8480","90","20160126090210","PC","AAA03","5","85000","15000","70000","2016-01-26 09:02:10"
"8481","31","20160126080416","Mobile","AAA01","5","50000","10000","40000","2016-01-26 08:04:16"
"8482","32","20160126062351","Shop","AAA05","8","480000","160000","320000","2016-01-26 06:23:51"
"8483","34","20160125050806","PC","AAA04","2","16000","800","15200","2016-01-25 17:08:06"
"8484","15","20160125023534","Mobile","AAA04","5","40000","2000","38000","2016-01-25 14:35:34"
"8485","7","20160125013944","PC","AAA02","2","30000","4600","25400","2016-01-25 13:39:44"
"8486","76","20160125115624","Mobile","AAA02","2","30000","4600","25400","2016-01-25 11:56:24"
"8487","21","20160125104500","Mobile","AAA04","9","72000","3600","68400","2016-01-25 10:45:00"
"8488","3","20160121043605","PC","AAA02","8","120000","18400","101600","2016-01-21 04:36:05"
"8489","96","20160120013227","Shop","AAA03","1","17000","3000","14000","2016-01-20 13:32:27"
"8490","60","20160120120039","Shop","AAA04","5","40000","2000","38000","2016-01-20 12:00:39"
"8491","79","20160120094408","Shop","AAA04","4","32000","1600","30400","2016-01-20 09:44:08"
"8492","30","20160120082006","Shop","AAA01","3","30000","6000","24000","2016-01-20 08:20:06"
"8493","16","20160120071445","PC","AAA04","2","16000","800","15200","2016-01-20 07:14:45"
"8494","90","20160120011645","Shop","AAA01","1","10000","2000","8000","2016-01-20 01:16:45"
"8495","81","20160119081130","Mobile","AAA01","8","80000","16000","64000","2016-01-19 08:11:30"
"8496","74","20160118113454","Mobile","AAA03","2","34000","6000","28000","2016-01-18 23:34:54"
"8497","62","20160118085648","Shop","AAA01","10","100000","20000","80000","2016-01-18 08:56:48"
"8498","18","20160114063140","Mobile","AAA02","5","75000","11500","63500","2016-01-14 18:31:40"
"8499","19","20160114113840","Shop","AAA04","2","16000","800","15200","2016-01-14 11:38:40"
"8500","45","20160114100101","Shop","AAA04","2","16000","800","15200","2016-01-14 10:01:01"
"8501","71","20160114073808","PC","AAA04","3","24000","1200","22800","2016-01-14 07:38:08"
"8502","95","20160113124025","Shop","AAA01","3","30000","6000","24000","2016-01-13 12:40:25"
"8503","61","20160113112409","Mobile","AAA01","5","50000","10000","40000","2016-01-13 11:24:09"
"8504","27","20160113104116","Mobile","AAA01","13","130000","26000","104000","2016-01-13 10:41:16"
"8505","82","20160113090247","PC","AAA01","2","20000","4000","16000","2016-01-13 09:02:47"
"8506","53","20160112080225","Mobile","AAA05","2","120000","40000","80000","2016-01-12 20:02:25"
"8507","86","20160112023915","PC","AAA05","3","180000","60000","120000","2016-01-12 14:39:15"
"8508","31","20160112012040","PC","AAA01","4","40000","8000","32000","2016-01-12 13:20:40"
"8509","28","20160112105035","Mobile","AAA05","8","480000","160000","320000","2016-01-12 10:50:35"
"8510","9","20160112091433","PC","AAA01","2","20000","4000","16000","2016-01-12 09:14:33"
"8511","74","20160112075900","PC","AAA05","5","300000","100000","200000","2016-01-12 07:59:00"
"8512","49","20160111083732","PC","AAA03","2","34000","6000","28000","2016-01-11 20:37:32"
"8513","69","20160111052733","PC","AAA02","4","60000","9200","50800","2016-01-11 17:27:33"
"8514","40","20160111042131","Shop","AAA04","4","32000","1600","30400","2016-01-11 16:21:31"
"8515","26","20160111025143","Mobile","AAA03","1","17000","3000","14000","2016-01-11 14:51:43"
"8516","73","20160111013609","Mobile","AAA04","5","40000","2000","38000","2016-01-11 13:36:09"
"8517","98","20160111121729","Shop","AAA02","1","15000","2300","12700","2016-01-11 12:17:29"
"8518","31","20160111104916","Shop","AAA01","3","30000","6000","24000","2016-01-11 10:49:16"
"8519","93","20160111102011","Shop","AAA04","5","40000","2000","38000","2016-01-11 10:20:11"
"8520","17","20160111085309","Shop","AAA01","5","50000","10000","40000","2016-01-11 08:53:09"
"8521","76","20160107081349","Mobile","AAA01","9","90000","18000","72000","2016-01-07 08:13:49"
"8522","11","20160107070803","Mobile","AAA04","4","32000","1600","30400","2016-01-07 07:08:03"
"8523","58","20160106112241","PC","AAA01","2","20000","4000","16000","2016-01-06 11:22:41"
"8524","74","20160106093900","Shop","AAA04","7","56000","2800","53200","2016-01-06 09:39:00"
"8525","72","20160106075931","PC","AAA03","1","17000","3000","14000","2016-01-06 07:59:31"
"8526","46","20160105033429","Mobile","AAA03","11","187000","33000","154000","2016-01-05 15:34:29"
"8527","69","20160105015551","PC","AAA01","5","50000","10000","40000","2016-01-05 13:55:51"
"8528","11","20160105084625","Shop","AAA01","8","80000","16000","64000","2016-01-05 08:46:25"
"8529","40","20160105072104","Mobile","AAA01","4","40000","8000","32000","2016-01-05 07:21:04"
"8530","43","20160104114236","PC","AAA02","3","45000","6900","38100","2016-01-04 23:42:36"
"8531","64","20160104012800","Mobile","AAA01","7","70000","14000","56000","2016-01-04 01:28:00"
"8532","34","20151231044513","Mobile","AAA04","1","8000","400","7600","2015-12-31 16:45:13"
"8533","59","20151231034943","PC","AAA04","1","8000","400","7600","2015-12-31 15:49:43"
"8534","55","20151231021608","Shop","AAA01","6","60000","12000","48000","2015-12-31 14:16:08"
"8535","47","20151231010613","Shop","AAA02","8","120000","18400","101600","2015-12-31 13:06:13"
"8536","79","20151231110406","Shop","AAA03","4","68000","12000","56000","2015-12-31 11:04:06"
"8537","39","20151231085013","Mobile","AAA03","7","119000","21000","98000","2015-12-31 08:50:13"
"8538","92","20151231065249","Mobile","AAA03","6","102000","18000","84000","2015-12-31 06:52:49"
"8539","48","20151230012739","PC","AAA01","1","10000","2000","8000","2015-12-30 13:27:39"
"8540","48","20151229112751","Shop","AAA03","5","85000","15000","70000","2015-12-29 23:27:51"
"8541","39","20151229020618","Shop","AAA01","6","60000","12000","48000","2015-12-29 14:06:18"
"8542","42","20151229104151","Shop","AAA02","9","135000","20700","114300","2015-12-29 10:41:51"
"8543","52","20151229090735","Shop","AAA03","4","68000","12000","56000","2015-12-29 09:07:35"
"8544","87","20151229075906","Shop","AAA01","2","20000","4000","16000","2015-12-29 07:59:06"
"8545","44","20151228032107","PC","AAA04","3","24000","1200","22800","2015-12-28 15:21:07"
"8546","93","20151228014032","Shop","AAA05","2","120000","40000","80000","2015-12-28 13:40:32"
"8547","29","20151228123859","Shop","AAA02","9","135000","20700","114300","2015-12-28 12:38:59"
"8548","48","20151223094734","Mobile","AAA04","6","48000","2400","45600","2015-12-23 09:47:34"
"8549","82","20151223084654","PC","AAA02","7","105000","16100","88900","2015-12-23 08:46:54"
"8550","10","20151223073541","Shop","AAA04","5","40000","2000","38000","2015-12-23 07:35:41"
"8551","12","20151222105932","Mobile","AAA05","2","120000","40000","80000","2015-12-22 10:59:32"
"8552","80","20151222091732","Mobile","AAA03","2","34000","6000","28000","2015-12-22 09:17:32"
"8553","41","20151222081029","Mobile","AAA04","2","16000","800","15200","2015-12-22 08:10:29"
"8554","70","20151222061559","Shop","AAA02","10","150000","23000","127000","2015-12-22 06:15:59"
"8555","16","20151221061423","Mobile","AAA03","12","204000","36000","168000","2015-12-21 18:14:23"
"8556","30","20151221021740","PC","AAA02","7","105000","16100","88900","2015-12-21 14:17:40"
"8557","92","20151221124916","Shop","AAA01","1","10000","2000","8000","2015-12-21 12:49:16"
"8558","43","20151221110541","PC","AAA04","4","32000","1600","30400","2015-12-21 11:05:41"
"8559","86","20151221091806","PC","AAA01","1","10000","2000","8000","2015-12-21 09:18:06"
"8560","66","20151217110307","Mobile","AAA01","1","10000","2000","8000","2015-12-17 11:03:07"
"8561","15","20151217093708","PC","AAA01","15","150000","30000","120000","2015-12-17 09:37:08"
"8562","25","20151216031258","Mobile","AAA04","2","16000","800","15200","2015-12-16 15:12:58"
"8563","9","20151216020158","Mobile","AAA02","2","30000","4600","25400","2015-12-16 14:01:58"
"8564","10","20151216121418","Mobile","AAA05","3","180000","60000","120000","2015-12-16 12:14:18"
"8565","41","20151216104851","Mobile","AAA03","3","51000","9000","42000","2015-12-16 10:48:51"
"8566","89","20151216020438","PC","AAA02","16","240000","36800","203200","2015-12-16 02:04:38"
"8567","34","20151215053751","Mobile","AAA02","3","45000","6900","38100","2015-12-15 17:37:51"
"8568","62","20151215035151","PC","AAA05","4","240000","80000","160000","2015-12-15 15:51:51"
"8569","28","20151215030005","Shop","AAA04","2","16000","800","15200","2015-12-15 15:00:05"
"8570","22","20151215011335","PC","AAA02","2","30000","4600","25400","2015-12-15 13:13:35"
"8571","8","20151215113321","Mobile","AAA01","1","10000","2000","8000","2015-12-15 11:33:21"
"8572","90","20151215093744","Shop","AAA03","4","68000","12000","56000","2015-12-15 09:37:44"
"8573","54","20151215081448","PC","AAA03","5","85000","15000","70000","2015-12-15 08:14:48"
"8574","63","20151215063206","PC","AAA04","4","32000","1600","30400","2015-12-15 06:32:06"
"8575","29","20151214020248","Shop","AAA01","3","30000","6000","24000","2015-12-14 14:02:48"
"8576","66","20151214114027","PC","AAA02","8","120000","18400","101600","2015-12-14 11:40:27"
"8577","10","20151210065728","Shop","AAA05","2","120000","40000","80000","2015-12-10 18:57:28"
"8578","91","20151210030653","Shop","AAA01","1","10000","2000","8000","2015-12-10 15:06:53"
"8579","43","20151210010657","Shop","AAA04","1","8000","400","7600","2015-12-10 13:06:57"
"8580","34","20151210094843","Mobile","AAA05","6","360000","120000","240000","2015-12-10 09:48:43"
"8581","62","20151210075953","PC","AAA02","1","15000","2300","12700","2015-12-10 07:59:53"
"8582","91","20151209082406","Mobile","AAA01","1","10000","2000","8000","2015-12-09 20:24:06"
"8583","81","20151209051759","Mobile","AAA03","2","34000","6000","28000","2015-12-09 17:17:59"
"8584","72","20151209032525","Mobile","AAA02","3","45000","6900","38100","2015-12-09 15:25:25"
"8585","13","20151209022356","Mobile","AAA01","1","10000","2000","8000","2015-12-09 14:23:56"
"8586","28","20151209122431","PC","AAA01","1","10000","2000","8000","2015-12-09 12:24:31"
"8587","95","20151209110839","Mobile","AAA04","7","56000","2800","53200","2015-12-09 11:08:39"
"8588","60","20151209092217","Mobile","AAA02","3","45000","6900","38100","2015-12-09 09:22:17"
"8589","35","20151209074625","Shop","AAA01","2","20000","4000","16000","2015-12-09 07:46:25"
"8590","81","20151208040401","PC","AAA03","2","34000","6000","28000","2015-12-08 16:04:01"
"8591","51","20151208021407","Mobile","AAA03","6","102000","18000","84000","2015-12-08 14:14:07"
"8592","44","20151208124522","PC","AAA04","1","8000","400","7600","2015-12-08 12:45:22"
"8593","81","20151208094941","Mobile","AAA01","4","40000","8000","32000","2015-12-08 09:49:41"
"8594","96","20151208083219","PC","AAA04","6","48000","2400","45600","2015-12-08 08:32:19"
"8595","24","20151208070018","Shop","AAA05","4","240000","80000","160000","2015-12-08 07:00:18"
"8596","86","20151207095510","Mobile","AAA01","1","10000","2000","8000","2015-12-07 21:55:10"
"8597","23","20151207051525","PC","AAA03","4","68000","12000","56000","2015-12-07 17:15:25"
"8598","42","20151207015815","Shop","AAA01","7","70000","14000","56000","2015-12-07 13:58:15"
"8599","43","20151207114813","Shop","AAA03","10","170000","30000","140000","2015-12-07 11:48:13"
"8600","40","20151207101617","Shop","AAA05","8","480000","160000","320000","2015-12-07 10:16:17"
"8601","53","20151204033452","PC","AAA03","5","85000","15000","70000","2015-12-04 03:34:52"
"8602","76","20151203084619","PC","AAA03","5","85000","15000","70000","2015-12-03 08:46:19"
"8603","9","20151203073508","Shop","AAA02","3","45000","6900","38100","2015-12-03 07:35:08"
"8604","64","20151202041644","Shop","AAA01","7","70000","14000","56000","2015-12-02 16:16:44"
"8605","34","20151202030246","PC","AAA04","6","48000","2400","45600","2015-12-02 15:02:46"
"8606","57","20151202011742","PC","AAA03","3","51000","9000","42000","2015-12-02 13:17:42"
"8607","61","20151202122014","Shop","AAA02","1","15000","2300","12700","2015-12-02 12:20:14"
"8608","57","20151202104943","Shop","AAA05","2","120000","40000","80000","2015-12-02 10:49:43"
"8609","27","20151202093634","Shop","AAA03","10","170000","30000","140000","2015-12-02 09:36:34"
"8610","9","20151202080322","Mobile","AAA01","6","60000","12000","48000","2015-12-02 08:03:22"
"8611","97","20151202071415","PC","AAA01","1","10000","2000","8000","2015-12-02 07:14:15"
"8612","92","20151201120414","Shop","AAA05","4","240000","80000","160000","2015-12-01 12:04:14"
"8613","37","20151201104522","Mobile","AAA01","5","50000","10000","40000","2015-12-01 10:45:22"
"8614","13","20151201093913","PC","AAA02","2","30000","4600","25400","2015-12-01 09:39:13"
"8615","73","20151201082357","PC","AAA02","4","60000","9200","50800","2015-12-01 08:23:57"
"8616","50","20151130081118","PC","AAA05","5","300000","100000","200000","2015-11-30 20:11:18"
"8617","30","20151130015433","Mobile","AAA01","3","30000","6000","24000","2015-11-30 13:54:33"
"8618","100","20151130012515","Mobile","AAA02","2","30000","4600","25400","2015-11-30 13:25:15"
"8619","54","20151130114005","Shop","AAA04","2","16000","800","15200","2015-11-30 11:40:05"
"8620","15","20151126013937","Mobile","AAA05","14","840000","280000","560000","2015-11-26 13:39:37"
"8621","3","20151126115851","Mobile","AAA02","3","45000","6900","38100","2015-11-26 11:58:51"
"8622","74","20151126104923","PC","AAA02","2","30000","4600","25400","2015-11-26 10:49:23"
"8623","13","20151126094735","Shop","AAA03","2","34000","6000","28000","2015-11-26 09:47:35"
"8624","96","20151126073917","PC","AAA03","2","34000","6000","28000","2015-11-26 07:39:17"
"8625","66","20151125041240","PC","AAA02","2","30000","4600","25400","2015-11-25 16:12:40"
"8626","58","20151125023913","Shop","AAA02","2","30000","4600","25400","2015-11-25 14:39:13"
"8627","88","20151125010157","Shop","AAA03","4","68000","12000","56000","2015-11-25 13:01:57"
"8628","8","20151125114654","Shop","AAA05","6","360000","120000","240000","2015-11-25 11:46:54"
"8629","53","20151125104613","PC","AAA01","1","10000","2000","8000","2015-11-25 10:46:13"
"8630","6","20151125070804","PC","AAA04","1","8000","400","7600","2015-11-25 07:08:04"
"8631","30","20151124065556","Shop","AAA02","3","45000","6900","38100","2015-11-24 18:55:56"
"8632","77","20151124015618","Shop","AAA03","2","34000","6000","28000","2015-11-24 13:56:18"
"8633","22","20151124124129","PC","AAA02","8","120000","18400","101600","2015-11-24 12:41:29"
"8634","87","20151124110516","Shop","AAA01","4","40000","8000","32000","2015-11-24 11:05:16"
"8635","89","20151124100324","Shop","AAA02","13","195000","29900","165100","2015-11-24 10:03:24"
"8636","65","20151124081945","Shop","AAA01","8","80000","16000","64000","2015-11-24 08:19:45"
"8637","40","20151124062219","Mobile","AAA04","1","8000","400","7600","2015-11-24 06:22:19"
"8638","82","20151123021753","Mobile","AAA05","7","420000","140000","280000","2015-11-23 14:17:53"
"8639","63","20151123122359","Shop","AAA05","4","240000","80000","160000","2015-11-23 12:23:59"
"8640","14","20151123113352","PC","AAA02","2","30000","4600","25400","2015-11-23 11:33:52"
"8641","8","20151123102519","PC","AAA04","6","48000","2400","45600","2015-11-23 10:25:19"
"8642","87","20151123080658","Shop","AAA04","2","16000","800","15200","2015-11-23 08:06:58"
"8643","85","20151118091220","Shop","AAA01","12","120000","24000","96000","2015-11-18 09:12:20"
"8644","61","20151118080348","Shop","AAA01","2","20000","4000","16000","2015-11-18 08:03:48"
"8645","2","20151118065730","PC","AAA04","1","8000","400","7600","2015-11-18 06:57:30"
"8646","32","20151117071119","Shop","AAA05","9","540000","180000","360000","2015-11-17 19:11:19"
"8647","96","20151117022601","Shop","AAA03","7","119000","21000","98000","2015-11-17 14:26:01"
"8648","8","20151117124829","Shop","AAA02","3","45000","6900","38100","2015-11-17 12:48:29"
"8649","32","20151117112929","PC","AAA03","11","187000","33000","154000","2015-11-17 11:29:29"
"8650","76","20151117063817","Mobile","AAA02","2","30000","4600","25400","2015-11-17 06:38:17"
"8651","17","20151116103142","Shop","AAA02","1","15000","2300","12700","2015-11-16 10:31:42"
"8652","84","20151116093205","Mobile","AAA04","4","32000","1600","30400","2015-11-16 09:32:05"
"8653","24","20151113095132","Mobile","AAA03","5","85000","15000","70000","2015-11-13 09:51:32"
"8654","44","20151113085423","PC","AAA05","2","120000","40000","80000","2015-11-13 08:54:23"
"8655","70","20151113075240","Shop","AAA03","20","340000","60000","280000","2015-11-13 07:52:40"
"8656","41","20151112090821","Shop","AAA01","8","80000","16000","64000","2015-11-12 21:08:21"
"8657","62","20151112065159","Shop","AAA02","6","90000","13800","76200","2015-11-12 18:51:59"
"8658","49","20151112021747","Shop","AAA02","1","15000","2300","12700","2015-11-12 14:17:47"
"8659","62","20151112014554","Shop","AAA01","4","40000","8000","32000","2015-11-12 13:45:54"
"8660","7","20151112122120","Shop","AAA04","10","80000","4000","76000","2015-11-12 12:21:20"
"8661","62","20151112103709","Mobile","AAA03","8","136000","24000","112000","2015-11-12 10:37:09"
"8662","33","20151112083416","Mobile","AAA04","1","8000","400","7600","2015-11-12 08:34:16"
"8663","29","20151111034758","PC","AAA03","6","102000","18000","84000","2015-11-11 15:47:58"
"8664","21","20151111024857","Mobile","AAA01","1","10000","2000","8000","2015-11-11 14:48:57"
"8665","3","20151111015043","Shop","AAA03","10","170000","30000","140000","2015-11-11 13:50:43"
"8666","39","20151111122504","PC","AAA01","5","50000","10000","40000","2015-11-11 12:25:04"
"8667","9","20151111093140","PC","AAA01","2","20000","4000","16000","2015-11-11 09:31:40"
"8668","70","20151110055830","PC","AAA04","7","56000","2800","53200","2015-11-10 17:58:30"
"8669","24","20151110042013","Mobile","AAA01","1","10000","2000","8000","2015-11-10 16:20:13"
"8670","23","20151110025009","PC","AAA04","7","56000","2800","53200","2015-11-10 14:50:09"
"8671","44","20151110123746","Mobile","AAA01","5","50000","10000","40000","2015-11-10 12:37:46"
"8672","95","20151110111214","PC","AAA01","7","70000","14000","56000","2015-11-10 11:12:14"
"8673","93","20151110085534","Shop","AAA04","8","64000","3200","60800","2015-11-10 08:55:34"
"8674","89","20151110073057","Mobile","AAA05","10","600000","200000","400000","2015-11-10 07:30:57"
"8675","10","20151109022940","Mobile","AAA04","10","80000","4000","76000","2015-11-09 14:29:40"
"8676","91","20151109120656","Mobile","AAA05","1","60000","20000","40000","2015-11-09 12:06:56"
"8677","85","20151109114332","PC","AAA03","3","51000","9000","42000","2015-11-09 11:43:32"
"8678","59","20151109093434","PC","AAA03","4","68000","12000","56000","2015-11-09 09:34:34"
"8679","83","20151104102907","Shop","AAA02","5","75000","11500","63500","2015-11-04 10:29:07"
"8680","22","20151104081248","Mobile","AAA01","1","10000","2000","8000","2015-11-04 08:12:48"
"8681","1","20151103055725","PC","AAA01","1","10000","2000","8000","2015-11-03 17:57:25"
"8682","55","20151103044030","Shop","AAA05","7","420000","140000","280000","2015-11-03 16:40:30"
"8683","96","20151103025903","Shop","AAA05","4","240000","80000","160000","2015-11-03 14:59:03"
"8684","70","20151103010731","Mobile","AAA01","8","80000","16000","64000","2015-11-03 13:07:31"
"8685","8","20151103105438","Shop","AAA04","9","72000","3600","68400","2015-11-03 10:54:38"
"8686","42","20151103090648","Mobile","AAA01","5","50000","10000","40000","2015-11-03 09:06:48"
"8687","65","20151103072606","Shop","AAA05","1","60000","20000","40000","2015-11-03 07:26:06"
"8688","17","20151102051040","Mobile","AAA05","3","180000","60000","120000","2015-11-02 17:10:40"
"8689","50","20151102031610","PC","AAA05","4","240000","80000","160000","2015-11-02 15:16:10"
"8690","86","20151102121613","Shop","AAA05","5","300000","100000","200000","2015-11-02 12:16:13"
"8691","67","20151102093428","PC","AAA02","1","15000","2300","12700","2015-11-02 09:34:28"
"8692","89","20151029082327","Mobile","AAA01","10","100000","20000","80000","2015-10-29 08:23:27"
"8693","21","20151029064831","Mobile","AAA01","7","70000","14000","56000","2015-10-29 06:48:31"
"8694","2","20151029044343","PC","AAA05","5","300000","100000","200000","2015-10-29 04:43:43"
"8695","52","20151028085224","Mobile","AAA02","1","15000","2300","12700","2015-10-28 08:52:24"
"8696","96","20151028085533","Shop","AAA02","7","105000","16100","88900","2015-10-28 08:55:33"
"8697","62","20151028065634","Shop","AAA05","6","360000","120000","240000","2015-10-28 06:56:34"
"8698","42","20151028121358","Shop","AAA02","5","75000","11500","63500","2015-10-28 00:13:58"
"8699","27","20151027012452","Shop","AAA05","9","540000","180000","360000","2015-10-27 13:24:52"
"8700","71","20151027121130","Mobile","AAA01","2","20000","4000","16000","2015-10-27 12:11:30"
"8701","27","20151027103753","PC","AAA03","2","34000","6000","28000","2015-10-27 10:37:53"
"8702","12","20151027093933","Mobile","AAA05","5","300000","100000","200000","2015-10-27 09:39:33"
"8703","99","20151027083334","PC","AAA02","5","75000","11500","63500","2015-10-27 08:33:34"
"8704","19","20151027062902","Mobile","AAA01","2","20000","4000","16000","2015-10-27 06:29:02"
"8705","37","20151026074343","Mobile","AAA05","3","180000","60000","120000","2015-10-26 19:43:43"
"8706","55","20151026034211","Shop","AAA01","3","30000","6000","24000","2015-10-26 15:42:11"
"8707","87","20151026022109","Shop","AAA02","2","30000","4600","25400","2015-10-26 14:21:09"
"8708","70","20151026011527","Shop","AAA01","1","10000","2000","8000","2015-10-26 13:15:27"
"8709","8","20151026114742","Mobile","AAA03","4","68000","12000","56000","2015-10-26 11:47:42"
"8710","43","20151026100156","Mobile","AAA04","5","40000","2000","38000","2015-10-26 10:01:56"
"8711","80","20151026080710","Mobile","AAA03","1","17000","3000","14000","2015-10-26 08:07:10"
"8712","59","20151021022618","PC","AAA05","1","60000","20000","40000","2015-10-21 14:26:18"
"8713","66","20151021012753","Mobile","AAA02","8","120000","18400","101600","2015-10-21 13:27:53"
"8714","82","20151021112914","Shop","AAA03","6","102000","18000","84000","2015-10-21 11:29:14"
"8715","11","20151021094711","Shop","AAA05","5","300000","100000","200000","2015-10-21 09:47:11"
"8716","92","20151021073456","PC","AAA01","3","30000","6000","24000","2015-10-21 07:34:56"
"8717","41","20151020022302","PC","AAA03","4","68000","12000","56000","2015-10-20 14:23:02"
"8718","66","20151020125740","PC","AAA05","8","480000","160000","320000","2015-10-20 12:57:40"
"8719","13","20151020120454","Mobile","AAA01","5","50000","10000","40000","2015-10-20 12:04:54"
"8720","100","20151020104522","Shop","AAA03","4","68000","12000","56000","2015-10-20 10:45:22"
"8721","40","20151020093202","Mobile","AAA03","3","51000","9000","42000","2015-10-20 09:32:02"
"8722","98","20151020081703","Mobile","AAA01","1","10000","2000","8000","2015-10-20 08:17:03"
"8723","50","20151020065439","Shop","AAA01","4","40000","8000","32000","2015-10-20 06:54:39"
"8724","40","20151019034238","PC","AAA02","2","30000","4600","25400","2015-10-19 15:42:38"
"8725","59","20151019022116","Shop","AAA01","2","20000","4000","16000","2015-10-19 14:21:16"
"8726","3","20151019122735","Shop","AAA03","16","272000","48000","224000","2015-10-19 12:27:35"
"8727","9","20151019105436","Mobile","AAA03","3","51000","9000","42000","2015-10-19 10:54:36"
"8728","83","20151019092745","PC","AAA02","2","30000","4600","25400","2015-10-19 09:27:45"
"8729","64","20151014123300","Mobile","AAA02","6","90000","13800","76200","2015-10-14 00:33:00"
"8730","46","20151013080238","Shop","AAA05","9","540000","180000","360000","2015-10-13 08:02:38"
"8731","65","20151013064050","Shop","AAA03","2","34000","6000","28000","2015-10-13 06:40:50"
"8732","14","20151013010245","Shop","AAA03","2","34000","6000","28000","2015-10-13 01:02:45"
"8733","47","20151012090621","Shop","AAA03","1","17000","3000","14000","2015-10-12 09:06:21"
"8734","79","20151008033337","Mobile","AAA03","4","68000","12000","56000","2015-10-08 15:33:37"
"8735","27","20151008011229","Mobile","AAA04","11","88000","4400","83600","2015-10-08 13:12:29"
"8736","1","20151008113908","Shop","AAA01","5","50000","10000","40000","2015-10-08 11:39:08"
"8737","62","20151008103748","Mobile","AAA04","4","32000","1600","30400","2015-10-08 10:37:48"
"8738","90","20151008094117","Mobile","AAA02","1","15000","2300","12700","2015-10-08 09:41:17"
"8739","32","20151008070839","PC","AAA03","6","102000","18000","84000","2015-10-08 07:08:39"
"8740","32","20151007030711","Mobile","AAA04","9","72000","3600","68400","2015-10-07 15:07:11"
"8741","84","20151007021230","Shop","AAA04","3","24000","1200","22800","2015-10-07 14:12:30"
"8742","98","20151007121225","Mobile","AAA05","6","360000","120000","240000","2015-10-07 12:12:25"
"8743","77","20151007105317","Mobile","AAA05","1","60000","20000","40000","2015-10-07 10:53:17"
"8744","94","20151007091721","Shop","AAA03","5","85000","15000","70000","2015-10-07 09:17:21"
"8745","70","20151007075616","PC","AAA03","6","102000","18000","84000","2015-10-07 07:56:16"
"8746","16","20151006115747","Mobile","AAA04","8","64000","3200","60800","2015-10-06 23:57:47"
"8747","36","20151006081436","PC","AAA01","7","70000","14000","56000","2015-10-06 08:14:36"
"8748","83","20151006070332","Mobile","AAA03","5","85000","15000","70000","2015-10-06 07:03:32"
"8749","45","20151005050616","Mobile","AAA04","5","40000","2000","38000","2015-10-05 17:06:16"
"8750","56","20151005030643","PC","AAA04","7","56000","2800","53200","2015-10-05 15:06:43"
"8751","38","20151005125958","Mobile","AAA04","4","32000","1600","30400","2015-10-05 12:59:58"
"8752","54","20151005121510","Mobile","AAA05","7","420000","140000","280000","2015-10-05 12:15:10"
"8753","94","20151005104905","Mobile","AAA03","13","221000","39000","182000","2015-10-05 10:49:05"
"8754","66","20151005092808","Mobile","AAA03","5","85000","15000","70000","2015-10-05 09:28:08"
"8755","14","20151002021516","Shop","AAA02","2","30000","4600","25400","2015-10-02 02:15:16"
"8756","18","20151001013315","Mobile","AAA03","1","17000","3000","14000","2015-10-01 13:33:15"
"8757","8","20151001121558","Mobile","AAA05","1","60000","20000","40000","2015-10-01 12:15:58"
"8758","97","20151001111956","Shop","AAA05","4","240000","80000","160000","2015-10-01 11:19:56"
"8759","32","20151001104916","PC","AAA04","8","64000","3200","60800","2015-10-01 10:49:16"
"8760","96","20151001091602","Mobile","AAA02","1","15000","2300","12700","2015-10-01 09:16:02"
"8761","93","20151001085109","Mobile","AAA02","2","30000","4600","25400","2015-10-01 08:51:09"
"8762","56","20151001072439","Shop","AAA03","5","85000","15000","70000","2015-10-01 07:24:39"
"8763","43","20150930091021","Shop","AAA03","7","119000","21000","98000","2015-09-30 21:10:21"
"8764","27","20150930040026","PC","AAA03","8","136000","24000","112000","2015-09-30 16:00:26"
"8765","68","20150930015217","Mobile","AAA01","4","40000","8000","32000","2015-09-30 13:52:17"
"8766","34","20150930113516","Shop","AAA02","4","60000","9200","50800","2015-09-30 11:35:16"
"8767","33","20150930095429","PC","AAA04","1","8000","400","7600","2015-09-30 09:54:29"
"8768","46","20150929100603","Mobile","AAA01","6","60000","12000","48000","2015-09-29 22:06:03"
"8769","14","20150929080236","Mobile","AAA01","3","30000","6000","24000","2015-09-29 20:02:36"
"8770","52","20150929040112","Mobile","AAA03","3","51000","9000","42000","2015-09-29 16:01:12"
"8771","84","20150929022906","PC","AAA04","1","8000","400","7600","2015-09-29 14:29:06"
"8772","32","20150929012439","PC","AAA04","5","40000","2000","38000","2015-09-29 13:24:39"
"8773","42","20150929112745","PC","AAA05","8","480000","160000","320000","2015-09-29 11:27:45"
"8774","96","20150929100124","PC","AAA02","3","45000","6900","38100","2015-09-29 10:01:24"
"8775","33","20150929081814","PC","AAA02","1","15000","2300","12700","2015-09-29 08:18:14"
"8776","8","20150929065001","Shop","AAA05","1","60000","20000","40000","2015-09-29 06:50:01"
"8777","63","20150928045034","Mobile","AAA03","4","68000","12000","56000","2015-09-28 16:50:34"
"8778","76","20150928040907","Shop","AAA02","4","60000","9200","50800","2015-09-28 16:09:07"
"8779","11","20150928012642","PC","AAA03","6","102000","18000","84000","2015-09-28 13:26:42"
"8780","33","20150928112050","Mobile","AAA01","5","50000","10000","40000","2015-09-28 11:20:50"
"8781","11","20150928091402","Mobile","AAA02","8","120000","18400","101600","2015-09-28 09:14:02"
"8782","65","20150924091447","Shop","AAA04","3","24000","1200","22800","2015-09-24 09:14:47"
"8783","68","20150924065246","Shop","AAA05","3","180000","60000","120000","2015-09-24 06:52:46"
"8784","94","20150923033459","Mobile","AAA02","13","195000","29900","165100","2015-09-23 15:34:59"
"8785","34","20150923023230","PC","AAA01","6","60000","12000","48000","2015-09-23 14:32:30"
"8786","45","20150923123924","PC","AAA01","2","20000","4000","16000","2015-09-23 12:39:24"
"8787","28","20150923092647","Mobile","AAA02","9","135000","20700","114300","2015-09-23 09:26:47"
"8788","25","20150923091133","Mobile","AAA05","3","180000","60000","120000","2015-09-23 09:11:33"
"8789","96","20150923070829","PC","AAA04","10","80000","4000","76000","2015-09-23 07:08:29"
"8790","55","20150922094842","Mobile","AAA04","6","48000","2400","45600","2015-09-22 09:48:42"
"8791","32","20150922081521","PC","AAA05","7","420000","140000","280000","2015-09-22 08:15:21"
"8792","13","20150922071116","PC","AAA01","2","20000","4000","16000","2015-09-22 07:11:16"
"8793","36","20150921094814","Shop","AAA03","4","68000","12000","56000","2015-09-21 21:48:14"
"8794","25","20150921042637","Shop","AAA03","2","34000","6000","28000","2015-09-21 16:26:37"
"8795","50","20150921023616","Mobile","AAA05","5","300000","100000","200000","2015-09-21 14:36:16"
"8796","48","20150921011002","PC","AAA02","3","45000","6900","38100","2015-09-21 13:10:02"
"8797","94","20150921113021","PC","AAA02","7","105000","16100","88900","2015-09-21 11:30:21"
"8798","79","20150921105900","PC","AAA02","1","15000","2300","12700","2015-09-21 10:59:00"
"8799","11","20150921104236","PC","AAA02","1","15000","2300","12700","2015-09-21 10:42:36"
"8800","69","20150921091553","Shop","AAA03","1","17000","3000","14000","2015-09-21 09:15:53"
"8801","12","20150919061825","Mobile","AAA01","3","30000","6000","24000","2015-09-19 18:18:25"
"8802","72","20150917114433","PC","AAA01","4","40000","8000","32000","2015-09-17 23:44:33"
"8803","38","20150917100908","PC","AAA04","1","8000","400","7600","2015-09-17 10:09:08"
"8804","21","20150916082639","PC","AAA05","10","600000","200000","400000","2015-09-16 20:26:39"
"8805","81","20150916124656","PC","AAA04","1","8000","400","7600","2015-09-16 12:46:56"
"8806","50","20150916115934","Mobile","AAA01","7","70000","14000","56000","2015-09-16 11:59:34"
"8807","51","20150916103308","Mobile","AAA02","1","15000","2300","12700","2015-09-16 10:33:08"
"8808","17","20150916091104","PC","AAA05","5","300000","100000","200000","2015-09-16 09:11:04"
"8809","94","20150916080306","PC","AAA03","1","17000","3000","14000","2015-09-16 08:03:06"
"8810","47","20150915091505","Shop","AAA02","5","75000","11500","63500","2015-09-15 09:15:05"
"8811","60","20150915070910","Shop","AAA03","5","85000","15000","70000","2015-09-15 07:09:10"
"8812","44","20150914030125","Mobile","AAA04","6","48000","2400","45600","2015-09-14 15:01:25"
"8813","16","20150914012350","Mobile","AAA01","2","20000","4000","16000","2015-09-14 13:23:50"
"8814","100","20150914113932","Mobile","AAA05","2","120000","40000","80000","2015-09-14 11:39:32"
"8815","21","20150914104215","PC","AAA02","9","135000","20700","114300","2015-09-14 10:42:15"
"8816","73","20150914092556","Shop","AAA05","4","240000","80000","160000","2015-09-14 09:25:56"
"8817","1","20150911015002","Mobile","AAA03","2","34000","6000","28000","2015-09-11 01:50:02"
"8818","5","20150909011237","PC","AAA05","10","600000","200000","400000","2015-09-09 13:12:37"
"8819","6","20150909115213","PC","AAA01","2","20000","4000","16000","2015-09-09 11:52:13"
"8820","42","20150909101702","Mobile","AAA03","5","85000","15000","70000","2015-09-09 10:17:02"
"8821","58","20150909082907","PC","AAA02","7","105000","16100","88900","2015-09-09 08:29:07"
"8822","86","20150908022553","Mobile","AAA01","3","30000","6000","24000","2015-09-08 14:25:53"
"8823","83","20150908013657","PC","AAA04","4","32000","1600","30400","2015-09-08 13:36:57"
"8824","46","20150908120700","PC","AAA01","9","90000","18000","72000","2015-09-08 12:07:00"
"8825","17","20150908110428","PC","AAA02","3","45000","6900","38100","2015-09-08 11:04:28"
"8826","57","20150908063634","Shop","AAA01","1","10000","2000","8000","2015-09-08 06:36:34"
"8827","98","20150907082745","Mobile","AAA01","4","40000","8000","32000","2015-09-07 20:27:45"
"8828","61","20150907060650","Mobile","AAA04","1","8000","400","7600","2015-09-07 18:06:50"
"8829","20","20150907040442","Shop","AAA04","9","72000","3600","68400","2015-09-07 16:04:42"
"8830","38","20150907013614","Shop","AAA05","1","60000","20000","40000","2015-09-07 13:36:14"
"8831","37","20150907104034","Mobile","AAA05","3","180000","60000","120000","2015-09-07 10:40:34"
"8832","97","20150907090209","PC","AAA05","7","420000","140000","280000","2015-09-07 09:02:09"
"8833","83","20150902032934","Mobile","AAA05","2","120000","40000","80000","2015-09-02 15:29:34"
"8834","48","20150902021948","Shop","AAA03","3","51000","9000","42000","2015-09-02 14:19:48"
"8835","30","20150902122734","Mobile","AAA03","6","102000","18000","84000","2015-09-02 12:27:34"
"8836","14","20150902104338","Mobile","AAA05","5","300000","100000","200000","2015-09-02 10:43:38"
"8837","85","20150902091353","PC","AAA03","10","170000","30000","140000","2015-09-02 09:13:53"
"8838","51","20150902070122","Mobile","AAA04","8","64000","3200","60800","2015-09-02 07:01:22"
"8839","19","20150901035529","Mobile","AAA01","2","20000","4000","16000","2015-09-01 15:55:29"
"8840","37","20150901021631","Mobile","AAA01","5","50000","10000","40000","2015-09-01 14:16:31"
"8841","69","20150901012259","Shop","AAA02","4","60000","9200","50800","2015-09-01 13:22:59"
"8842","42","20150901111748","Mobile","AAA03","8","136000","24000","112000","2015-09-01 11:17:48"
"8843","40","20150901070400","Shop","AAA02","3","45000","6900","38100","2015-09-01 07:04:00"
"8844","70","20150831075250","PC","AAA02","8","120000","18400","101600","2015-08-31 19:52:50"
"8845","62","20150831040636","Shop","AAA05","6","360000","120000","240000","2015-08-31 16:06:36"
"8846","7","20150831023223","Mobile","AAA05","10","600000","200000","400000","2015-08-31 14:32:23"
"8847","89","20150831114117","Mobile","AAA01","8","80000","16000","64000","2015-08-31 11:41:17"
"8848","97","20150828123525","PC","AAA05","5","300000","100000","200000","2015-08-28 00:35:25"
"8849","53","20150827065746","PC","AAA04","4","32000","1600","30400","2015-08-27 18:57:46"
"8850","33","20150827033039","Mobile","AAA04","1","8000","400","7600","2015-08-27 15:30:39"
"8851","14","20150827021024","Mobile","AAA01","4","40000","8000","32000","2015-08-27 14:10:24"
"8852","10","20150827123058","PC","AAA02","6","90000","13800","76200","2015-08-27 12:30:58"
"8853","86","20150827115030","PC","AAA02","1","15000","2300","12700","2015-08-27 11:50:30"
"8854","39","20150827084134","Shop","AAA04","3","24000","1200","22800","2015-08-27 08:41:34"
"8855","8","20150827074635","PC","AAA05","1","60000","20000","40000","2015-08-27 07:46:35"
"8856","21","20150826053815","Shop","AAA05","10","600000","200000","400000","2015-08-26 17:38:15"
"8857","95","20150826043518","Shop","AAA03","4","68000","12000","56000","2015-08-26 16:35:18"
"8858","45","20150826034634","Shop","AAA03","4","68000","12000","56000","2015-08-26 15:46:34"
"8859","82","20150826123713","Shop","AAA02","3","45000","6900","38100","2015-08-26 12:37:13"
"8860","87","20150826103349","Shop","AAA02","3","45000","6900","38100","2015-08-26 10:33:49"
"8861","73","20150826094426","PC","AAA04","4","32000","1600","30400","2015-08-26 09:44:26"
"8862","41","20150826092603","Shop","AAA05","3","180000","60000","120000","2015-08-26 09:26:03"
"8863","30","20150826081125","PC","AAA04","3","24000","1200","22800","2015-08-26 08:11:25"
"8864","58","20150826065735","PC","AAA01","5","50000","10000","40000","2015-08-26 06:57:35"
"8865","13","20150825092613","PC","AAA01","6","60000","12000","48000","2015-08-25 21:26:13"
"8866","21","20150825051039","Mobile","AAA01","8","80000","16000","64000","2015-08-25 17:10:39"
"8867","36","20150825042428","Shop","AAA03","12","204000","36000","168000","2015-08-25 16:24:28"
"8868","76","20150825031340","Shop","AAA02","4","60000","9200","50800","2015-08-25 15:13:40"
"8869","37","20150825011255","Shop","AAA04","4","32000","1600","30400","2015-08-25 13:12:55"
"8870","80","20150825101708","Shop","AAA04","6","48000","2400","45600","2015-08-25 10:17:08"
"8871","63","20150825080213","Shop","AAA04","1","8000","400","7600","2015-08-25 08:02:13"
"8872","12","20150825064015","Mobile","AAA04","3","24000","1200","22800","2015-08-25 06:40:15"
"8873","22","20150824071805","Shop","AAA01","7","70000","14000","56000","2015-08-24 19:18:05"
"8874","85","20150824074117","Mobile","AAA03","2","34000","6000","28000","2015-08-24 19:41:17"
"8875","54","20150824032646","Shop","AAA02","7","105000","16100","88900","2015-08-24 15:26:46"
"8876","4","20150824020113","Mobile","AAA03","3","51000","9000","42000","2015-08-24 14:01:13"
"8877","16","20150824122601","PC","AAA03","1","17000","3000","14000","2015-08-24 12:26:01"
"8878","16","20150824104815","Shop","AAA01","6","60000","12000","48000","2015-08-24 10:48:15"
"8879","54","20150824090254","Shop","AAA01","2","20000","4000","16000","2015-08-24 09:02:54"
"8880","25","20150819110225","Shop","AAA01","2","20000","4000","16000","2015-08-19 11:02:25"
"8881","95","20150819090157","Shop","AAA04","1","8000","400","7600","2015-08-19 09:01:57"
"8882","38","20150818081652","PC","AAA01","9","90000","18000","72000","2015-08-18 20:16:52"
"8883","70","20150818053322","Mobile","AAA05","6","360000","120000","240000","2015-08-18 17:33:22"
"8884","36","20150818041032","Shop","AAA03","8","136000","24000","112000","2015-08-18 16:10:32"
"8885","58","20150818024321","Mobile","AAA05","6","360000","120000","240000","2015-08-18 14:43:21"
"8886","23","20150818010209","PC","AAA01","8","80000","16000","64000","2015-08-18 13:02:09"
"8887","70","20150818112656","Shop","AAA02","5","75000","11500","63500","2015-08-18 11:26:56"
"8888","66","20150818094820","Mobile","AAA02","2","30000","4600","25400","2015-08-18 09:48:20"
"8889","22","20150818074623","PC","AAA04","7","56000","2800","53200","2015-08-18 07:46:23"
"8890","32","20150817025445","PC","AAA03","5","85000","15000","70000","2015-08-17 14:54:45"
"8891","56","20150817012617","Mobile","AAA03","5","85000","15000","70000","2015-08-17 13:26:17"
"8892","37","20150817100214","Mobile","AAA04","6","48000","2400","45600","2015-08-17 10:02:14"
"8893","39","20150812071320","PC","AAA01","4","40000","8000","32000","2015-08-12 19:13:20"
"8894","34","20150812031706","Mobile","AAA02","3","45000","6900","38100","2015-08-12 15:17:06"
"8895","24","20150812125723","PC","AAA05","8","480000","160000","320000","2015-08-12 12:57:23"
"8896","20","20150812112701","Shop","AAA05","1","60000","20000","40000","2015-08-12 11:27:01"
"8897","40","20150812101153","PC","AAA04","1","8000","400","7600","2015-08-12 10:11:53"
"8898","89","20150812082153","Shop","AAA01","12","120000","24000","96000","2015-08-12 08:21:53"
"8899","28","20150811081644","Shop","AAA02","3","45000","6900","38100","2015-08-11 20:16:44"
"8900","60","20150811012847","PC","AAA05","3","180000","60000","120000","2015-08-11 13:28:47"
"8901","11","20150811120640","Shop","AAA03","5","85000","15000","70000","2015-08-11 12:06:40"
"8902","25","20150811110106","PC","AAA05","7","420000","140000","280000","2015-08-11 11:01:06"
"8903","36","20150811100230","Shop","AAA04","11","88000","4400","83600","2015-08-11 10:02:30"
"8904","88","20150811090435","PC","AAA02","3","45000","6900","38100","2015-08-11 09:04:35"
"8905","28","20150811070331","Mobile","AAA01","6","60000","12000","48000","2015-08-11 07:03:31"
"8906","10","20150810010520","PC","AAA04","6","48000","2400","45600","2015-08-10 13:05:20"
"8907","79","20150810115529","Shop","AAA05","8","480000","160000","320000","2015-08-10 11:55:29"
"8908","82","20150810110232","PC","AAA04","5","40000","2000","38000","2015-08-10 11:02:32"
"8909","13","20150810092346","Mobile","AAA01","1","10000","2000","8000","2015-08-10 09:23:46"
"8910","4","20150807010402","Mobile","AAA02","3","45000","6900","38100","2015-08-07 13:04:02"
"8911","9","20150807091558","Mobile","AAA01","1","10000","2000","8000","2015-08-07 09:15:58"
"8912","2","20150807075247","Mobile","AAA03","1","17000","3000","14000","2015-08-07 07:52:47"
"8913","34","20150806043809","PC","AAA04","12","96000","4800","91200","2015-08-06 16:38:09"
"8914","56","20150806032707","PC","AAA05","1","60000","20000","40000","2015-08-06 15:27:07"
"8915","45","20150806021145","Mobile","AAA03","5","85000","15000","70000","2015-08-06 14:11:45"
"8916","27","20150806121231","Mobile","AAA01","1","10000","2000","8000","2015-08-06 12:12:31"
"8917","33","20150806111521","PC","AAA04","5","40000","2000","38000","2015-08-06 11:15:21"
"8918","89","20150806101539","PC","AAA05","8","480000","160000","320000","2015-08-06 10:15:39"
"8919","60","20150806084947","PC","AAA04","3","24000","1200","22800","2015-08-06 08:49:47"
"8920","69","20150806074022","Mobile","AAA03","1","17000","3000","14000","2015-08-06 07:40:22"
"8921","23","20150805022552","Shop","AAA01","2","20000","4000","16000","2015-08-05 14:25:52"
"8922","95","20150805014112","PC","AAA05","3","180000","60000","120000","2015-08-05 13:41:12"
"8923","55","20150805010250","Shop","AAA04","7","56000","2800","53200","2015-08-05 13:02:50"
"8924","95","20150805125347","PC","AAA04","1","8000","400","7600","2015-08-05 12:53:47"
"8925","90","20150805090703","PC","AAA05","5","300000","100000","200000","2015-08-05 09:07:03"
"8926","83","20150805074547","Mobile","AAA01","12","120000","24000","96000","2015-08-05 07:45:47"
"8927","78","20150804062335","Mobile","AAA01","2","20000","4000","16000","2015-08-04 18:23:35"
"8928","77","20150804022355","Mobile","AAA05","4","240000","80000","160000","2015-08-04 14:23:55"
"8929","96","20150804115548","PC","AAA01","8","80000","16000","64000","2015-08-04 11:55:48"
"8930","62","20150804081524","Mobile","AAA02","5","75000","11500","63500","2015-08-04 08:15:24"
"8931","55","20150804064350","PC","AAA02","7","105000","16100","88900","2015-08-04 06:43:50"
"8932","18","20150803075150","PC","AAA05","6","360000","120000","240000","2015-08-03 19:51:50"
"8933","99","20150803035027","PC","AAA01","5","50000","10000","40000","2015-08-03 15:50:27"
"8934","47","20150803023718","Shop","AAA04","3","24000","1200","22800","2015-08-03 14:37:18"
"8935","97","20150803011321","Mobile","AAA03","1","17000","3000","14000","2015-08-03 13:13:21"
"8936","71","20150803112956","Mobile","AAA02","2","30000","4600","25400","2015-08-03 11:29:56"
"8937","2","20150803095010","Shop","AAA05","4","240000","80000","160000","2015-08-03 09:50:10"
"8938","39","20150729041527","Mobile","AAA02","9","135000","20700","114300","2015-07-29 16:15:27"
"8939","90","20150729022204","PC","AAA01","2","20000","4000","16000","2015-07-29 14:22:04"
"8940","49","20150729125424","Mobile","AAA01","4","40000","8000","32000","2015-07-29 12:54:24"
"8941","78","20150729112000","PC","AAA04","1","8000","400","7600","2015-07-29 11:20:00"
"8942","78","20150729095725","PC","AAA04","2","16000","800","15200","2015-07-29 09:57:25"
"8943","79","20150728015736","Shop","AAA03","2","34000","6000","28000","2015-07-28 13:57:36"
"8944","42","20150728122811","PC","AAA01","12","120000","24000","96000","2015-07-28 12:28:11"
"8945","38","20150728104927","Mobile","AAA03","8","136000","24000","112000","2015-07-28 10:49:27"
"8946","74","20150728094651","Shop","AAA02","7","105000","16100","88900","2015-07-28 09:46:51"
"8947","3","20150728073045","Shop","AAA04","4","32000","1600","30400","2015-07-28 07:30:45"
"8948","54","20150727100347","Shop","AAA05","9","540000","180000","360000","2015-07-27 22:03:47"
"8949","9","20150727061742","Mobile","AAA05","1","60000","20000","40000","2015-07-27 18:17:42"
"8950","70","20150727051434","Mobile","AAA04","5","40000","2000","38000","2015-07-27 17:14:34"
"8951","65","20150727033253","Shop","AAA01","3","30000","6000","24000","2015-07-27 15:32:53"
"8952","2","20150727021139","PC","AAA04","5","40000","2000","38000","2015-07-27 14:11:39"
"8953","99","20150727120823","PC","AAA03","3","51000","9000","42000","2015-07-27 12:08:23"
"8954","12","20150727095304","Shop","AAA02","2","30000","4600","25400","2015-07-27 09:53:04"
"8955","51","20150724124509","Mobile","AAA05","7","420000","140000","280000","2015-07-24 00:45:09"
"8956","96","20150723051906","Shop","AAA04","8","64000","3200","60800","2015-07-23 05:19:06"
"8957","14","20150722125621","PC","AAA01","5","50000","10000","40000","2015-07-22 12:56:21"
"8958","58","20150722085317","Mobile","AAA03","8","136000","24000","112000","2015-07-22 08:53:17"
"8959","66","20150722075625","PC","AAA04","4","32000","1600","30400","2015-07-22 07:56:25"
"8960","50","20150721021711","Mobile","AAA03","4","68000","12000","56000","2015-07-21 14:17:11"
"8961","11","20150721125633","Shop","AAA01","1","10000","2000","8000","2015-07-21 12:56:33"
"8962","14","20150721113503","PC","AAA01","4","40000","8000","32000","2015-07-21 11:35:03"
"8963","2","20150721100223","Shop","AAA04","4","32000","1600","30400","2015-07-21 10:02:23"
"8964","50","20150721075522","Shop","AAA03","3","51000","9000","42000","2015-07-21 07:55:22"
"8965","55","20150720092638","PC","AAA02","7","105000","16100","88900","2015-07-20 09:26:38"
"8966","22","20150719075627","PC","AAA02","4","60000","9200","50800","2015-07-19 07:56:27"
"8967","86","20150716020957","PC","AAA05","1","60000","20000","40000","2015-07-16 14:09:57"
"8968","22","20150716120237","PC","AAA05","6","360000","120000","240000","2015-07-16 12:02:37"
"8969","93","20150716110225","PC","AAA03","2","34000","6000","28000","2015-07-16 11:02:25"
"8970","48","20150716100107","PC","AAA02","1","15000","2300","12700","2015-07-16 10:01:07"
"8971","16","20150716084037","PC","AAA05","2","120000","40000","80000","2015-07-16 08:40:37"
"8972","72","20150716071708","PC","AAA01","1","10000","2000","8000","2015-07-16 07:17:08"
"8973","100","20150715115227","Mobile","AAA04","2","16000","800","15200","2015-07-15 23:52:27"
"8974","33","20150715041225","Shop","AAA02","3","45000","6900","38100","2015-07-15 16:12:25"
"8975","31","20150715023208","Mobile","AAA01","6","60000","12000","48000","2015-07-15 14:32:08"
"8976","15","20150715104825","Shop","AAA01","6","60000","12000","48000","2015-07-15 10:48:25"
"8977","62","20150715094834","Shop","AAA03","4","68000","12000","56000","2015-07-15 09:48:34"
"8978","14","20150715070133","Shop","AAA03","3","51000","9000","42000","2015-07-15 07:01:33"
"8979","54","20150714122007","PC","AAA01","4","40000","8000","32000","2015-07-14 12:20:07"
"8980","3","20150714110244","Shop","AAA05","5","300000","100000","200000","2015-07-14 11:02:44"
"8981","57","20150714103808","Mobile","AAA03","3","51000","9000","42000","2015-07-14 10:38:08"
"8982","81","20150714091412","PC","AAA03","2","34000","6000","28000","2015-07-14 09:14:12"
"8983","63","20150714080807","Mobile","AAA05","4","240000","80000","160000","2015-07-14 08:08:07"
"8984","86","20150714064955","Mobile","AAA02","3","45000","6900","38100","2015-07-14 06:49:55"
"8985","66","20150713102017","Shop","AAA04","7","56000","2800","53200","2015-07-13 22:20:17"
"8986","10","20150713065802","PC","AAA02","3","45000","6900","38100","2015-07-13 18:58:02"
"8987","25","20150713013335","Shop","AAA04","3","24000","1200","22800","2015-07-13 13:33:35"
"8988","71","20150713114122","PC","AAA02","3","45000","6900","38100","2015-07-13 11:41:22"
"8989","5","20150713095235","Shop","AAA01","9","90000","18000","72000","2015-07-13 09:52:35"
"8990","71","20150709080111","PC","AAA04","5","40000","2000","38000","2015-07-09 20:01:11"
"8991","34","20150709045848","PC","AAA02","1","15000","2300","12700","2015-07-09 16:58:48"
"8992","50","20150709033818","PC","AAA04","6","48000","2400","45600","2015-07-09 15:38:18"
"8993","12","20150709012254","Mobile","AAA05","2","120000","40000","80000","2015-07-09 13:22:54"
"8994","41","20150709110301","Mobile","AAA01","3","30000","6000","24000","2015-07-09 11:03:01"
"8995","41","20150709090013","Mobile","AAA02","2","30000","4600","25400","2015-07-09 09:00:13"
"8996","67","20150709061633","Shop","AAA02","5","75000","11500","63500","2015-07-09 06:16:33"
"8997","50","20150708034348","PC","AAA05","8","480000","160000","320000","2015-07-08 15:43:48"
"8998","71","20150708020325","Mobile","AAA01","3","30000","6000","24000","2015-07-08 14:03:25"
"8999","57","20150708111931","Mobile","AAA01","1","10000","2000","8000","2015-07-08 11:19:31"
"9000","86","20150708101751","Mobile","AAA01","2","20000","4000","16000","2015-07-08 10:17:51"
"9001","77","20150707054222","PC","AAA01","1","10000","2000","8000","2015-07-07 17:42:22"
"9002","70","20150707051825","PC","AAA05","8","480000","160000","320000","2015-07-07 17:18:25"
"9003","16","20150707030518","PC","AAA03","7","119000","21000","98000","2015-07-07 15:05:18"
"9004","10","20150707125131","Shop","AAA02","10","150000","23000","127000","2015-07-07 12:51:31"
"9005","16","20150707111632","PC","AAA04","1","8000","400","7600","2015-07-07 11:16:32"
"9006","57","20150707092642","Shop","AAA02","2","30000","4600","25400","2015-07-07 09:26:42"
"9007","36","20150707083016","PC","AAA04","1","8000","400","7600","2015-07-07 08:30:16"
"9008","15","20150706063100","Mobile","AAA01","10","100000","20000","80000","2015-07-06 18:31:00"
"9009","44","20150706013849","PC","AAA04","13","104000","5200","98800","2015-07-06 13:38:49"
"9010","86","20150706121000","PC","AAA01","3","30000","6000","24000","2015-07-06 12:10:00"
"9011","17","20150706101645","Shop","AAA01","4","40000","8000","32000","2015-07-06 10:16:45"
"9012","84","20150706092802","PC","AAA02","2","30000","4600","25400","2015-07-06 09:28:02"
"9013","44","20150702105604","Shop","AAA02","1","15000","2300","12700","2015-07-02 10:56:04"
"9014","29","20150702092736","Mobile","AAA05","3","180000","60000","120000","2015-07-02 09:27:36"
"9015","31","20150702074958","Mobile","AAA01","7","70000","14000","56000","2015-07-02 07:49:58"
"9016","92","20150701044357","Mobile","AAA05","2","120000","40000","80000","2015-07-01 16:43:57"
"9017","96","20150701030418","Shop","AAA05","5","300000","100000","200000","2015-07-01 15:04:18"
"9018","90","20150701122355","Mobile","AAA04","3","24000","1200","22800","2015-07-01 12:23:55"
"9019","98","20150701095653","Shop","AAA01","5","50000","10000","40000","2015-07-01 09:56:53"
"9020","91","20150701081741","Shop","AAA04","2","16000","800","15200","2015-07-01 08:17:41"
"9021","67","20150701072050","Shop","AAA05","6","360000","120000","240000","2015-07-01 07:20:50"
"9022","93","20150630065102","Mobile","AAA01","3","30000","6000","24000","2015-06-30 18:51:02"
"9023","11","20150630014700","Mobile","AAA03","5","85000","15000","70000","2015-06-30 13:47:00"
"9024","21","20150630121628","Shop","AAA04","5","40000","2000","38000","2015-06-30 12:16:28"
"9025","1","20150630112535","PC","AAA02","1","15000","2300","12700","2015-06-30 11:25:35"
"9026","50","20150630101632","PC","AAA03","6","102000","18000","84000","2015-06-30 10:16:32"
"9027","68","20150630093155","Mobile","AAA01","6","60000","12000","48000","2015-06-30 09:31:55"
"9028","49","20150630074637","Shop","AAA04","1","8000","400","7600","2015-06-30 07:46:37"
"9029","81","20150629125807","PC","AAA04","1","8000","400","7600","2015-06-29 12:58:07"
"9030","29","20150629113753","Shop","AAA05","5","300000","100000","200000","2015-06-29 11:37:53"
"9031","93","20150625014825","PC","AAA03","4","68000","12000","56000","2015-06-25 01:48:25"
"9032","38","20150623114905","PC","AAA05","6","360000","120000","240000","2015-06-23 11:49:05"
"9033","91","20150623101705","Mobile","AAA02","1","15000","2300","12700","2015-06-23 10:17:05"
"9034","83","20150623085956","Shop","AAA04","6","48000","2400","45600","2015-06-23 08:59:56"
"9035","42","20150623082802","Shop","AAA05","5","300000","100000","200000","2015-06-23 08:28:02"
"9036","41","20150623065404","Shop","AAA01","9","90000","18000","72000","2015-06-23 06:54:04"
"9037","25","20150623124922","Shop","AAA03","6","102000","18000","84000","2015-06-23 00:49:22"
"9038","17","20150622112153","PC","AAA03","1","17000","3000","14000","2015-06-22 11:21:53"
"9039","3","20150622103403","Mobile","AAA02","3","45000","6900","38100","2015-06-22 10:34:03"
"9040","1","20150622084727","Shop","AAA03","6","102000","18000","84000","2015-06-22 08:47:27"
"9041","44","20150619043228","PC","AAA03","4","68000","12000","56000","2015-06-19 04:32:28"
"9042","24","20150618035113","Shop","AAA02","2","30000","4600","25400","2015-06-18 15:51:13"
"9043","97","20150618014215","PC","AAA03","5","85000","15000","70000","2015-06-18 13:42:15"
"9044","42","20150618124844","PC","AAA02","2","30000","4600","25400","2015-06-18 12:48:44"
"9045","50","20150618111730","Shop","AAA03","2","34000","6000","28000","2015-06-18 11:17:30"
"9046","33","20150618093256","Mobile","AAA02","6","90000","13800","76200","2015-06-18 09:32:56"
"9047","3","20150618074419","Shop","AAA02","3","45000","6900","38100","2015-06-18 07:44:19"
"9048","66","20150617032005","Mobile","AAA04","5","40000","2000","38000","2015-06-17 15:20:05"
"9049","43","20150617012254","Mobile","AAA02","6","90000","13800","76200","2015-06-17 13:22:54"
"9050","16","20150617120336","Mobile","AAA03","15","255000","45000","210000","2015-06-17 12:03:36"
"9051","42","20150617095307","Mobile","AAA04","8","64000","3200","60800","2015-06-17 09:53:07"
"9052","28","20150617085752","PC","AAA02","4","60000","9200","50800","2015-06-17 08:57:52"
"9053","27","20150617064104","PC","AAA02","5","75000","11500","63500","2015-06-17 06:41:04"
"9054","69","20150616051147","Mobile","AAA02","4","60000","9200","50800","2015-06-16 17:11:47"
"9055","65","20150616030909","Shop","AAA04","6","48000","2400","45600","2015-06-16 15:09:09"
"9056","68","20150616015006","PC","AAA03","5","85000","15000","70000","2015-06-16 13:50:06"
"9057","57","20150616114231","Mobile","AAA04","4","32000","1600","30400","2015-06-16 11:42:31"
"9058","55","20150616095442","PC","AAA03","8","136000","24000","112000","2015-06-16 09:54:42"
"9059","11","20150616081706","Mobile","AAA02","3","45000","6900","38100","2015-06-16 08:17:06"
"9060","50","20150616071142","Mobile","AAA03","2","34000","6000","28000","2015-06-16 07:11:42"
"9061","71","20150615013346","Shop","AAA05","6","360000","120000","240000","2015-06-15 13:33:46"
"9062","30","20150615085707","Shop","AAA05","6","360000","120000","240000","2015-06-15 08:57:07"
"9063","27","20150613040208","PC","AAA05","10","600000","200000","400000","2015-06-13 04:02:08"
"9064","74","20150612034135","Shop","AAA01","4","40000","8000","32000","2015-06-12 03:41:35"
"9065","76","20150611104251","PC","AAA05","1","60000","20000","40000","2015-06-11 22:42:51"
"9066","62","20150611061659","Shop","AAA03","1","17000","3000","14000","2015-06-11 18:16:59"
"9067","39","20150611023736","Shop","AAA01","2","20000","4000","16000","2015-06-11 14:37:36"
"9068","100","20150611115922","Mobile","AAA05","4","240000","80000","160000","2015-06-11 11:59:22"
"9069","84","20150611094719","Shop","AAA03","3","51000","9000","42000","2015-06-11 09:47:19"
"9070","75","20150611075953","Shop","AAA05","1","60000","20000","40000","2015-06-11 07:59:53"
"9071","98","20150610043644","Shop","AAA04","1","8000","400","7600","2015-06-10 16:36:44"
"9072","7","20150610025546","Mobile","AAA04","3","24000","1200","22800","2015-06-10 14:55:46"
"9073","59","20150610012757","PC","AAA02","5","75000","11500","63500","2015-06-10 13:27:57"
"9074","64","20150610115823","PC","AAA05","2","120000","40000","80000","2015-06-10 11:58:23"
"9075","35","20150610101733","Shop","AAA01","6","60000","12000","48000","2015-06-10 10:17:33"
"9076","65","20150610081512","Mobile","AAA03","2","34000","6000","28000","2015-06-10 08:15:12"
"9077","93","20150610061356","Mobile","AAA04","4","32000","1600","30400","2015-06-10 06:13:56"
"9078","17","20150609104203","Shop","AAA02","8","120000","18400","101600","2015-06-09 10:42:03"
"9079","39","20150609084705","PC","AAA03","3","51000","9000","42000","2015-06-09 08:47:05"
"9080","28","20150609073644","Mobile","AAA05","8","480000","160000","320000","2015-06-09 07:36:44"
"9081","37","20150608065538","PC","AAA02","5","75000","11500","63500","2015-06-08 18:55:38"
"9082","77","20150608011933","Shop","AAA04","1","8000","400","7600","2015-06-08 13:19:33"
"9083","82","20150608122720","Mobile","AAA02","5","75000","11500","63500","2015-06-08 12:27:20"
"9084","71","20150608104439","Shop","AAA02","4","60000","9200","50800","2015-06-08 10:44:39"
"9085","93","20150608092359","Shop","AAA04","3","24000","1200","22800","2015-06-08 09:23:59"
"9086","79","20150604011306","Shop","AAA05","1","60000","20000","40000","2015-06-04 13:13:06"
"9087","59","20150604114507","PC","AAA05","3","180000","60000","120000","2015-06-04 11:45:07"
"9088","37","20150604102811","Shop","AAA03","5","85000","15000","70000","2015-06-04 10:28:11"
"9089","1","20150604084829","PC","AAA02","2","30000","4600","25400","2015-06-04 08:48:29"
"9090","78","20150604073204","Shop","AAA03","5","85000","15000","70000","2015-06-04 07:32:04"
"9091","95","20150603035745","Shop","AAA03","6","102000","18000","84000","2015-06-03 15:57:45"
"9092","68","20150603024250","PC","AAA05","2","120000","40000","80000","2015-06-03 14:42:50"
"9093","23","20150603011222","Shop","AAA02","1","15000","2300","12700","2015-06-03 13:12:22"
"9094","19","20150603110842","PC","AAA04","1","8000","400","7600","2015-06-03 11:08:42"
"9095","75","20150603090154","Shop","AAA03","7","119000","21000","98000","2015-06-03 09:01:54"
"9096","66","20150603082128","PC","AAA01","1","10000","2000","8000","2015-06-03 08:21:28"
"9097","73","20150602090029","Mobile","AAA03","4","68000","12000","56000","2015-06-02 21:00:29"
"9098","2","20150602022911","PC","AAA05","4","240000","80000","160000","2015-06-02 14:29:11"
"9099","46","20150602011500","Mobile","AAA05","2","120000","40000","80000","2015-06-02 13:15:00"
"9100","23","20150602105946","Mobile","AAA05","2","120000","40000","80000","2015-06-02 10:59:46"
"9101","9","20150602011715","PC","AAA03","4","68000","12000","56000","2015-06-02 01:17:15"
"9102","27","20150601124232","Shop","AAA03","13","221000","39000","182000","2015-06-01 12:42:32"
"9103","52","20150601115056","PC","AAA03","6","102000","18000","84000","2015-06-01 11:50:56"
"9104","14","20150601094819","Mobile","AAA03","1","17000","3000","14000","2015-06-01 09:48:19"
"9105","3","20150526074702","Shop","AAA01","9","90000","18000","72000","2015-05-26 19:47:02"
"9106","59","20150526020911","Mobile","AAA02","2","30000","4600","25400","2015-05-26 14:09:11"
"9107","98","20150526010031","Mobile","AAA05","2","120000","40000","80000","2015-05-26 13:00:31"
"9108","5","20150526112450","PC","AAA05","3","180000","60000","120000","2015-05-26 11:24:50"
"9109","87","20150526092729","Mobile","AAA01","4","40000","8000","32000","2015-05-26 09:27:29"
"9110","61","20150526070418","Mobile","AAA02","4","60000","9200","50800","2015-05-26 07:04:18"
"9111","32","20150526022816","PC","AAA03","4","68000","12000","56000","2015-05-26 02:28:16"
"9112","57","20150525032254","Shop","AAA04","1","8000","400","7600","2015-05-25 15:22:54"
"9113","55","20150525015327","Mobile","AAA04","5","40000","2000","38000","2015-05-25 13:53:27"
"9114","15","20150525122102","PC","AAA05","7","420000","140000","280000","2015-05-25 12:21:02"
"9115","73","20150525102750","PC","AAA05","4","240000","80000","160000","2015-05-25 10:27:50"
"9116","46","20150525080453","PC","AAA05","4","240000","80000","160000","2015-05-25 08:04:53"
"9117","41","20150523074102","PC","AAA05","3","180000","60000","120000","2015-05-23 07:41:02"
"9118","5","20150522074711","Mobile","AAA03","5","85000","15000","70000","2015-05-22 07:47:11"
"9119","36","20150521084046","Shop","AAA03","8","136000","24000","112000","2015-05-21 20:40:46"
"9120","13","20150521030852","PC","AAA04","1","8000","400","7600","2015-05-21 15:08:52"
"9121","27","20150521015509","Shop","AAA05","3","180000","60000","120000","2015-05-21 13:55:09"
"9122","79","20150521011853","PC","AAA04","5","40000","2000","38000","2015-05-21 13:18:53"
"9123","41","20150521122237","Shop","AAA04","4","32000","1600","30400","2015-05-21 12:22:37"
"9124","63","20150521112535","Mobile","AAA01","7","70000","14000","56000","2015-05-21 11:25:35"
"9125","51","20150521081642","Shop","AAA03","4","68000","12000","56000","2015-05-21 08:16:42"
"9126","96","20150521072130","Mobile","AAA01","1","10000","2000","8000","2015-05-21 07:21:30"
"9127","30","20150520030605","Mobile","AAA01","5","50000","10000","40000","2015-05-20 15:06:05"
"9128","28","20150520020242","PC","AAA04","11","88000","4400","83600","2015-05-20 14:02:42"
"9129","91","20150520123934","Mobile","AAA04","2","16000","800","15200","2015-05-20 12:39:34"
"9130","31","20150520115540","Shop","AAA02","4","60000","9200","50800","2015-05-20 11:55:40"
"9131","80","20150520105339","Mobile","AAA03","2","34000","6000","28000","2015-05-20 10:53:39"
"9132","58","20150520091332","Shop","AAA03","9","153000","27000","126000","2015-05-20 09:13:32"
"9133","49","20150520072344","Mobile","AAA05","3","180000","60000","120000","2015-05-20 07:23:44"
"9134","25","20150519063146","PC","AAA01","4","40000","8000","32000","2015-05-19 18:31:46"
"9135","30","20150519111106","PC","AAA04","2","16000","800","15200","2015-05-19 11:11:06"
"9136","83","20150518024016","Mobile","AAA05","2","120000","40000","80000","2015-05-18 14:40:16"
"9137","79","20150518124951","Shop","AAA03","1","17000","3000","14000","2015-05-18 12:49:51"
"9138","55","20150518114455","PC","AAA04","6","48000","2400","45600","2015-05-18 11:44:55"
"9139","10","20150518093252","PC","AAA03","10","170000","30000","140000","2015-05-18 09:32:52"
"9140","67","20150515114647","Shop","AAA01","9","90000","18000","72000","2015-05-15 23:46:47"
"9141","47","20150515074652","Shop","AAA01","7","70000","14000","56000","2015-05-15 07:46:52"
"9142","89","20150514101105","Shop","AAA04","13","104000","5200","98800","2015-05-14 22:11:05"
"9143","10","20150514044758","Mobile","AAA04","3","24000","1200","22800","2015-05-14 16:47:58"
"9144","34","20150514024124","PC","AAA03","4","68000","12000","56000","2015-05-14 14:41:24"
"9145","9","20150514125245","Shop","AAA04","4","32000","1600","30400","2015-05-14 12:52:45"
"9146","81","20150514110728","Mobile","AAA02","1","15000","2300","12700","2015-05-14 11:07:28"
"9147","29","20150514092516","Mobile","AAA05","13","780000","260000","520000","2015-05-14 09:25:16"
"9148","94","20150514071028","Shop","AAA03","10","170000","30000","140000","2015-05-14 07:10:28"
"9149","30","20150513063213","Mobile","AAA04","7","56000","2800","53200","2015-05-13 18:32:13"
"9150","64","20150513034100","Mobile","AAA05","9","540000","180000","360000","2015-05-13 15:41:00"
"9151","74","20150513014151","Shop","AAA03","1","17000","3000","14000","2015-05-13 13:41:51"
"9152","92","20150513120519","Mobile","AAA04","13","104000","5200","98800","2015-05-13 12:05:19"
"9153","4","20150513103413","Mobile","AAA05","4","240000","80000","160000","2015-05-13 10:34:13"
"9154","19","20150513093551","Shop","AAA02","3","45000","6900","38100","2015-05-13 09:35:51"
"9155","86","20150513080845","Shop","AAA01","1","10000","2000","8000","2015-05-13 08:08:45"
"9156","65","20150513064339","PC","AAA03","4","68000","12000","56000","2015-05-13 06:43:39"
"9157","54","20150512060220","Shop","AAA04","1","8000","400","7600","2015-05-12 18:02:20"
"9158","99","20150512014125","Shop","AAA04","3","24000","1200","22800","2015-05-12 13:41:25"
"9159","82","20150512103639","PC","AAA01","5","50000","10000","40000","2015-05-12 10:36:39"
"9160","27","20150512084456","Mobile","AAA04","10","80000","4000","76000","2015-05-12 08:44:56"
"9161","22","20150512073612","PC","AAA04","4","32000","1600","30400","2015-05-12 07:36:12"
"9162","54","20150511012232","PC","AAA05","2","120000","40000","80000","2015-05-11 13:22:32"
"9163","39","20150511113759","Shop","AAA02","7","105000","16100","88900","2015-05-11 11:37:59"
"9164","57","20150511111048","Shop","AAA02","3","45000","6900","38100","2015-05-11 11:10:48"
"9165","63","20150511100711","PC","AAA05","4","240000","80000","160000","2015-05-11 10:07:11"
"9166","11","20150511081555","Mobile","AAA03","3","51000","9000","42000","2015-05-11 08:15:55"
"9167","14","20150506065926","PC","AAA05","2","120000","40000","80000","2015-05-06 06:59:26"
"9168","68","20150505121600","Mobile","AAA03","1","17000","3000","14000","2015-05-05 12:16:00"
"9169","96","20150505111615","PC","AAA04","5","40000","2000","38000","2015-05-05 11:16:15"
"9170","3","20150505091900","Shop","AAA05","12","720000","240000","480000","2015-05-05 09:19:00"
"9171","24","20150505064420","PC","AAA05","7","420000","140000","280000","2015-05-05 06:44:20"
"9172","71","20150504061651","PC","AAA04","3","24000","1200","22800","2015-05-04 18:16:51"
"9173","79","20150504024639","Mobile","AAA03","6","102000","18000","84000","2015-05-04 14:46:39"
"9174","18","20150504011031","Mobile","AAA05","3","180000","60000","120000","2015-05-04 13:10:31"
"9175","42","20150504114851","PC","AAA03","11","187000","33000","154000","2015-05-04 11:48:51"
"9176","63","20150504095050","Shop","AAA01","1","10000","2000","8000","2015-05-04 09:50:50"
"9177","41","20150503125617","Mobile","AAA01","6","60000","12000","48000","2015-05-03 00:56:17"
"9178","41","20150430091929","Shop","AAA01","5","50000","10000","40000","2015-04-30 21:19:29"
"9179","80","20150430123252","Shop","AAA05","5","300000","100000","200000","2015-04-30 12:32:52"
"9180","88","20150430112908","Mobile","AAA04","2","16000","800","15200","2015-04-30 11:29:08"
"9181","18","20150430082049","Shop","AAA05","5","300000","100000","200000","2015-04-30 08:20:49"
"9182","81","20150430065719","Mobile","AAA05","1","60000","20000","40000","2015-04-30 06:57:19"
"9183","74","20150429093649","Shop","AAA01","4","40000","8000","32000","2015-04-29 21:36:49"
"9184","97","20150429073904","Shop","AAA03","5","85000","15000","70000","2015-04-29 19:39:04"
"9185","15","20150429032955","Shop","AAA02","4","60000","9200","50800","2015-04-29 15:29:55"
"9186","67","20150429020726","Mobile","AAA02","3","45000","6900","38100","2015-04-29 14:07:26"
"9187","65","20150429111957","Shop","AAA01","13","130000","26000","104000","2015-04-29 11:19:57"
"9188","90","20150429092545","Mobile","AAA02","3","45000","6900","38100","2015-04-29 09:25:45"
"9189","4","20150429073051","PC","AAA01","4","40000","8000","32000","2015-04-29 07:30:51"
"9190","79","20150428070114","Shop","AAA02","1","15000","2300","12700","2015-04-28 19:01:14"
"9191","31","20150428115315","Shop","AAA05","1","60000","20000","40000","2015-04-28 11:53:15"
"9192","1","20150428111940","Mobile","AAA04","5","40000","2000","38000","2015-04-28 11:19:40"
"9193","78","20150428085705","PC","AAA05","2","120000","40000","80000","2015-04-28 08:57:05"
"9194","34","20150428074437","Shop","AAA05","6","360000","120000","240000","2015-04-28 07:44:37"
"9195","94","20150427045124","Shop","AAA03","8","136000","24000","112000","2015-04-27 16:51:24"
"9196","14","20150427025932","PC","AAA04","2","16000","800","15200","2015-04-27 14:59:32"
"9197","20","20150427114958","Mobile","AAA05","3","180000","60000","120000","2015-04-27 11:49:58"
"9198","7","20150427103152","PC","AAA03","5","85000","15000","70000","2015-04-27 10:31:52"
"9199","100","20150427092432","Mobile","AAA05","6","360000","120000","240000","2015-04-27 09:24:32"
"9200","1","20150423061549","Shop","AAA05","9","540000","180000","360000","2015-04-23 18:15:49"
"9201","29","20150423120927","PC","AAA02","8","120000","18400","101600","2015-04-23 12:09:27"
"9202","7","20150423102338","PC","AAA02","3","45000","6900","38100","2015-04-23 10:23:38"
"9203","81","20150423092623","PC","AAA01","5","50000","10000","40000","2015-04-23 09:26:23"
"9204","21","20150423070216","Shop","AAA04","9","72000","3600","68400","2015-04-23 07:02:16"
"9205","20","20150422024045","PC","AAA04","1","8000","400","7600","2015-04-22 14:40:45"
"9206","13","20150422011236","Shop","AAA03","1","17000","3000","14000","2015-04-22 13:12:36"
"9207","43","20150422120146","PC","AAA04","3","24000","1200","22800","2015-04-22 12:01:46"
"9208","4","20150422095656","Mobile","AAA03","2","34000","6000","28000","2015-04-22 09:56:56"
"9209","100","20150422091950","Shop","AAA05","4","240000","80000","160000","2015-04-22 09:19:50"
"9210","45","20150422075429","Mobile","AAA05","2","120000","40000","80000","2015-04-22 07:54:29"
"9211","6","20150421094221","Mobile","AAA03","4","68000","12000","56000","2015-04-21 21:42:21"
"9212","19","20150421064303","Mobile","AAA02","5","75000","11500","63500","2015-04-21 18:43:03"
"9213","26","20150421035603","PC","AAA01","3","30000","6000","24000","2015-04-21 15:56:03"
"9214","64","20150421022135","Mobile","AAA02","9","135000","20700","114300","2015-04-21 14:21:35"
"9215","54","20150421124402","Shop","AAA02","7","105000","16100","88900","2015-04-21 12:44:02"
"9216","17","20150421113016","Mobile","AAA05","3","180000","60000","120000","2015-04-21 11:30:16"
"9217","15","20150421103702","Mobile","AAA03","15","255000","45000","210000","2015-04-21 10:37:02"
"9218","67","20150421083934","Mobile","AAA04","4","32000","1600","30400","2015-04-21 08:39:34"
"9219","1","20150421070106","PC","AAA04","2","16000","800","15200","2015-04-21 07:01:06"
"9220","8","20150420082012","Shop","AAA05","1","60000","20000","40000","2015-04-20 20:20:12"
"9221","68","20150420033751","Shop","AAA05","1","60000","20000","40000","2015-04-20 15:37:51"
"9222","66","20150420014553","PC","AAA04","4","32000","1600","30400","2015-04-20 13:45:53"
"9223","50","20150420121601","Shop","AAA04","12","96000","4800","91200","2015-04-20 12:16:01"
"9224","59","20150420121547","Mobile","AAA03","3","51000","9000","42000","2015-04-20 12:15:47"
"9225","44","20150420120205","Shop","AAA03","4","68000","12000","56000","2015-04-20 12:02:05"
"9226","55","20150420105713","Mobile","AAA03","5","85000","15000","70000","2015-04-20 10:57:13"
"9227","3","20150420095231","Mobile","AAA02","9","135000","20700","114300","2015-04-20 09:52:31"
"9228","48","20150414083935","PC","AAA04","5","40000","2000","38000","2015-04-14 20:39:35"
"9229","87","20150414032649","Shop","AAA04","2","16000","800","15200","2015-04-14 15:26:49"
"9230","83","20150414020338","Mobile","AAA02","13","195000","29900","165100","2015-04-14 14:03:38"
"9231","18","20150414123437","Shop","AAA03","2","34000","6000","28000","2015-04-14 12:34:37"
"9232","67","20150414102853","Mobile","AAA04","2","16000","800","15200","2015-04-14 10:28:53"
"9233","69","20150414091950","Mobile","AAA01","4","40000","8000","32000","2015-04-14 09:19:50"
"9234","85","20150414080444","PC","AAA02","3","45000","6900","38100","2015-04-14 08:04:44"
"9235","11","20150414053623","Shop","AAA03","6","102000","18000","84000","2015-04-14 05:36:23"
"9236","12","20150413022606","Shop","AAA01","2","20000","4000","16000","2015-04-13 14:26:06"
"9237","41","20150413123912","PC","AAA04","8","64000","3200","60800","2015-04-13 12:39:12"
"9238","38","20150413092856","PC","AAA02","9","135000","20700","114300","2015-04-13 09:28:56"
"9239","70","20150409094159","Shop","AAA05","7","420000","140000","280000","2015-04-09 09:41:59"
"9240","34","20150408050649","Shop","AAA02","6","90000","13800","76200","2015-04-08 17:06:49"
"9241","5","20150408041320","Mobile","AAA03","1","17000","3000","14000","2015-04-08 16:13:20"
"9242","3","20150408033055","Shop","AAA02","6","90000","13800","76200","2015-04-08 15:30:55"
"9243","49","20150408011803","PC","AAA05","6","360000","120000","240000","2015-04-08 13:18:03"
"9244","8","20150408084709","Mobile","AAA01","2","20000","4000","16000","2015-04-08 08:47:09"
"9245","47","20150408074939","Shop","AAA03","1","17000","3000","14000","2015-04-08 07:49:39"
"9246","29","20150407115656","Shop","AAA01","2","20000","4000","16000","2015-04-07 11:56:56"
"9247","1","20150407095823","Shop","AAA01","6","60000","12000","48000","2015-04-07 09:58:23"
"9248","81","20150407075409","Shop","AAA03","6","102000","18000","84000","2015-04-07 07:54:09"
"9249","5","20150406065812","Mobile","AAA04","4","32000","1600","30400","2015-04-06 18:58:12"
"9250","12","20150406032908","Shop","AAA02","2","30000","4600","25400","2015-04-06 15:29:08"
"9251","31","20150406014428","PC","AAA03","1","17000","3000","14000","2015-04-06 13:44:28"
"9252","67","20150406125551","Shop","AAA04","13","104000","5200","98800","2015-04-06 12:55:51"
"9253","58","20150406105428","Shop","AAA02","7","105000","16100","88900","2015-04-06 10:54:28"
"9254","16","20150406084438","Mobile","AAA02","6","90000","13800","76200","2015-04-06 08:44:38"
"9255","97","20150401023811","PC","AAA03","5","85000","15000","70000","2015-04-01 14:38:11"
"9256","84","20150401010758","PC","AAA04","3","24000","1200","22800","2015-04-01 13:07:58"
"9257","15","20150401111715","Mobile","AAA03","1","17000","3000","14000","2015-04-01 11:17:15"
"9258","69","20150401093730","Mobile","AAA05","2","120000","40000","80000","2015-04-01 09:37:30"
"9259","36","20150401074747","PC","AAA02","9","135000","20700","114300","2015-04-01 07:47:47"
"9260","60","20150331012403","Mobile","AAA04","3","24000","1200","22800","2015-03-31 13:24:03"
"9261","65","20150331104000","Shop","AAA01","6","60000","12000","48000","2015-03-31 10:40:00"
"9262","62","20150331083657","Shop","AAA04","5","40000","2000","38000","2015-03-31 08:36:57"
"9263","14","20150331060140","Mobile","AAA05","1","60000","20000","40000","2015-03-31 06:01:40"
"9264","68","20150331052402","PC","AAA01","1","10000","2000","8000","2015-03-31 05:24:02"
"9265","90","20150330074432","Mobile","AAA04","1","8000","400","7600","2015-03-30 07:44:32"
"9266","88","20150326064732","Shop","AAA05","1","60000","20000","40000","2015-03-26 06:47:32"
"9267","64","20150325013903","PC","AAA01","3","30000","6000","24000","2015-03-25 13:39:03"
"9268","86","20150325125410","Shop","AAA04","3","24000","1200","22800","2015-03-25 12:54:10"
"9269","40","20150325112337","Mobile","AAA02","5","75000","11500","63500","2015-03-25 11:23:37"
"9270","89","20150325092947","Shop","AAA03","12","204000","36000","168000","2015-03-25 09:29:47"
"9271","47","20150325084058","PC","AAA04","3","24000","1200","22800","2015-03-25 08:40:58"
"9272","31","20150325072233","Shop","AAA03","3","51000","9000","42000","2015-03-25 07:22:33"
"9273","43","20150324095902","Mobile","AAA03","8","136000","24000","112000","2015-03-24 21:59:02"
"9274","49","20150324064908","PC","AAA05","10","600000","200000","400000","2015-03-24 18:49:08"
"9275","48","20150324031520","PC","AAA03","2","34000","6000","28000","2015-03-24 15:15:20"
"9276","67","20150324011821","PC","AAA05","6","360000","120000","240000","2015-03-24 13:18:21"
"9277","70","20150324114824","PC","AAA05","5","300000","100000","200000","2015-03-24 11:48:24"
"9278","24","20150324110309","Mobile","AAA04","4","32000","1600","30400","2015-03-24 11:03:09"
"9279","59","20150324091943","PC","AAA05","3","180000","60000","120000","2015-03-24 09:19:43"
"9280","52","20150324074930","PC","AAA03","3","51000","9000","42000","2015-03-24 07:49:30"
"9281","5","20150323070723","PC","AAA03","7","119000","21000","98000","2015-03-23 19:07:23"
"9282","32","20150323050844","Shop","AAA04","13","104000","5200","98800","2015-03-23 17:08:44"
"9283","50","20150323032925","Mobile","AAA05","8","480000","160000","320000","2015-03-23 15:29:25"
"9284","20","20150323095933","Shop","AAA04","4","32000","1600","30400","2015-03-23 09:59:33"
"9285","61","20150320081631","PC","AAA04","3","24000","1200","22800","2015-03-20 08:16:31"
"9286","41","20150319104701","Mobile","AAA03","5","85000","15000","70000","2015-03-19 10:47:01"
"9287","70","20150319092950","PC","AAA05","11","660000","220000","440000","2015-03-19 09:29:50"
"9288","3","20150319055105","Mobile","AAA02","10","150000","23000","127000","2015-03-19 05:51:05"
"9289","81","20150318044536","PC","AAA04","3","24000","1200","22800","2015-03-18 16:45:36"
"9290","91","20150318030734","PC","AAA04","2","16000","800","15200","2015-03-18 15:07:34"
"9291","73","20150318023231","Shop","AAA05","8","480000","160000","320000","2015-03-18 14:32:31"
"9292","97","20150318012038","Shop","AAA04","4","32000","1600","30400","2015-03-18 13:20:38"
"9293","97","20150318124215","Shop","AAA02","7","105000","16100","88900","2015-03-18 12:42:15"
"9294","74","20150318105321","PC","AAA04","1","8000","400","7600","2015-03-18 10:53:21"
"9295","94","20150318091330","Mobile","AAA03","3","51000","9000","42000","2015-03-18 09:13:30"
"9296","94","20150318072655","PC","AAA04","8","64000","3200","60800","2015-03-18 07:26:55"
"9297","55","20150317061606","Mobile","AAA03","2","34000","6000","28000","2015-03-17 18:16:06"
"9298","13","20150317124603","Mobile","AAA01","3","30000","6000","24000","2015-03-17 12:46:03"
"9299","12","20150317110809","PC","AAA02","1","15000","2300","12700","2015-03-17 11:08:09"
"9300","41","20150317091127","Shop","AAA04","5","40000","2000","38000","2015-03-17 09:11:27"
"9301","57","20150317075458","PC","AAA01","3","30000","6000","24000","2015-03-17 07:54:58"
"9302","78","20150316102035","PC","AAA01","2","20000","4000","16000","2015-03-16 22:20:35"
"9303","37","20150316045656","Mobile","AAA05","3","180000","60000","120000","2015-03-16 16:56:56"
"9304","26","20150316040003","Mobile","AAA03","1","17000","3000","14000","2015-03-16 16:00:03"
"9305","42","20150316031043","PC","AAA02","9","135000","20700","114300","2015-03-16 15:10:43"
"9306","92","20150316112039","Mobile","AAA02","4","60000","9200","50800","2015-03-16 11:20:39"
"9307","89","20150316105925","Mobile","AAA04","8","64000","3200","60800","2015-03-16 10:59:25"
"9308","50","20150316095809","PC","AAA01","3","30000","6000","24000","2015-03-16 09:58:09"
"9309","54","20150313041058","Shop","AAA02","6","90000","13800","76200","2015-03-13 04:10:58"
"9310","59","20150312011719","Shop","AAA05","2","120000","40000","80000","2015-03-12 13:17:19"
"9311","66","20150312121808","PC","AAA02","3","45000","6900","38100","2015-03-12 12:18:08"
"9312","52","20150312102803","Mobile","AAA05","2","120000","40000","80000","2015-03-12 10:28:03"
"9313","76","20150312101338","PC","AAA05","5","300000","100000","200000","2015-03-12 10:13:38"
"9314","4","20150312081213","PC","AAA01","6","60000","12000","48000","2015-03-12 08:12:13"
"9315","87","20150312062559","Mobile","AAA01","4","40000","8000","32000","2015-03-12 06:25:59"
"9316","80","20150311121804","Mobile","AAA02","5","75000","11500","63500","2015-03-11 12:18:04"
"9317","97","20150311112211","PC","AAA01","3","30000","6000","24000","2015-03-11 11:22:11"
"9318","84","20150311081239","Shop","AAA01","2","20000","4000","16000","2015-03-11 08:12:39"
"9319","60","20150311071328","Mobile","AAA01","4","40000","8000","32000","2015-03-11 07:13:28"
"9320","23","20150310122309","Shop","AAA04","6","48000","2400","45600","2015-03-10 12:23:09"
"9321","71","20150310083423","PC","AAA04","1","8000","400","7600","2015-03-10 08:34:23"
"9322","82","20150310060137","Mobile","AAA02","5","75000","11500","63500","2015-03-10 06:01:37"
"9323","61","20150309104717","Mobile","AAA05","3","180000","60000","120000","2015-03-09 22:47:17"
"9324","83","20150309033922","Mobile","AAA04","9","72000","3600","68400","2015-03-09 15:39:22"
"9325","80","20150309013142","Shop","AAA04","3","24000","1200","22800","2015-03-09 13:31:42"
"9326","78","20150309112021","Mobile","AAA03","4","68000","12000","56000","2015-03-09 11:20:21"
"9327","77","20150309081810","PC","AAA01","3","30000","6000","24000","2015-03-09 08:18:10"
"9328","19","20150305093916","PC","AAA04","4","32000","1600","30400","2015-03-05 21:39:16"
"9329","15","20150305042605","PC","AAA03","11","187000","33000","154000","2015-03-05 16:26:05"
"9330","40","20150305030403","Mobile","AAA05","1","60000","20000","40000","2015-03-05 15:04:03"
"9331","33","20150305015115","PC","AAA02","1","15000","2300","12700","2015-03-05 13:51:15"
"9332","62","20150305103543","Mobile","AAA04","10","80000","4000","76000","2015-03-05 10:35:43"
"9333","99","20150305094716","PC","AAA03","5","85000","15000","70000","2015-03-05 09:47:16"
"9334","42","20150305063447","Shop","AAA03","2","34000","6000","28000","2015-03-05 06:34:47"
"9335","56","20150304093105","PC","AAA02","11","165000","25300","139700","2015-03-04 21:31:05"
"9336","30","20150304011710","Shop","AAA05","1","60000","20000","40000","2015-03-04 13:17:10"
"9337","76","20150304104412","Mobile","AAA01","1","10000","2000","8000","2015-03-04 10:44:12"
"9338","20","20150304092541","Shop","AAA02","8","120000","18400","101600","2015-03-04 09:25:41"
"9339","32","20150304084402","Shop","AAA03","7","119000","21000","98000","2015-03-04 08:44:02"
"9340","13","20150304062837","Shop","AAA02","4","60000","9200","50800","2015-03-04 06:28:37"
"9341","73","20150303033820","Shop","AAA03","4","68000","12000","56000","2015-03-03 15:38:20"
"9342","79","20150303020103","Mobile","AAA03","1","17000","3000","14000","2015-03-03 14:01:03"
"9343","39","20150303121817","Mobile","AAA04","8","64000","3200","60800","2015-03-03 12:18:17"
"9344","34","20150303111052","Mobile","AAA01","9","90000","18000","72000","2015-03-03 11:10:52"
"9345","68","20150303094034","Shop","AAA01","3","30000","6000","24000","2015-03-03 09:40:34"
"9346","96","20150303074930","Mobile","AAA03","3","51000","9000","42000","2015-03-03 07:49:30"
"9347","97","20150303025306","Shop","AAA04","3","24000","1200","22800","2015-03-03 02:53:06"
"9348","60","20150303010005","Shop","AAA01","3","30000","6000","24000","2015-03-03 01:00:05"
"9349","69","20150302120546","PC","AAA04","3","24000","1200","22800","2015-03-02 12:05:46"
"9350","64","20150302104957","Mobile","AAA05","5","300000","100000","200000","2015-03-02 10:49:57"
"9351","94","20150228015542","Shop","AAA05","7","420000","140000","280000","2015-02-28 01:55:42"
"9352","7","20150227064905","Shop","AAA02","1","15000","2300","12700","2015-02-27 06:49:05"
"9353","6","20150226042922","PC","AAA05","6","360000","120000","240000","2015-02-26 16:29:22"
"9354","10","20150226035855","Mobile","AAA01","4","40000","8000","32000","2015-02-26 15:58:55"
"9355","19","20150226015059","Mobile","AAA02","1","15000","2300","12700","2015-02-26 13:50:59"
"9356","87","20150226122852","Shop","AAA04","6","48000","2400","45600","2015-02-26 12:28:52"
"9357","53","20150226110817","Mobile","AAA05","4","240000","80000","160000","2015-02-26 11:08:17"
"9358","79","20150226103804","Mobile","AAA02","1","15000","2300","12700","2015-02-26 10:38:04"
"9359","88","20150226074828","PC","AAA05","3","180000","60000","120000","2015-02-26 07:48:28"
"9360","51","20150225084511","PC","AAA04","3","24000","1200","22800","2015-02-25 20:45:11"
"9361","44","20150225024008","Shop","AAA02","3","45000","6900","38100","2015-02-25 14:40:08"
"9362","94","20150225125256","PC","AAA05","3","180000","60000","120000","2015-02-25 12:52:56"
"9363","83","20150225112759","Shop","AAA01","5","50000","10000","40000","2015-02-25 11:27:59"
"9364","42","20150225105113","PC","AAA02","3","45000","6900","38100","2015-02-25 10:51:13"
"9365","20","20150225070911","Mobile","AAA03","7","119000","21000","98000","2015-02-25 07:09:11"
"9366","27","20150224105619","PC","AAA04","4","32000","1600","30400","2015-02-24 10:56:19"
"9367","36","20150224091709","PC","AAA03","5","85000","15000","70000","2015-02-24 09:17:09"
"9368","83","20150224082032","Shop","AAA04","11","88000","4400","83600","2015-02-24 08:20:32"
"9369","78","20150224074428","PC","AAA03","5","85000","15000","70000","2015-02-24 07:44:28"
"9370","69","20150223101425","PC","AAA04","4","32000","1600","30400","2015-02-23 22:14:25"
"9371","95","20150223043907","PC","AAA01","5","50000","10000","40000","2015-02-23 16:39:07"
"9372","92","20150223032552","Shop","AAA03","1","17000","3000","14000","2015-02-23 15:25:52"
"9373","3","20150223013236","Mobile","AAA04","5","40000","2000","38000","2015-02-23 13:32:36"
"9374","52","20150223115627","Shop","AAA05","1","60000","20000","40000","2015-02-23 11:56:27"
"9375","74","20150223095623","Shop","AAA01","1","10000","2000","8000","2015-02-23 09:56:23"
"9376","17","20150218013119","Mobile","AAA01","1","10000","2000","8000","2015-02-18 13:31:19"
"9377","70","20150218124112","Shop","AAA02","13","195000","29900","165100","2015-02-18 12:41:12"
"9378","76","20150218105001","Shop","AAA05","3","180000","60000","120000","2015-02-18 10:50:01"
"9379","50","20150218094859","PC","AAA02","3","45000","6900","38100","2015-02-18 09:48:59"
"9380","19","20150218080843","PC","AAA01","2","20000","4000","16000","2015-02-18 08:08:43"
"9381","81","20150217101409","PC","AAA01","1","10000","2000","8000","2015-02-17 10:14:09"
"9382","47","20150217090347","PC","AAA03","1","17000","3000","14000","2015-02-17 09:03:47"
"9383","37","20150217082506","Mobile","AAA02","3","45000","6900","38100","2015-02-17 08:25:06"
"9384","85","20150216115532","Mobile","AAA05","9","540000","180000","360000","2015-02-16 23:55:32"
"9385","35","20150216032305","Mobile","AAA04","1","8000","400","7600","2015-02-16 03:23:05"
"9386","11","20150213121104","Shop","AAA04","4","32000","1600","30400","2015-02-13 00:11:04"
"9387","65","20150212015656","PC","AAA04","10","80000","4000","76000","2015-02-12 01:56:56"
"9388","60","20150211024501","Shop","AAA03","1","17000","3000","14000","2015-02-11 14:45:01"
"9389","90","20150211124955","Shop","AAA05","1","60000","20000","40000","2015-02-11 12:49:55"
"9390","5","20150211113148","Shop","AAA01","5","50000","10000","40000","2015-02-11 11:31:48"
"9391","63","20150211103941","PC","AAA05","1","60000","20000","40000","2015-02-11 10:39:41"
"9392","30","20150211100357","PC","AAA02","1","15000","2300","12700","2015-02-11 10:03:57"
"9393","30","20150211082544","Shop","AAA04","2","16000","800","15200","2015-02-11 08:25:44"
"9394","48","20150211073115","Shop","AAA01","6","60000","12000","48000","2015-02-11 07:31:15"
"9395","70","20150210095614","Mobile","AAA01","4","40000","8000","32000","2015-02-10 09:56:14"
"9396","74","20150210083251","PC","AAA03","1","17000","3000","14000","2015-02-10 08:32:51"
"9397","45","20150210063116","PC","AAA01","1","10000","2000","8000","2015-02-10 06:31:16"
"9398","11","20150209095507","PC","AAA01","1","10000","2000","8000","2015-02-09 09:55:07"
"9399","37","20150202082443","PC","AAA01","4","40000","8000","32000","2015-02-02 20:24:43"
"9400","76","20150202042945","Shop","AAA03","3","51000","9000","42000","2015-02-02 16:29:45"
"9401","70","20150202032355","Mobile","AAA03","4","68000","12000","56000","2015-02-02 15:23:55"
"9402","12","20150202014716","Shop","AAA02","1","15000","2300","12700","2015-02-02 13:47:16"
"9403","27","20150202122417","PC","AAA03","1","17000","3000","14000","2015-02-02 12:24:17"
"9404","41","20150202110458","Shop","AAA02","6","90000","13800","76200","2015-02-02 11:04:58"
"9405","5","20150130123816","PC","AAA03","8","136000","24000","112000","2015-01-30 00:38:16"
"9406","97","20150129021307","PC","AAA05","4","240000","80000","160000","2015-01-29 14:13:07"
"9407","93","20150129122942","PC","AAA05","3","180000","60000","120000","2015-01-29 12:29:42"
"9408","92","20150129104404","Shop","AAA04","7","56000","2800","53200","2015-01-29 10:44:04"
"9409","60","20150129092302","Mobile","AAA04","4","32000","1600","30400","2015-01-29 09:23:02"
"9410","46","20150129080853","PC","AAA05","1","60000","20000","40000","2015-01-29 08:08:53"
"9411","86","20150129055024","Mobile","AAA05","2","120000","40000","80000","2015-01-29 05:50:24"
"9412","12","20150128014954","PC","AAA01","4","40000","8000","32000","2015-01-28 13:49:54"
"9413","10","20150128115758","PC","AAA01","4","40000","8000","32000","2015-01-28 11:57:58"
"9414","79","20150128093937","Mobile","AAA01","4","40000","8000","32000","2015-01-28 09:39:37"
"9415","24","20150128062106","Mobile","AAA03","1","17000","3000","14000","2015-01-28 06:21:06"
"9416","63","20150127052338","Mobile","AAA02","2","30000","4600","25400","2015-01-27 17:23:38"
"9417","74","20150127043903","PC","AAA05","2","120000","40000","80000","2015-01-27 16:39:03"
"9418","79","20150127024335","Shop","AAA01","1","10000","2000","8000","2015-01-27 14:43:35"
"9419","4","20150127011357","Shop","AAA01","1","10000","2000","8000","2015-01-27 13:13:57"
"9420","49","20150127121039","Shop","AAA05","15","900000","300000","600000","2015-01-27 12:10:39"
"9421","17","20150127102324","Shop","AAA04","3","24000","1200","22800","2015-01-27 10:23:24"
"9422","48","20150127085907","Shop","AAA01","2","20000","4000","16000","2015-01-27 08:59:07"
"9423","13","20150127075821","Shop","AAA04","5","40000","2000","38000","2015-01-27 07:58:21"
"9424","56","20150127120911","Mobile","AAA03","4","68000","12000","56000","2015-01-27 00:09:11"
"9425","59","20150126110947","Mobile","AAA04","1","8000","400","7600","2015-01-26 11:09:47"
"9426","95","20150126094539","Mobile","AAA02","2","30000","4600","25400","2015-01-26 09:45:39"
"9427","32","20150120052936","Mobile","AAA01","14","140000","28000","112000","2015-01-20 17:29:36"
"9428","4","20150120041302","Mobile","AAA02","2","30000","4600","25400","2015-01-20 16:13:02"
"9429","72","20150120024439","PC","AAA05","2","120000","40000","80000","2015-01-20 14:44:39"
"9430","27","20150120123442","Shop","AAA05","3","180000","60000","120000","2015-01-20 12:34:42"
"9431","75","20150120094829","Shop","AAA01","2","20000","4000","16000","2015-01-20 09:48:29"
"9432","71","20150120091949","Shop","AAA01","6","60000","12000","48000","2015-01-20 09:19:49"
"9433","61","20150120065507","Shop","AAA03","5","85000","15000","70000","2015-01-20 06:55:07"
"9434","61","20150119112704","Shop","AAA02","2","30000","4600","25400","2015-01-19 23:27:04"
"9435","29","20150119093121","PC","AAA04","9","72000","3600","68400","2015-01-19 09:31:21"
"9436","75","20150114121224","PC","AAA04","4","32000","1600","30400","2015-01-14 12:12:24"
"9437","54","20150114103915","Mobile","AAA03","8","136000","24000","112000","2015-01-14 10:39:15"
"9438","98","20150114084844","Shop","AAA05","2","120000","40000","80000","2015-01-14 08:48:44"
"9439","85","20150114075018","Mobile","AAA04","3","24000","1200","22800","2015-01-14 07:50:18"
"9440","11","20150113075823","PC","AAA02","2","30000","4600","25400","2015-01-13 19:58:23"
"9441","92","20150113022230","Shop","AAA03","3","51000","9000","42000","2015-01-13 14:22:30"
"9442","27","20150113012113","Mobile","AAA05","3","180000","60000","120000","2015-01-13 13:21:13"
"9443","59","20150113114312","Shop","AAA02","2","30000","4600","25400","2015-01-13 11:43:12"
"9444","94","20150113102425","PC","AAA04","5","40000","2000","38000","2015-01-13 10:24:25"
"9445","68","20150113082329","PC","AAA02","7","105000","16100","88900","2015-01-13 08:23:29"
"9446","8","20150112123709","Mobile","AAA03","1","17000","3000","14000","2015-01-12 12:37:09"
"9447","75","20150112112123","Mobile","AAA05","3","180000","60000","120000","2015-01-12 11:21:23"
"9448","38","20150112095951","PC","AAA02","2","30000","4600","25400","2015-01-12 09:59:51"
"9449","34","20150108062451","Mobile","AAA02","1","15000","2300","12700","2015-01-08 06:24:51"
"9450","49","20150107055533","Mobile","AAA01","7","70000","14000","56000","2015-01-07 17:55:33"
"9451","87","20150107050547","PC","AAA02","2","30000","4600","25400","2015-01-07 17:05:47"
"9452","44","20150107034152","Mobile","AAA02","8","120000","18400","101600","2015-01-07 15:41:52"
"9453","95","20150107021833","PC","AAA04","1","8000","400","7600","2015-01-07 14:18:33"
"9454","74","20150107125739","Shop","AAA05","4","240000","80000","160000","2015-01-07 12:57:39"
"9455","26","20150107095721","Shop","AAA02","4","60000","9200","50800","2015-01-07 09:57:21"
"9456","45","20150107062624","Shop","AAA04","2","16000","800","15200","2015-01-07 06:26:24"
"9457","97","20150106015420","PC","AAA02","1","15000","2300","12700","2015-01-06 13:54:20"
"9458","60","20150106114959","PC","AAA03","3","51000","9000","42000","2015-01-06 11:49:59"
"9459","91","20150106104554","PC","AAA01","6","60000","12000","48000","2015-01-06 10:45:54"
"9460","36","20150106094826","PC","AAA05","12","720000","240000","480000","2015-01-06 09:48:26"
"9461","7","20150105121603","Shop","AAA01","5","50000","10000","40000","2015-01-05 12:16:03"
"9462","78","20150105110148","Mobile","AAA03","1","17000","3000","14000","2015-01-05 11:01:48"
"9463","77","20150105100911","PC","AAA02","1","15000","2300","12700","2015-01-05 10:09:11"
"9464","81","20150105073108","Mobile","AAA03","5","85000","15000","70000","2015-01-05 07:31:08"
"9465","49","20150101024626","Shop","AAA04","12","96000","4800","91200","2015-01-01 14:46:26"
"9466","55","20150101125400","Shop","AAA05","5","300000","100000","200000","2015-01-01 12:54:00"
"9467","15","20150101122149","Mobile","AAA04","3","24000","1200","22800","2015-01-01 12:21:49"
"9468","18","20150101114838","PC","AAA05","1","60000","20000","40000","2015-01-01 11:48:38"
"9469","6","20150101100614","PC","AAA05","1","60000","20000","40000","2015-01-01 10:06:14"
"9470","99","20141231074106","Shop","AAA01","3","30000","6000","24000","2014-12-31 07:41:06"
"9471","12","20141230102503","Shop","AAA05","1","60000","20000","40000","2014-12-30 22:25:03"
"9472","72","20141230052306","PC","AAA02","5","75000","11500","63500","2014-12-30 17:23:06"
"9473","18","20141230043626","Shop","AAA03","1","17000","3000","14000","2014-12-30 16:36:26"
"9474","71","20141230010444","Shop","AAA02","2","30000","4600","25400","2014-12-30 13:04:44"
"9475","87","20141230104851","Mobile","AAA02","1","15000","2300","12700","2014-12-30 10:48:51"
"9476","20","20141230090107","Shop","AAA04","1","8000","400","7600","2014-12-30 09:01:07"
"9477","48","20141230070745","Shop","AAA02","3","45000","6900","38100","2014-12-30 07:07:45"
"9478","87","20141229042144","Mobile","AAA01","3","30000","6000","24000","2014-12-29 16:21:44"
"9479","76","20141229023315","PC","AAA04","7","56000","2800","53200","2014-12-29 14:33:15"
"9480","2","20141229013501","Shop","AAA03","3","51000","9000","42000","2014-12-29 13:35:01"
"9481","25","20141229115541","Mobile","AAA03","7","119000","21000","98000","2014-12-29 11:55:41"
"9482","80","20141229085622","Shop","AAA04","5","40000","2000","38000","2014-12-29 08:56:22"
"9483","76","20141225043035","Shop","AAA01","1","10000","2000","8000","2014-12-25 04:30:35"
"9484","78","20141224034202","PC","AAA01","1","10000","2000","8000","2014-12-24 15:42:02"
"9485","68","20141224025157","Mobile","AAA05","3","180000","60000","120000","2014-12-24 14:51:57"
"9486","39","20141224121126","Shop","AAA04","8","64000","3200","60800","2014-12-24 12:11:26"
"9487","19","20141224082907","Shop","AAA01","3","30000","6000","24000","2014-12-24 08:29:07"
"9488","38","20141224074627","PC","AAA05","6","360000","120000","240000","2014-12-24 07:46:27"
"9489","6","20141223012654","PC","AAA03","1","17000","3000","14000","2014-12-23 13:26:54"
"9490","34","20141223114016","Shop","AAA03","1","17000","3000","14000","2014-12-23 11:40:16"
"9491","52","20141223101934","PC","AAA05","1","60000","20000","40000","2014-12-23 10:19:34"
"9492","72","20141223081410","Mobile","AAA05","5","300000","100000","200000","2014-12-23 08:14:10"
"9493","80","20141223072839","PC","AAA04","1","8000","400","7600","2014-12-23 07:28:39"
"9494","91","20141222080050","Mobile","AAA03","4","68000","12000","56000","2014-12-22 20:00:50"
"9495","78","20141222101928","Shop","AAA02","1","15000","2300","12700","2014-12-22 10:19:28"
"9496","54","20141222085301","Shop","AAA02","5","75000","11500","63500","2014-12-22 08:53:01"
"9497","78","20141217092008","PC","AAA03","1","17000","3000","14000","2014-12-17 21:20:08"
"9498","50","20141217031924","Mobile","AAA05","8","480000","160000","320000","2014-12-17 15:19:24"
"9499","4","20141217112021","Shop","AAA02","1","15000","2300","12700","2014-12-17 11:20:21"
"9500","100","20141217094929","Shop","AAA04","1","8000","400","7600","2014-12-17 09:49:29"
"9501","21","20141217084116","Shop","AAA02","5","75000","11500","63500","2014-12-17 08:41:16"
"9502","26","20141217071127","PC","AAA05","3","180000","60000","120000","2014-12-17 07:11:27"
"9503","100","20141216084056","Mobile","AAA02","3","45000","6900","38100","2014-12-16 20:40:56"
"9504","93","20141216040121","Shop","AAA03","1","17000","3000","14000","2014-12-16 16:01:21"
"9505","27","20141216030922","PC","AAA03","4","68000","12000","56000","2014-12-16 15:09:22"
"9506","12","20141216020801","PC","AAA05","5","300000","100000","200000","2014-12-16 14:08:01"
"9507","25","20141216122024","Shop","AAA02","4","60000","9200","50800","2014-12-16 12:20:24"
"9508","10","20141216094055","Shop","AAA05","2","120000","40000","80000","2014-12-16 09:40:55"
"9509","13","20141216082650","Mobile","AAA02","1","15000","2300","12700","2014-12-16 08:26:50"
"9510","32","20141215043312","Mobile","AAA02","3","45000","6900","38100","2014-12-15 16:33:12"
"9511","42","20141215023853","Shop","AAA03","4","68000","12000","56000","2014-12-15 14:38:53"
"9512","18","20141215124800","PC","AAA04","5","40000","2000","38000","2014-12-15 12:48:00"
"9513","43","20141215112243","PC","AAA01","6","60000","12000","48000","2014-12-15 11:22:43"
"9514","5","20141215092655","Mobile","AAA03","6","102000","18000","84000","2014-12-15 09:26:55"
"9515","85","20141212012851","PC","AAA02","7","105000","16100","88900","2014-12-12 01:28:51"
"9516","7","20141211104007","Shop","AAA01","8","80000","16000","64000","2014-12-11 10:40:07"
"9517","86","20141211084512","Mobile","AAA02","2","30000","4600","25400","2014-12-11 08:45:12"
"9518","53","20141211065929","Shop","AAA04","2","16000","800","15200","2014-12-11 06:59:29"
"9519","35","20141210055836","PC","AAA02","3","45000","6900","38100","2014-12-10 17:58:36"
"9520","72","20141210045326","PC","AAA03","3","51000","9000","42000","2014-12-10 16:53:26"
"9521","23","20141210035957","Mobile","AAA02","5","75000","11500","63500","2014-12-10 15:59:57"
"9522","35","20141210024040","PC","AAA02","4","60000","9200","50800","2014-12-10 14:40:40"
"9523","45","20141210013212","Mobile","AAA03","3","51000","9000","42000","2014-12-10 13:32:12"
"9524","3","20141210113940","Shop","AAA02","6","90000","13800","76200","2014-12-10 11:39:40"
"9525","47","20141210095233","Mobile","AAA01","4","40000","8000","32000","2014-12-10 09:52:33"
"9526","99","20141209102304","Shop","AAA01","2","20000","4000","16000","2014-12-09 22:23:04"
"9527","56","20141209023143","PC","AAA05","5","300000","100000","200000","2014-12-09 14:31:43"
"9528","17","20141209010553","PC","AAA01","1","10000","2000","8000","2014-12-09 13:05:53"
"9529","68","20141209113235","PC","AAA03","3","51000","9000","42000","2014-12-09 11:32:35"
"9530","29","20141209085733","Shop","AAA05","7","420000","140000","280000","2014-12-09 08:57:33"
"9531","55","20141209071711","PC","AAA03","3","51000","9000","42000","2014-12-09 07:17:11"
"9532","86","20141208081607","Shop","AAA05","1","60000","20000","40000","2014-12-08 20:16:07"
"9533","31","20141208034852","Shop","AAA05","6","360000","120000","240000","2014-12-08 15:48:52"
"9534","94","20141208033107","Mobile","AAA05","7","420000","140000","280000","2014-12-08 15:31:07"
"9535","58","20141208011630","Shop","AAA01","1","10000","2000","8000","2014-12-08 13:16:30"
"9536","1","20141208115214","Mobile","AAA01","1","10000","2000","8000","2014-12-08 11:52:14"
"9537","20","20141208083903","Shop","AAA04","1","8000","400","7600","2014-12-08 08:39:03"
"9538","76","20141206052149","PC","AAA01","8","80000","16000","64000","2014-12-06 05:21:49"
"9539","87","20141205072414","Mobile","AAA04","4","32000","1600","30400","2014-12-05 07:24:14"
"9540","94","20141204055356","Shop","AAA04","2","16000","800","15200","2014-12-04 17:53:56"
"9541","18","20141204043105","Mobile","AAA03","1","17000","3000","14000","2014-12-04 16:31:05"
"9542","16","20141204033548","PC","AAA04","3","24000","1200","22800","2014-12-04 15:35:48"
"9543","86","20141204022330","PC","AAA03","3","51000","9000","42000","2014-12-04 14:23:30"
"9544","46","20141204011234","Mobile","AAA02","6","90000","13800","76200","2014-12-04 13:12:34"
"9545","24","20141204110957","PC","AAA01","2","20000","4000","16000","2014-12-04 11:09:57"
"9546","75","20141204100458","Mobile","AAA01","1","10000","2000","8000","2014-12-04 10:04:58"
"9547","34","20141203115021","Shop","AAA01","9","90000","18000","72000","2014-12-03 23:50:21"
"9548","47","20141203014251","Shop","AAA03","2","34000","6000","28000","2014-12-03 13:42:51"
"9549","73","20141203125148","Mobile","AAA02","4","60000","9200","50800","2014-12-03 12:51:48"
"9550","54","20141203101827","Mobile","AAA04","6","48000","2400","45600","2014-12-03 10:18:27"
"9551","98","20141203083213","Mobile","AAA03","3","51000","9000","42000","2014-12-03 08:32:13"
"9552","96","20141203065110","Shop","AAA02","7","105000","16100","88900","2014-12-03 06:51:10"
"9553","26","20141202124335","PC","AAA02","3","45000","6900","38100","2014-12-02 12:43:35"
"9554","92","20141202112119","Mobile","AAA03","2","34000","6000","28000","2014-12-02 11:21:19"
"9555","30","20141202100814","Shop","AAA01","2","20000","4000","16000","2014-12-02 10:08:14"
"9556","80","20141202081312","Mobile","AAA04","2","16000","800","15200","2014-12-02 08:13:12"
"9557","37","20141201095723","Shop","AAA01","3","30000","6000","24000","2014-12-01 09:57:23"
"9558","79","20141127121158","PC","AAA05","1","60000","20000","40000","2014-11-27 00:11:58"
"9559","30","20141126091816","Shop","AAA04","4","32000","1600","30400","2014-11-26 09:18:16"
"9560","42","20141126084103","Shop","AAA03","3","51000","9000","42000","2014-11-26 08:41:03"
"9561","74","20141126073200","Mobile","AAA01","1","10000","2000","8000","2014-11-26 07:32:00"
"9562","23","20141125034458","PC","AAA02","4","60000","9200","50800","2014-11-25 15:44:58"
"9563","67","20141125114815","Mobile","AAA01","6","60000","12000","48000","2014-11-25 11:48:15"
"9564","48","20141125103521","Mobile","AAA01","2","20000","4000","16000","2014-11-25 10:35:21"
"9565","54","20141125082549","Mobile","AAA05","1","60000","20000","40000","2014-11-25 08:25:49"
"9566","81","20141125081405","PC","AAA01","2","20000","4000","16000","2014-11-25 08:14:05"
"9567","3","20141124021356","Shop","AAA02","8","120000","18400","101600","2014-11-24 14:13:56"
"9568","74","20141124122551","Shop","AAA03","8","136000","24000","112000","2014-11-24 12:25:51"
"9569","68","20141124104124","PC","AAA05","6","360000","120000","240000","2014-11-24 10:41:24"
"9570","98","20141124095043","Mobile","AAA01","2","20000","4000","16000","2014-11-24 09:50:43"
"9571","70","20141120121133","Shop","AAA03","6","102000","18000","84000","2014-11-20 00:11:33"
"9572","1","20141119054630","PC","AAA03","2","34000","6000","28000","2014-11-19 17:46:30"
"9573","33","20141119023826","Shop","AAA03","1","17000","3000","14000","2014-11-19 14:38:26"
"9574","47","20141119122308","PC","AAA05","2","120000","40000","80000","2014-11-19 12:23:08"
"9575","85","20141119100618","Mobile","AAA01","4","40000","8000","32000","2014-11-19 10:06:18"
"9576","27","20141119064649","Shop","AAA02","6","90000","13800","76200","2014-11-19 06:46:49"
"9577","84","20141119011710","PC","AAA03","2","34000","6000","28000","2014-11-19 01:17:10"
"9578","68","20141118072228","Mobile","AAA01","3","30000","6000","24000","2014-11-18 07:22:28"
"9579","24","20141118125223","PC","AAA05","1","60000","20000","40000","2014-11-18 00:52:23"
"9580","99","20141117054344","Shop","AAA05","1","60000","20000","40000","2014-11-17 17:43:44"
"9581","50","20141117045826","Mobile","AAA02","2","30000","4600","25400","2014-11-17 16:58:26"
"9582","16","20141117025911","Shop","AAA01","11","110000","22000","88000","2014-11-17 14:59:11"
"9583","78","20141117115438","Shop","AAA04","6","48000","2400","45600","2014-11-17 11:54:38"
"9584","37","20141117101843","PC","AAA05","6","360000","120000","240000","2014-11-17 10:18:43"
"9585","70","20141117092019","Shop","AAA05","5","300000","100000","200000","2014-11-17 09:20:19"
"9586","94","20141112032153","PC","AAA01","2","20000","4000","16000","2014-11-12 15:21:53"
"9587","66","20141112015149","PC","AAA05","1","60000","20000","40000","2014-11-12 13:51:49"
"9588","72","20141112120922","PC","AAA01","4","40000","8000","32000","2014-11-12 12:09:22"
"9589","35","20141112102205","PC","AAA01","2","20000","4000","16000","2014-11-12 10:22:05"
"9590","99","20141112085415","Shop","AAA02","3","45000","6900","38100","2014-11-12 08:54:15"
"9591","8","20141112071927","PC","AAA01","2","20000","4000","16000","2014-11-12 07:19:27"
"9592","5","20141111023638","Shop","AAA04","3","24000","1200","22800","2014-11-11 14:36:38"
"9593","76","20141111010052","PC","AAA05","1","60000","20000","40000","2014-11-11 13:00:52"
"9594","54","20141111101155","Shop","AAA05","7","420000","140000","280000","2014-11-11 10:11:55"
"9595","9","20141111084616","Shop","AAA03","1","17000","3000","14000","2014-11-11 08:46:16"
"9596","83","20141111065157","Shop","AAA02","9","135000","20700","114300","2014-11-11 06:51:57"
"9597","92","20141110075905","Mobile","AAA02","4","60000","9200","50800","2014-11-10 19:59:05"
"9598","78","20141110112344","Mobile","AAA02","5","75000","11500","63500","2014-11-10 11:23:44"
"9599","65","20141110110452","PC","AAA05","5","300000","100000","200000","2014-11-10 11:04:52"
"9600","16","20141110103952","Shop","AAA04","1","8000","400","7600","2014-11-10 10:39:52"
"9601","13","20141110092138","Shop","AAA04","1","8000","400","7600","2014-11-10 09:21:38"
"9602","78","20141107095844","Shop","AAA04","3","24000","1200","22800","2014-11-07 21:58:44"
"9603","30","20141107124735","Mobile","AAA03","3","51000","9000","42000","2014-11-07 12:47:35"
"9604","20","20141107105902","PC","AAA01","1","10000","2000","8000","2014-11-07 10:59:02"
"9605","29","20141107093130","Shop","AAA01","1","10000","2000","8000","2014-11-07 09:31:30"
"9606","99","20141107075619","Mobile","AAA02","1","15000","2300","12700","2014-11-07 07:56:19"
"9607","98","20141106020725","Shop","AAA01","1","10000","2000","8000","2014-11-06 14:07:25"
"9608","74","20141106115255","Mobile","AAA04","3","24000","1200","22800","2014-11-06 11:52:55"
"9609","87","20141106102558","Shop","AAA05","1","60000","20000","40000","2014-11-06 10:25:58"
"9610","45","20141106082850","PC","AAA04","2","16000","800","15200","2014-11-06 08:28:50"
"9611","33","20141106064633","Mobile","AAA04","4","32000","1600","30400","2014-11-06 06:46:33"
"9612","68","20141105033721","Shop","AAA03","4","68000","12000","56000","2014-11-05 15:37:21"
"9613","72","20141105013951","Mobile","AAA05","6","360000","120000","240000","2014-11-05 13:39:51"
"9614","12","20141105121742","Shop","AAA05","1","60000","20000","40000","2014-11-05 12:17:42"
"9615","95","20141105105458","PC","AAA02","1","15000","2300","12700","2014-11-05 10:54:58"
"9616","99","20141105083418","Shop","AAA01","4","40000","8000","32000","2014-11-05 08:34:18"
"9617","78","20141105070840","Shop","AAA05","2","120000","40000","80000","2014-11-05 07:08:40"
"9618","13","20141104051136","Mobile","AAA01","3","30000","6000","24000","2014-11-04 17:11:36"
"9619","32","20141104032931","PC","AAA04","1","8000","400","7600","2014-11-04 15:29:31"
"9620","81","20141104012145","Shop","AAA05","3","180000","60000","120000","2014-11-04 13:21:45"
"9621","2","20141104090246","Shop","AAA04","2","16000","800","15200","2014-11-04 09:02:46"
"9622","80","20141104075650","PC","AAA05","2","120000","40000","80000","2014-11-04 07:56:50"
"9623","97","20141103033752","Mobile","AAA05","4","240000","80000","160000","2014-11-03 15:37:52"
"9624","76","20141103015023","Shop","AAA02","3","45000","6900","38100","2014-11-03 13:50:23"
"9625","79","20141103120326","Mobile","AAA02","4","60000","9200","50800","2014-11-03 12:03:26"
"9626","54","20141103102030","Mobile","AAA03","1","17000","3000","14000","2014-11-03 10:20:30"
"9627","50","20141028033444","Mobile","AAA04","5","40000","2000","38000","2014-10-28 15:34:44"
"9628","80","20141028021802","Mobile","AAA02","5","75000","11500","63500","2014-10-28 14:18:02"
"9629","93","20141028112952","Shop","AAA05","1","60000","20000","40000","2014-10-28 11:29:52"
"9630","92","20141028094531","Mobile","AAA04","6","48000","2400","45600","2014-10-28 09:45:31"
"9631","29","20141028073859","Shop","AAA03","4","68000","12000","56000","2014-10-28 07:38:59"
"9632","46","20141027030911","Mobile","AAA01","5","50000","10000","40000","2014-10-27 15:09:11"
"9633","35","20141027015947","Mobile","AAA02","5","75000","11500","63500","2014-10-27 13:59:47"
"9634","88","20141027115127","Mobile","AAA04","1","8000","400","7600","2014-10-27 11:51:27"
"9635","35","20141027095200","Shop","AAA03","3","51000","9000","42000","2014-10-27 09:52:00"
"9636","29","20141023032943","Mobile","AAA01","7","70000","14000","56000","2014-10-23 03:29:43"
"9637","91","20141022044638","Mobile","AAA03","2","34000","6000","28000","2014-10-22 16:46:38"
"9638","64","20141022033415","Mobile","AAA04","3","24000","1200","22800","2014-10-22 15:34:15"
"9639","74","20141022122809","Shop","AAA01","2","20000","4000","16000","2014-10-22 12:28:09"
"9640","65","20141022111939","Shop","AAA04","7","56000","2800","53200","2014-10-22 11:19:39"
"9641","87","20141022094731","Shop","AAA03","5","85000","15000","70000","2014-10-22 09:47:31"
"9642","42","20141022082756","PC","AAA05","9","540000","180000","360000","2014-10-22 08:27:56"
"9643","57","20141021053439","Shop","AAA01","1","10000","2000","8000","2014-10-21 17:34:39"
"9644","45","20141021044830","PC","AAA02","2","30000","4600","25400","2014-10-21 16:48:30"
"9645","79","20141021025816","Mobile","AAA03","2","34000","6000","28000","2014-10-21 14:58:16"
"9646","44","20141021020750","Mobile","AAA02","1","15000","2300","12700","2014-10-21 14:07:50"
"9647","87","20141021010136","PC","AAA01","5","50000","10000","40000","2014-10-21 13:01:36"
"9648","83","20141021114435","Shop","AAA05","5","300000","100000","200000","2014-10-21 11:44:35"
"9649","93","20141021104812","PC","AAA04","1","8000","400","7600","2014-10-21 10:48:12"
"9650","24","20141021080654","Shop","AAA01","6","60000","12000","48000","2014-10-21 08:06:54"
"9651","76","20141021062522","Shop","AAA02","3","45000","6900","38100","2014-10-21 06:25:22"
"9652","53","20141020044115","Shop","AAA03","2","34000","6000","28000","2014-10-20 16:41:15"
"9653","42","20141020024145","PC","AAA01","1","10000","2000","8000","2014-10-20 14:41:45"
"9654","21","20141020092335","Shop","AAA05","7","420000","140000","280000","2014-10-20 09:23:35"
"9655","5","20141016094405","PC","AAA01","4","40000","8000","32000","2014-10-16 09:44:05"
"9656","98","20141016075850","Mobile","AAA04","1","8000","400","7600","2014-10-16 07:58:50"
"9657","52","20141015092358","PC","AAA02","1","15000","2300","12700","2014-10-15 09:23:58"
"9658","43","20141015083142","Mobile","AAA01","5","50000","10000","40000","2014-10-15 08:31:42"
"9659","60","20141015063201","PC","AAA03","4","68000","12000","56000","2014-10-15 06:32:01"
"9660","62","20141014055755","Shop","AAA05","7","420000","140000","280000","2014-10-14 17:57:55"
"9661","47","20141014022054","Mobile","AAA02","4","60000","9200","50800","2014-10-14 14:20:54"
"9662","48","20141014020954","Mobile","AAA01","4","40000","8000","32000","2014-10-14 14:09:54"
"9663","56","20141014115313","Mobile","AAA03","7","119000","21000","98000","2014-10-14 11:53:13"
"9664","26","20141014103736","Shop","AAA04","4","32000","1600","30400","2014-10-14 10:37:36"
"9665","78","20141014085837","Mobile","AAA05","6","360000","120000","240000","2014-10-14 08:58:37"
"9666","18","20141013094816","Shop","AAA05","2","120000","40000","80000","2014-10-13 21:48:16"
"9667","64","20141013015929","Mobile","AAA03","2","34000","6000","28000","2014-10-13 13:59:29"
"9668","1","20141013121434","Shop","AAA03","4","68000","12000","56000","2014-10-13 12:14:34"
"9669","38","20141013120552","Mobile","AAA02","6","90000","13800","76200","2014-10-13 12:05:52"
"9670","85","20141013102504","Shop","AAA01","3","30000","6000","24000","2014-10-13 10:25:04"
"9671","45","20141013091719","Mobile","AAA03","5","85000","15000","70000","2014-10-13 09:17:19"
"9672","50","20141008110947","Shop","AAA05","2","120000","40000","80000","2014-10-08 11:09:47"
"9673","55","20141008092514","Shop","AAA05","1","60000","20000","40000","2014-10-08 09:25:14"
"9674","32","20141008061035","PC","AAA04","6","48000","2400","45600","2014-10-08 06:10:35"
"9675","27","20141007082817","Mobile","AAA02","4","60000","9200","50800","2014-10-07 08:28:17"
"9676","49","20141007064834","PC","AAA05","8","480000","160000","320000","2014-10-07 06:48:34"
"9677","10","20141006103037","Shop","AAA03","10","170000","30000","140000","2014-10-06 22:30:37"
"9678","14","20141006014104","Shop","AAA01","1","10000","2000","8000","2014-10-06 13:41:04"
"9679","72","20141006105553","Shop","AAA04","4","32000","1600","30400","2014-10-06 10:55:53"
"9680","36","20141004035315","Mobile","AAA01","1","10000","2000","8000","2014-10-04 15:53:15"
"9681","44","20141002053712","Shop","AAA05","3","180000","60000","120000","2014-10-02 17:37:12"
"9682","6","20141002032209","PC","AAA01","1","10000","2000","8000","2014-10-02 15:22:09"
"9683","62","20141002013904","PC","AAA02","8","120000","18400","101600","2014-10-02 13:39:04"
"9684","32","20141002121307","Shop","AAA01","7","70000","14000","56000","2014-10-02 12:13:07"
"9685","33","20141002110030","Mobile","AAA05","8","480000","160000","320000","2014-10-02 11:00:30"
"9686","50","20141002092220","Mobile","AAA04","2","16000","800","15200","2014-10-02 09:22:20"
"9687","47","20141002080650","Shop","AAA05","3","180000","60000","120000","2014-10-02 08:06:50"
"9688","69","20141002054331","Shop","AAA01","1","10000","2000","8000","2014-10-02 05:43:31"
"9689","34","20141001040222","PC","AAA05","8","480000","160000","320000","2014-10-01 16:02:22"
"9690","69","20141001030637","Shop","AAA05","2","120000","40000","80000","2014-10-01 15:06:37"
"9691","8","20141001013240","Mobile","AAA04","7","56000","2800","53200","2014-10-01 13:32:40"
"9692","62","20141001121935","Shop","AAA04","6","48000","2400","45600","2014-10-01 12:19:35"
"9693","35","20141001105248","Mobile","AAA03","1","17000","3000","14000","2014-10-01 10:52:48"
"9694","55","20141001092629","Shop","AAA04","5","40000","2000","38000","2014-10-01 09:26:29"
"9695","30","20141001075530","Shop","AAA02","2","30000","4600","25400","2014-10-01 07:55:30"
"9696","5","20140930035108","Shop","AAA03","9","153000","27000","126000","2014-09-30 15:51:08"
"9697","24","20140930023157","Shop","AAA04","5","40000","2000","38000","2014-09-30 14:31:57"
"9698","51","20140930011140","Shop","AAA04","3","24000","1200","22800","2014-09-30 13:11:40"
"9699","38","20140930110906","PC","AAA03","5","85000","15000","70000","2014-09-30 11:09:06"
"9700","11","20140930101407","Shop","AAA02","5","75000","11500","63500","2014-09-30 10:14:07"
"9701","91","20140930080556","Shop","AAA04","2","16000","800","15200","2014-09-30 08:05:56"
"9702","6","20140930064401","Mobile","AAA02","2","30000","4600","25400","2014-09-30 06:44:01"
"9703","46","20140929072606","PC","AAA03","4","68000","12000","56000","2014-09-29 19:26:06"
"9704","92","20140929122932","Shop","AAA03","5","85000","15000","70000","2014-09-29 12:29:32"
"9705","6","20140929104610","PC","AAA02","2","30000","4600","25400","2014-09-29 10:46:10"
"9706","71","20140929095444","Shop","AAA05","2","120000","40000","80000","2014-09-29 09:54:44"
"9707","77","20140922061529","PC","AAA02","1","15000","2300","12700","2014-09-22 18:15:29"
"9708","6","20140922021150","Shop","AAA02","3","45000","6900","38100","2014-09-22 14:11:50"
"9709","65","20140922095447","Shop","AAA04","4","32000","1600","30400","2014-09-22 09:54:47"
"9710","50","20140919064328","Shop","AAA04","7","56000","2800","53200","2014-09-19 18:43:28"
"9711","63","20140919123031","PC","AAA04","3","24000","1200","22800","2014-09-19 12:30:31"
"9712","3","20140919111924","Shop","AAA05","2","120000","40000","80000","2014-09-19 11:19:24"
"9713","47","20140919100650","PC","AAA03","7","119000","21000","98000","2014-09-19 10:06:50"
"9714","78","20140919075240","PC","AAA01","1","10000","2000","8000","2014-09-19 07:52:40"
"9715","31","20140918012935","Shop","AAA04","6","48000","2400","45600","2014-09-18 13:29:35"
"9716","39","20140918120027","Mobile","AAA02","2","30000","4600","25400","2014-09-18 12:00:27"
"9717","30","20140918110300","PC","AAA02","7","105000","16100","88900","2014-09-18 11:03:00"
"9718","55","20140918091008","Shop","AAA05","6","360000","120000","240000","2014-09-18 09:10:08"
"9719","91","20140918071907","Shop","AAA01","1","10000","2000","8000","2014-09-18 07:19:07"
"9720","65","20140917110927","Mobile","AAA02","8","120000","18400","101600","2014-09-17 23:09:27"
"9721","79","20140917022102","PC","AAA01","1","10000","2000","8000","2014-09-17 02:21:02"
"9722","85","20140916091813","PC","AAA02","3","45000","6900","38100","2014-09-16 09:18:13"
"9723","72","20140916081158","PC","AAA01","6","60000","12000","48000","2014-09-16 08:11:58"
"9724","36","20140916062854","Shop","AAA05","5","300000","100000","200000","2014-09-16 06:28:54"
"9725","97","20140915114935","PC","AAA05","10","600000","200000","400000","2014-09-15 23:49:35"
"9726","9","20140915100840","Shop","AAA04","4","32000","1600","30400","2014-09-15 10:08:40"
"9727","13","20140915090715","Mobile","AAA03","2","34000","6000","28000","2014-09-15 09:07:15"
"9728","8","20140910062532","Shop","AAA05","7","420000","140000","280000","2014-09-10 18:25:32"
"9729","90","20140910020442","Shop","AAA02","5","75000","11500","63500","2014-09-10 14:04:42"
"9730","54","20140910124106","Mobile","AAA04","3","24000","1200","22800","2014-09-10 12:41:06"
"9731","93","20140910110522","Mobile","AAA03","2","34000","6000","28000","2014-09-10 11:05:22"
"9732","19","20140910091927","Mobile","AAA03","5","85000","15000","70000","2014-09-10 09:19:27"
"9733","2","20140910074120","Shop","AAA01","1","10000","2000","8000","2014-09-10 07:41:20"
"9734","61","20140909044135","PC","AAA02","1","15000","2300","12700","2014-09-09 16:41:35"
"9735","70","20140909030831","Mobile","AAA05","9","540000","180000","360000","2014-09-09 15:08:31"
"9736","52","20140909102625","Shop","AAA02","1","15000","2300","12700","2014-09-09 10:26:25"
"9737","80","20140909064130","PC","AAA01","3","30000","6000","24000","2014-09-09 06:41:30"
"9738","13","20140908033048","PC","AAA04","4","32000","1600","30400","2014-09-08 15:30:48"
"9739","45","20140908010154","Mobile","AAA04","3","24000","1200","22800","2014-09-08 13:01:54"
"9740","10","20140908120403","Mobile","AAA03","6","102000","18000","84000","2014-09-08 12:04:03"
"9741","29","20140908105049","Mobile","AAA01","7","70000","14000","56000","2014-09-08 10:50:49"
"9742","60","20140908085239","PC","AAA01","2","20000","4000","16000","2014-09-08 08:52:39"
"9743","26","20140906105904","PC","AAA02","3","45000","6900","38100","2014-09-06 22:59:04"
"9744","58","20140906010919","Shop","AAA03","5","85000","15000","70000","2014-09-06 01:09:19"
"9745","33","20140905013704","PC","AAA03","3","51000","9000","42000","2014-09-05 13:37:04"
"9746","61","20140905123852","Mobile","AAA02","4","60000","9200","50800","2014-09-05 12:38:52"
"9747","34","20140905083738","Shop","AAA01","8","80000","16000","64000","2014-09-05 08:37:38"
"9748","7","20140904020811","Shop","AAA01","2","20000","4000","16000","2014-09-04 14:08:11"
"9749","5","20140904123212","PC","AAA02","5","75000","11500","63500","2014-09-04 12:32:12"
"9750","52","20140904100827","PC","AAA04","2","16000","800","15200","2014-09-04 10:08:27"
"9751","98","20140904094037","PC","AAA04","1","8000","400","7600","2014-09-04 09:40:37"
"9752","93","20140904080355","Shop","AAA01","2","20000","4000","16000","2014-09-04 08:03:55"
"9753","60","20140904063346","PC","AAA04","4","32000","1600","30400","2014-09-04 06:33:46"
"9754","85","20140903030313","Shop","AAA05","2","120000","40000","80000","2014-09-03 15:03:13"
"9755","58","20140903010730","PC","AAA05","2","120000","40000","80000","2014-09-03 13:07:30"
"9756","26","20140903122227","Shop","AAA02","4","60000","9200","50800","2014-09-03 12:22:27"
"9757","24","20140903110157","Shop","AAA01","6","60000","12000","48000","2014-09-03 11:01:57"
"9758","36","20140903090845","Shop","AAA02","7","105000","16100","88900","2014-09-03 09:08:45"
"9759","7","20140903073057","PC","AAA01","2","20000","4000","16000","2014-09-03 07:30:57"
"9760","42","20140902054511","Mobile","AAA04","4","32000","1600","30400","2014-09-02 17:45:11"
"9761","36","20140902035154","PC","AAA02","8","120000","18400","101600","2014-09-02 15:51:54"
"9762","48","20140902025845","PC","AAA03","5","85000","15000","70000","2014-09-02 14:58:45"
"9763","87","20140902125224","PC","AAA04","1","8000","400","7600","2014-09-02 12:52:24"
"9764","48","20140902115017","Mobile","AAA02","2","30000","4600","25400","2014-09-02 11:50:17"
"9765","57","20140902102423","Mobile","AAA02","3","45000","6900","38100","2014-09-02 10:24:23"
"9766","67","20140902081407","Shop","AAA02","3","45000","6900","38100","2014-09-02 08:14:07"
"9767","10","20140902071116","PC","AAA01","9","90000","18000","72000","2014-09-02 07:11:16"
"9768","48","20140901032008","PC","AAA04","3","24000","1200","22800","2014-09-01 15:20:08"
"9769","71","20140901013542","PC","AAA05","2","120000","40000","80000","2014-09-01 13:35:42"
"9770","3","20140901114231","Mobile","AAA02","16","240000","36800","203200","2014-09-01 11:42:31"
"9771","100","20140901105632","Mobile","AAA03","4","68000","12000","56000","2014-09-01 10:56:32"
"9772","10","20140901093606","Shop","AAA01","10","100000","20000","80000","2014-09-01 09:36:06"
"9773","25","20140828122443","Mobile","AAA02","4","60000","9200","50800","2014-08-28 12:24:43"
"9774","39","20140828110843","PC","AAA05","4","240000","80000","160000","2014-08-28 11:08:43"
"9775","47","20140828102435","Shop","AAA02","2","30000","4600","25400","2014-08-28 10:24:35"
"9776","10","20140828095132","Mobile","AAA02","12","180000","27600","152400","2014-08-28 09:51:32"
"9777","82","20140828085527","Shop","AAA04","3","24000","1200","22800","2014-08-28 08:55:27"
"9778","79","20140828072932","Mobile","AAA03","8","136000","24000","112000","2014-08-28 07:29:32"
"9779","12","20140827084328","Mobile","AAA03","3","51000","9000","42000","2014-08-27 20:43:28"
"9780","55","20140827034438","Shop","AAA05","2","120000","40000","80000","2014-08-27 15:44:38"
"9781","43","20140827013030","Shop","AAA02","6","90000","13800","76200","2014-08-27 13:30:30"
"9782","88","20140827123455","PC","AAA01","1","10000","2000","8000","2014-08-27 12:34:55"
"9783","60","20140827102441","PC","AAA03","3","51000","9000","42000","2014-08-27 10:24:41"
"9784","93","20140827085520","PC","AAA05","8","480000","160000","320000","2014-08-27 08:55:20"
"9785","82","20140827064948","Shop","AAA05","7","420000","140000","280000","2014-08-27 06:49:48"
"9786","7","20140826101821","PC","AAA05","6","360000","120000","240000","2014-08-26 10:18:21"
"9787","8","20140826092805","Mobile","AAA01","3","30000","6000","24000","2014-08-26 09:28:05"
"9788","26","20140825113635","PC","AAA05","1","60000","20000","40000","2014-08-25 23:36:35"
"9789","13","20140825121306","Shop","AAA01","3","30000","6000","24000","2014-08-25 12:13:06"
"9790","38","20140825110245","Mobile","AAA05","6","360000","120000","240000","2014-08-25 11:02:45"
"9791","50","20140825085216","PC","AAA04","6","48000","2400","45600","2014-08-25 08:52:16"
"9792","55","20140821020643","PC","AAA03","7","119000","21000","98000","2014-08-21 02:06:43"
"9793","55","20140820101858","PC","AAA04","3","24000","1200","22800","2014-08-20 10:18:58"
"9794","3","20140820075300","PC","AAA04","8","64000","3200","60800","2014-08-20 07:53:00"
"9795","33","20140820031946","Shop","AAA04","2","16000","800","15200","2014-08-20 03:19:46"
"9796","40","20140819122111","Shop","AAA02","2","30000","4600","25400","2014-08-19 12:21:11"
"9797","92","20140819101333","Shop","AAA05","4","240000","80000","160000","2014-08-19 10:13:33"
"9798","89","20140819075555","Mobile","AAA04","3","24000","1200","22800","2014-08-19 07:55:55"
"9799","10","20140818025542","Shop","AAA05","4","240000","80000","160000","2014-08-18 14:55:42"
"9800","52","20140818011242","PC","AAA03","3","51000","9000","42000","2014-08-18 13:12:42"
"9801","47","20140818104410","PC","AAA03","1","17000","3000","14000","2014-08-18 10:44:10"
"9802","10","20140818085315","Mobile","AAA01","7","70000","14000","56000","2014-08-18 08:53:15"
"9803","25","20140817023553","Mobile","AAA02","4","60000","9200","50800","2014-08-17 14:35:53"
"9804","32","20140816035308","Mobile","AAA05","5","300000","100000","200000","2014-08-16 03:53:08"
"9805","10","20140815040535","Mobile","AAA03","7","119000","21000","98000","2014-08-15 16:05:35"
"9806","61","20140815020057","PC","AAA03","1","17000","3000","14000","2014-08-15 14:00:57"
"9807","42","20140815113705","Shop","AAA01","3","30000","6000","24000","2014-08-15 11:37:05"
"9808","15","20140815103035","PC","AAA01","7","70000","14000","56000","2014-08-15 10:30:35"
"9809","26","20140814051950","Shop","AAA05","1","60000","20000","40000","2014-08-14 17:19:50"
"9810","20","20140814033940","Shop","AAA02","3","45000","6900","38100","2014-08-14 15:39:40"
"9811","20","20140814013414","Shop","AAA03","2","34000","6000","28000","2014-08-14 13:34:14"
"9812","97","20140814122014","Shop","AAA05","4","240000","80000","160000","2014-08-14 12:20:14"
"9813","40","20140814103919","Mobile","AAA05","1","60000","20000","40000","2014-08-14 10:39:19"
"9814","79","20140814090557","PC","AAA04","5","40000","2000","38000","2014-08-14 09:05:57"
"9815","87","20140814074603","Mobile","AAA04","2","16000","800","15200","2014-08-14 07:46:03"
"9816","11","20140814120054","Mobile","AAA02","2","30000","4600","25400","2014-08-14 00:00:54"
"9817","5","20140813045513","Shop","AAA02","4","60000","9200","50800","2014-08-13 16:55:13"
"9818","15","20140813123104","Shop","AAA02","15","225000","34500","190500","2014-08-13 12:31:04"
"9819","25","20140813104023","Mobile","AAA04","3","24000","1200","22800","2014-08-13 10:40:23"
"9820","96","20140813092912","Mobile","AAA05","2","120000","40000","80000","2014-08-13 09:29:12"
"9821","74","20140813075057","PC","AAA04","2","16000","800","15200","2014-08-13 07:50:57"
"9822","48","20140812085335","Shop","AAA01","8","80000","16000","64000","2014-08-12 20:53:35"
"9823","7","20140812052930","PC","AAA01","3","30000","6000","24000","2014-08-12 17:29:30"
"9824","23","20140812042532","PC","AAA04","2","16000","800","15200","2014-08-12 16:25:32"
"9825","32","20140812011624","PC","AAA04","5","40000","2000","38000","2014-08-12 13:16:24"
"9826","16","20140812091642","PC","AAA05","8","480000","160000","320000","2014-08-12 09:16:42"
"9827","22","20140812075114","PC","AAA01","4","40000","8000","32000","2014-08-12 07:51:14"
"9828","18","20140811081528","Shop","AAA02","5","75000","11500","63500","2014-08-11 20:15:28"
"9829","24","20140811025526","Mobile","AAA04","5","40000","2000","38000","2014-08-11 14:55:26"
"9830","97","20140811125535","Mobile","AAA03","2","34000","6000","28000","2014-08-11 12:55:35"
"9831","50","20140811114338","PC","AAA02","4","60000","9200","50800","2014-08-11 11:43:38"
"9832","54","20140811095713","PC","AAA01","5","50000","10000","40000","2014-08-11 09:57:13"
"9833","48","20140808122403","Mobile","AAA05","5","300000","100000","200000","2014-08-08 00:24:03"
"9834","55","20140807093551","Shop","AAA04","6","48000","2400","45600","2014-08-07 09:35:51"
"9835","44","20140807080127","Mobile","AAA03","1","17000","3000","14000","2014-08-07 08:01:27"
"9836","61","20140807061717","Mobile","AAA03","2","34000","6000","28000","2014-08-07 06:17:17"
"9837","43","20140806032825","Mobile","AAA02","4","60000","9200","50800","2014-08-06 15:28:25"
"9838","83","20140806115045","Mobile","AAA01","6","60000","12000","48000","2014-08-06 11:50:45"
"9839","34","20140806105306","PC","AAA04","4","32000","1600","30400","2014-08-06 10:53:06"
"9840","38","20140806085912","PC","AAA05","2","120000","40000","80000","2014-08-06 08:59:12"
"9841","89","20140806065703","Shop","AAA03","8","136000","24000","112000","2014-08-06 06:57:03"
"9842","77","20140806123528","Mobile","AAA02","2","30000","4600","25400","2014-08-06 00:35:28"
"9843","72","20140804114433","PC","AAA04","4","32000","1600","30400","2014-08-04 23:44:33"
"9844","77","20140804060332","Shop","AAA03","5","85000","15000","70000","2014-08-04 06:03:32"
"9845","40","20140802051950","Mobile","AAA03","7","119000","21000","98000","2014-08-02 05:19:50"
"9846","9","20140731040228","Shop","AAA05","3","180000","60000","120000","2014-07-31 16:02:28"
"9847","30","20140731024427","Shop","AAA02","3","45000","6900","38100","2014-07-31 14:44:27"
"9848","75","20140731114410","Mobile","AAA04","3","24000","1200","22800","2014-07-31 11:44:10"
"9849","27","20140731091306","PC","AAA02","9","135000","20700","114300","2014-07-31 09:13:06"
"9850","2","20140730100528","PC","AAA03","4","68000","12000","56000","2014-07-30 22:05:28"
"9851","42","20140730041612","PC","AAA01","6","60000","12000","48000","2014-07-30 16:16:12"
"9852","32","20140730035620","Shop","AAA04","8","64000","3200","60800","2014-07-30 15:56:20"
"9853","57","20140730023945","Shop","AAA05","1","60000","20000","40000","2014-07-30 14:39:45"
"9854","39","20140730015617","PC","AAA04","2","16000","800","15200","2014-07-30 13:56:17"
"9855","64","20140730110218","Shop","AAA02","7","105000","16100","88900","2014-07-30 11:02:18"
"9856","30","20140730093542","PC","AAA05","6","360000","120000","240000","2014-07-30 09:35:42"
"9857","10","20140730074743","Shop","AAA04","6","48000","2400","45600","2014-07-30 07:47:43"
"9858","44","20140729051358","Shop","AAA05","1","60000","20000","40000","2014-07-29 17:13:58"
"9859","48","20140729052125","Mobile","AAA02","2","30000","4600","25400","2014-07-29 17:21:25"
"9860","64","20140729034007","Mobile","AAA03","8","136000","24000","112000","2014-07-29 15:40:07"
"9861","43","20140729013001","PC","AAA05","7","420000","140000","280000","2014-07-29 13:30:01"
"9862","53","20140729100612","PC","AAA05","3","180000","60000","120000","2014-07-29 10:06:12"
"9863","18","20140729073615","Mobile","AAA02","3","45000","6900","38100","2014-07-29 07:36:15"
"9864","70","20140728112129","PC","AAA02","8","120000","18400","101600","2014-07-28 11:21:29"
"9865","56","20140728091320","Shop","AAA03","4","68000","12000","56000","2014-07-28 09:13:20"
"9866","26","20140724024903","Shop","AAA01","2","20000","4000","16000","2014-07-24 02:49:03"
"9867","56","20140723061553","Shop","AAA02","1","15000","2300","12700","2014-07-23 18:15:53"
"9868","70","20140723013720","Shop","AAA03","7","119000","21000","98000","2014-07-23 13:37:20"
"9869","16","20140723125601","Shop","AAA03","3","51000","9000","42000","2014-07-23 12:56:01"
"9870","43","20140723113504","Shop","AAA03","6","102000","18000","84000","2014-07-23 11:35:04"
"9871","98","20140723092431","PC","AAA01","1","10000","2000","8000","2014-07-23 09:24:31"
"9872","97","20140723065816","Shop","AAA02","1","15000","2300","12700","2014-07-23 06:58:16"
"9873","47","20140723121231","Mobile","AAA03","3","51000","9000","42000","2014-07-23 00:12:31"
"9874","80","20140722062739","Shop","AAA05","3","180000","60000","120000","2014-07-22 06:27:39"
"9875","79","20140721064216","PC","AAA02","4","60000","9200","50800","2014-07-21 18:42:16"
"9876","79","20140721124906","PC","AAA01","1","10000","2000","8000","2014-07-21 12:49:06"
"9877","29","20140721105422","Mobile","AAA04","6","48000","2400","45600","2014-07-21 10:54:22"
"9878","50","20140721092327","Mobile","AAA01","7","70000","14000","56000","2014-07-21 09:23:27"
"9879","74","20140720060147","Mobile","AAA01","5","50000","10000","40000","2014-07-20 06:01:47"
"9880","22","20140715021425","Shop","AAA03","6","102000","18000","84000","2014-07-15 14:14:25"
"9881","80","20140715124814","PC","AAA01","6","60000","12000","48000","2014-07-15 12:48:14"
"9882","35","20140715115614","Shop","AAA04","1","8000","400","7600","2014-07-15 11:56:14"
"9883","28","20140715084743","PC","AAA02","9","135000","20700","114300","2014-07-15 08:47:43"
"9884","25","20140715073559","PC","AAA02","1","15000","2300","12700","2014-07-15 07:35:59"
"9885","58","20140714044509","Mobile","AAA01","3","30000","6000","24000","2014-07-14 16:45:09"
"9886","39","20140714021348","PC","AAA03","6","102000","18000","84000","2014-07-14 14:13:48"
"9887","4","20140714113340","Shop","AAA03","1","17000","3000","14000","2014-07-14 11:33:40"
"9888","48","20140710025549","Shop","AAA02","3","45000","6900","38100","2014-07-10 02:55:49"
"9889","13","20140709063018","Mobile","AAA01","2","20000","4000","16000","2014-07-09 06:30:18"
"9890","1","20140708065810","PC","AAA04","6","48000","2400","45600","2014-07-08 18:58:10"
"9891","88","20140708011846","Mobile","AAA03","2","34000","6000","28000","2014-07-08 13:18:46"
"9892","81","20140708114012","Shop","AAA04","3","24000","1200","22800","2014-07-08 11:40:12"
"9893","8","20140708102309","Shop","AAA01","7","70000","14000","56000","2014-07-08 10:23:09"
"9894","8","20140708083206","PC","AAA04","11","88000","4400","83600","2014-07-08 08:32:06"
"9895","22","20140708064618","Shop","AAA02","9","135000","20700","114300","2014-07-08 06:46:18"
"9896","75","20140707084944","PC","AAA02","2","30000","4600","25400","2014-07-07 20:49:44"
"9897","15","20140707014156","PC","AAA02","5","75000","11500","63500","2014-07-07 13:41:56"
"9898","59","20140707115501","PC","AAA05","4","240000","80000","160000","2014-07-07 11:55:01"
"9899","64","20140707112445","PC","AAA05","10","600000","200000","400000","2014-07-07 11:24:45"
"9900","15","20140707102004","PC","AAA03","8","136000","24000","112000","2014-07-07 10:20:04"
"9901","31","20140707090244","PC","AAA05","1","60000","20000","40000","2014-07-07 09:02:44"
"9902","28","20140703125519","Mobile","AAA02","6","90000","13800","76200","2014-07-03 12:55:19"
"9903","67","20140703093727","Mobile","AAA04","3","24000","1200","22800","2014-07-03 09:37:27"
"9904","13","20140703073455","PC","AAA04","4","32000","1600","30400","2014-07-03 07:34:55"
"9905","15","20140702102715","Shop","AAA04","9","72000","3600","68400","2014-07-02 22:27:15"
"9906","41","20140702072607","Shop","AAA03","7","119000","21000","98000","2014-07-02 19:26:07"
"9907","48","20140702125550","PC","AAA04","1","8000","400","7600","2014-07-02 12:55:50"
"9908","32","20140702110433","PC","AAA05","8","480000","160000","320000","2014-07-02 11:04:33"
"9909","15","20140702100412","PC","AAA05","8","480000","160000","320000","2014-07-02 10:04:12"
"9910","63","20140702090948","PC","AAA03","1","17000","3000","14000","2014-07-02 09:09:48"
"9911","3","20140702072111","Shop","AAA02","3","45000","6900","38100","2014-07-02 07:21:11"
"9912","45","20140701010329","PC","AAA05","5","300000","100000","200000","2014-07-01 13:03:29"
"9913","10","20140701111127","Mobile","AAA01","3","30000","6000","24000","2014-07-01 11:11:27"
"9914","85","20140701085936","PC","AAA03","1","17000","3000","14000","2014-07-01 08:59:36"
"9915","45","20140701065611","PC","AAA04","3","24000","1200","22800","2014-07-01 06:56:11"
"9916","28","20140630055531","Shop","AAA03","4","68000","12000","56000","2014-06-30 17:55:31"
"9917","40","20140630043836","PC","AAA02","3","45000","6900","38100","2014-06-30 16:38:36"
"9918","53","20140630035735","Shop","AAA04","4","32000","1600","30400","2014-06-30 15:57:35"
"9919","2","20140630023850","PC","AAA01","1","10000","2000","8000","2014-06-30 14:38:50"
"9920","23","20140630013236","PC","AAA04","5","40000","2000","38000","2014-06-30 13:32:36"
"9921","21","20140630100506","Mobile","AAA01","6","60000","12000","48000","2014-06-30 10:05:06"
"9922","97","20140630081045","Mobile","AAA02","4","60000","9200","50800","2014-06-30 08:10:45"
"9923","25","20140626120859","Shop","AAA01","8","80000","16000","64000","2014-06-26 00:08:59"
"9924","82","20140625031123","Shop","AAA01","4","40000","8000","32000","2014-06-25 15:11:23"
"9925","24","20140625021730","PC","AAA03","11","187000","33000","154000","2014-06-25 14:17:30"
"9926","88","20140625122920","Shop","AAA05","1","60000","20000","40000","2014-06-25 12:29:20"
"9927","46","20140625105235","PC","AAA05","8","480000","160000","320000","2014-06-25 10:52:35"
"9928","62","20140625094117","PC","AAA05","2","120000","40000","80000","2014-06-25 09:41:17"
"9929","99","20140625083823","PC","AAA03","1","17000","3000","14000","2014-06-25 08:38:23"
"9930","30","20140625074820","Shop","AAA01","3","30000","6000","24000","2014-06-25 07:48:20"
"9931","39","20140624113112","PC","AAA02","4","60000","9200","50800","2014-06-24 23:31:12"
"9932","82","20140624025618","Shop","AAA04","1","8000","400","7600","2014-06-24 02:56:18"
"9933","38","20140623035904","PC","AAA02","5","75000","11500","63500","2014-06-23 15:59:04"
"9934","46","20140623014034","PC","AAA05","3","180000","60000","120000","2014-06-23 13:40:34"
"9935","64","20140623120919","Shop","AAA04","7","56000","2800","53200","2014-06-23 12:09:19"
"9936","66","20140623104249","PC","AAA03","1","17000","3000","14000","2014-06-23 10:42:49"
"9937","46","20140623083826","Shop","AAA02","2","30000","4600","25400","2014-06-23 08:38:26"
"9938","99","20140616075155","Mobile","AAA05","1","60000","20000","40000","2014-06-16 19:51:55"
"9939","95","20140616052247","PC","AAA02","1","15000","2300","12700","2014-06-16 17:22:47"
"9940","22","20140616035405","PC","AAA04","4","32000","1600","30400","2014-06-16 15:54:05"
"9941","40","20140616023746","PC","AAA04","1","8000","400","7600","2014-06-16 14:37:46"
"9942","50","20140616125054","Mobile","AAA02","5","75000","11500","63500","2014-06-16 12:50:54"
"9943","17","20140616092703","Mobile","AAA03","1","17000","3000","14000","2014-06-16 09:27:03"
"9944","75","20140612093601","PC","AAA04","3","24000","1200","22800","2014-06-12 09:36:01"
"9945","56","20140612081649","PC","AAA05","5","300000","100000","200000","2014-06-12 08:16:49"
"9946","9","20140612060845","Mobile","AAA04","2","16000","800","15200","2014-06-12 06:08:45"
"9947","30","20140611125440","PC","AAA05","4","240000","80000","160000","2014-06-11 12:54:40"
"9948","44","20140611095321","Shop","AAA05","6","360000","120000","240000","2014-06-11 09:53:21"
"9949","84","20140611081630","PC","AAA05","2","120000","40000","80000","2014-06-11 08:16:30"
"9950","24","20140611070517","Shop","AAA04","2","16000","800","15200","2014-06-11 07:05:17"
"9951","93","20140610023944","PC","AAA02","8","120000","18400","101600","2014-06-10 14:39:44"
"9952","14","20140610125031","Shop","AAA02","2","30000","4600","25400","2014-06-10 12:50:31"
"9953","60","20140610112851","PC","AAA01","4","40000","8000","32000","2014-06-10 11:28:51"
"9954","49","20140610104138","Mobile","AAA03","5","85000","15000","70000","2014-06-10 10:41:38"
"9955","100","20140610091840","Shop","AAA03","1","17000","3000","14000","2014-06-10 09:18:40"
"9956","65","20140610065558","PC","AAA05","3","180000","60000","120000","2014-06-10 06:55:58"
"9957","58","20140609015651","PC","AAA02","1","15000","2300","12700","2014-06-09 13:56:51"
"9958","39","20140609115120","PC","AAA03","4","68000","12000","56000","2014-06-09 11:51:20"
"9959","8","20140609105044","Mobile","AAA03","6","102000","18000","84000","2014-06-09 10:50:44"
"9960","42","20140609091520","Mobile","AAA05","3","180000","60000","120000","2014-06-09 09:15:20"
"9961","4","20140606075145","Shop","AAA02","1","15000","2300","12700","2014-06-06 07:51:45"
"9962","51","20140605035840","PC","AAA04","2","16000","800","15200","2014-06-05 15:58:40"
"9963","7","20140605023038","Mobile","AAA03","3","51000","9000","42000","2014-06-05 14:30:38"
"9964","37","20140605100842","Mobile","AAA01","3","30000","6000","24000","2014-06-05 10:08:42"
"9965","88","20140605073622","Shop","AAA05","4","240000","80000","160000","2014-06-05 07:36:22"
"9966","59","20140604011458","PC","AAA02","3","45000","6900","38100","2014-06-04 13:14:58"
"9967","48","20140604114800","PC","AAA01","2","20000","4000","16000","2014-06-04 11:48:00"
"9968","71","20140604103553","PC","AAA04","5","40000","2000","38000","2014-06-04 10:35:53"
"9969","2","20140604092739","Mobile","AAA05","6","360000","120000","240000","2014-06-04 09:27:39"
"9970","13","20140604063754","Shop","AAA04","2","16000","800","15200","2014-06-04 06:37:54"
"9971","57","20140603062541","Shop","AAA03","2","34000","6000","28000","2014-06-03 18:25:41"
"9972","94","20140603032611","Mobile","AAA03","8","136000","24000","112000","2014-06-03 15:26:11"
"9973","21","20140603124051","Shop","AAA02","5","75000","11500","63500","2014-06-03 12:40:51"
"9974","66","20140603113721","Mobile","AAA02","6","90000","13800","76200","2014-06-03 11:37:21"
"9975","87","20140603100147","Mobile","AAA04","4","32000","1600","30400","2014-06-03 10:01:47"
"9976","4","20140603081053","Shop","AAA03","3","51000","9000","42000","2014-06-03 08:10:53"
"9977","57","20140603061329","Mobile","AAA05","3","180000","60000","120000","2014-06-03 06:13:29"
"9978","77","20140602091917","Shop","AAA04","4","32000","1600","30400","2014-06-02 21:19:17"
"9979","51","20140602041328","Shop","AAA03","6","102000","18000","84000","2014-06-02 16:13:28"
"9980","70","20140602125741","PC","AAA03","8","136000","24000","112000","2014-06-02 12:57:41"
"9981","36","20140602115820","PC","AAA05","2","120000","40000","80000","2014-06-02 11:58:20"
"9982","16","20140602101608","Mobile","AAA05","1","60000","20000","40000","2014-06-02 10:16:08"
"9983","66","20140602083918","PC","AAA02","4","60000","9200","50800","2014-06-02 08:39:18"
"9984","18","20140529073902","PC","AAA04","2","16000","800","15200","2014-05-29 19:39:02"
"9985","43","20140529034233","PC","AAA02","11","165000","25300","139700","2014-05-29 15:42:33"
"9986","11","20140529020627","PC","AAA02","8","120000","18400","101600","2014-05-29 14:06:27"
"9987","21","20140529124113","PC","AAA04","5","40000","2000","38000","2014-05-29 12:41:13"
"9988","13","20140529112559","PC","AAA02","6","90000","13800","76200","2014-05-29 11:25:59"
"9989","30","20140529101405","Mobile","AAA04","4","32000","1600","30400","2014-05-29 10:14:05"
"9990","92","20140529085305","Mobile","AAA04","4","32000","1600","30400","2014-05-29 08:53:05"
"9991","10","20140529071206","PC","AAA04","3","24000","1200","22800","2014-05-29 07:12:06"
"9992","95","20140528060613","Mobile","AAA03","1","17000","3000","14000","2014-05-28 18:06:13"
"9993","83","20140528100219","PC","AAA03","2","34000","6000","28000","2014-05-28 10:02:19"
"9994","1","20140528085034","PC","AAA03","10","170000","30000","140000","2014-05-28 08:50:34"
"9995","52","20140528065725","PC","AAA05","1","60000","20000","40000","2014-05-28 06:57:25"
"9996","100","20140528044426","Mobile","AAA05","2","120000","40000","80000","2014-05-28 04:44:26"
"9997","52","20140527033910","PC","AAA01","1","10000","2000","8000","2014-05-27 15:39:10"
"9998","19","20140527015944","PC","AAA04","1","8000","400","7600","2014-05-27 13:59:44"
"9999","51","20140527120047","Shop","AAA01","4","40000","8000","32000","2014-05-27 12:00:47"
"10000","84","20140527095516","Shop","AAA02","1","15000","2300","12700","2014-05-27 09:55:16"
"10001","10","20140527090549","PC","AAA05","5","300000","100000","200000","2014-05-27 09:05:49"
"10002","25","20140527065307","Mobile","AAA01","4","40000","8000","32000","2014-05-27 06:53:07"
"10003","62","20140526085507","Mobile","AAA03","3","51000","9000","42000","2014-05-26 20:55:07"
"10004","45","20140526051640","Mobile","AAA05","6","360000","120000","240000","2014-05-26 17:16:40"
"10005","2","20140526012345","PC","AAA03","4","68000","12000","56000","2014-05-26 13:23:45"
"10006","34","20140526115310","Mobile","AAA05","9","540000","180000","360000","2014-05-26 11:53:10"
"10007","16","20140526102644","PC","AAA02","3","45000","6900","38100","2014-05-26 10:26:44"
"10008","66","20140526083604","Mobile","AAA04","4","32000","1600","30400","2014-05-26 08:36:04"
"10009","56","20140524045040","Mobile","AAA03","5","85000","15000","70000","2014-05-24 16:50:40"
"10010","6","20140523070847","Mobile","AAA02","3","45000","6900","38100","2014-05-23 07:08:47"
"10011","57","20140522011351","Shop","AAA05","2","120000","40000","80000","2014-05-22 13:13:51"
"10012","27","20140522112731","Shop","AAA05","8","480000","160000","320000","2014-05-22 11:27:31"
"10013","56","20140522095847","Mobile","AAA03","2","34000","6000","28000","2014-05-22 09:58:47"
"10014","31","20140522075259","Mobile","AAA04","2","16000","800","15200","2014-05-22 07:52:59"
"10015","81","20140521022456","Shop","AAA02","2","30000","4600","25400","2014-05-21 14:24:56"
"10016","92","20140521124740","Shop","AAA02","1","15000","2300","12700","2014-05-21 12:47:40"
"10017","46","20140521111843","PC","AAA04","4","32000","1600","30400","2014-05-21 11:18:43"
"10018","90","20140521082208","Shop","AAA01","2","20000","4000","16000","2014-05-21 08:22:08"
"10019","37","20140520022737","Shop","AAA05","4","240000","80000","160000","2014-05-20 14:27:37"
"10020","32","20140520015521","Mobile","AAA02","2","30000","4600","25400","2014-05-20 13:55:21"
"10021","91","20140520120951","Mobile","AAA03","1","17000","3000","14000","2014-05-20 12:09:51"
"10022","97","20140520102110","PC","AAA02","7","105000","16100","88900","2014-05-20 10:21:10"
"10023","1","20140520082707","Mobile","AAA02","4","60000","9200","50800","2014-05-20 08:27:07"
"10024","90","20140520065653","PC","AAA04","3","24000","1200","22800","2014-05-20 06:56:53"
"10025","54","20140514095143","PC","AAA05","4","240000","80000","160000","2014-05-14 09:51:43"
"10026","93","20140514084847","PC","AAA03","2","34000","6000","28000","2014-05-14 08:48:47"
"10027","93","20140514065919","Shop","AAA02","3","45000","6900","38100","2014-05-14 06:59:19"
"10028","55","20140513013640","Mobile","AAA05","9","540000","180000","360000","2014-05-13 13:36:40"
"10029","48","20140513112326","PC","AAA05","6","360000","120000","240000","2014-05-13 11:23:26"
"10030","16","20140513073857","Mobile","AAA01","6","60000","12000","48000","2014-05-13 07:38:57"
"10031","100","20140512091305","Shop","AAA04","6","48000","2400","45600","2014-05-12 21:13:05"
"10032","21","20140512051244","Mobile","AAA03","6","102000","18000","84000","2014-05-12 17:12:44"
"10033","44","20140512031137","Mobile","AAA02","2","30000","4600","25400","2014-05-12 15:11:37"
"10034","44","20140512015004","PC","AAA05","3","180000","60000","120000","2014-05-12 13:50:04"
"10035","58","20140512122032","Mobile","AAA04","2","16000","800","15200","2014-05-12 12:20:32"
"10036","66","20140512105005","Mobile","AAA05","5","300000","100000","200000","2014-05-12 10:50:05"
"10037","100","20140512085459","Shop","AAA02","2","30000","4600","25400","2014-05-12 08:54:59"
"10038","31","20140508031855","PC","AAA01","5","50000","10000","40000","2014-05-08 03:18:55"
"10039","75","20140507075658","Mobile","AAA03","1","17000","3000","14000","2014-05-07 07:56:58"
"10040","74","20140506050800","Mobile","AAA02","2","30000","4600","25400","2014-05-06 17:08:00"
"10041","76","20140506031853","Mobile","AAA04","1","8000","400","7600","2014-05-06 15:18:53"
"10042","70","20140506023919","PC","AAA03","2","34000","6000","28000","2014-05-06 14:39:19"
"10043","88","20140506124607","Mobile","AAA03","4","68000","12000","56000","2014-05-06 12:46:07"
"10044","68","20140506111123","PC","AAA04","1","8000","400","7600","2014-05-06 11:11:23"
"10045","3","20140506094647","Shop","AAA01","9","90000","18000","72000","2014-05-06 09:46:47"
"10046","93","20140506090009","PC","AAA03","3","51000","9000","42000","2014-05-06 09:00:09"
"10047","15","20140506075430","Mobile","AAA02","10","150000","23000","127000","2014-05-06 07:54:30"
"10048","29","20140505020037","Mobile","AAA01","7","70000","14000","56000","2014-05-05 14:00:37"
"10049","76","20140505120633","Mobile","AAA01","3","30000","6000","24000","2014-05-05 12:06:33"
"10050","70","20140505094329","Mobile","AAA02","11","165000","25300","139700","2014-05-05 09:43:29"
"10051","22","20140430042743","Mobile","AAA05","6","360000","120000","240000","2014-04-30 16:27:43"
"10052","5","20140430022424","Mobile","AAA02","6","90000","13800","76200","2014-04-30 14:24:24"
"10053","96","20140430010411","Mobile","AAA04","7","56000","2800","53200","2014-04-30 13:04:11"
"10054","41","20140430115308","Mobile","AAA03","6","102000","18000","84000","2014-04-30 11:53:08"
"10055","84","20140430102029","PC","AAA04","1","8000","400","7600","2014-04-30 10:20:29"
"10056","7","20140430082907","PC","AAA05","6","360000","120000","240000","2014-04-30 08:29:07"
"10057","27","20140430073022","Mobile","AAA02","5","75000","11500","63500","2014-04-30 07:30:22"
"10058","37","20140430124530","Shop","AAA01","6","60000","12000","48000","2014-04-30 00:45:30"
"10059","16","20140429082512","PC","AAA03","9","153000","27000","126000","2014-04-29 08:25:12"
"10060","28","20140429064200","Shop","AAA02","3","45000","6900","38100","2014-04-29 06:42:00"
"10061","40","20140428040021","PC","AAA02","1","15000","2300","12700","2014-04-28 16:00:21"
"10062","84","20140428023550","Shop","AAA05","2","120000","40000","80000","2014-04-28 14:35:50"
"10063","19","20140428102702","Shop","AAA01","1","10000","2000","8000","2014-04-28 10:27:02"
"10064","1","20140428083304","Shop","AAA05","5","300000","100000","200000","2014-04-28 08:33:04"
"10065","5","20140425060623","PC","AAA05","5","300000","100000","200000","2014-04-25 06:06:23"
"10066","7","20140424110840","PC","AAA01","1","10000","2000","8000","2014-04-24 11:08:40"
"10067","77","20140424095659","Mobile","AAA03","3","51000","9000","42000","2014-04-24 09:56:59"
"10068","42","20140424071245","Mobile","AAA02","5","75000","11500","63500","2014-04-24 07:12:45"
"10069","68","20140423041650","PC","AAA05","1","60000","20000","40000","2014-04-23 16:16:50"
"10070","61","20140423025717","PC","AAA03","3","51000","9000","42000","2014-04-23 14:57:17"
"10071","99","20140423112508","Shop","AAA01","2","20000","4000","16000","2014-04-23 11:25:08"
"10072","64","20140423085800","Shop","AAA02","1","15000","2300","12700","2014-04-23 08:58:00"
"10073","86","20140423071213","PC","AAA05","4","240000","80000","160000","2014-04-23 07:12:13"
"10074","39","20140422062220","Shop","AAA01","1","10000","2000","8000","2014-04-22 18:22:20"
"10075","13","20140422041800","PC","AAA02","2","30000","4600","25400","2014-04-22 16:18:00"
"10076","67","20140422022702","Mobile","AAA01","7","70000","14000","56000","2014-04-22 14:27:02"
"10077","22","20140422123744","Shop","AAA03","8","136000","24000","112000","2014-04-22 12:37:44"
"10078","56","20140422103437","Mobile","AAA02","5","75000","11500","63500","2014-04-22 10:34:37"
"10079","93","20140422081629","Mobile","AAA02","3","45000","6900","38100","2014-04-22 08:16:29"
"10080","49","20140422074151","Mobile","AAA03","12","204000","36000","168000","2014-04-22 07:41:51"
"10081","2","20140421042043","Shop","AAA04","4","32000","1600","30400","2014-04-21 16:20:43"
"10082","91","20140421024648","Mobile","AAA05","1","60000","20000","40000","2014-04-21 14:46:48"
"10083","79","20140421125741","Shop","AAA04","1","8000","400","7600","2014-04-21 12:57:41"
"10084","92","20140421115805","Shop","AAA03","9","153000","27000","126000","2014-04-21 11:58:05"
"10085","43","20140421104814","Shop","AAA02","1","15000","2300","12700","2014-04-21 10:48:14"
"10086","21","20140421093212","PC","AAA04","5","40000","2000","38000","2014-04-21 09:32:12"
"10087","80","20140417100813","Shop","AAA01","5","50000","10000","40000","2014-04-17 10:08:13"
"10088","42","20140417085704","PC","AAA05","4","240000","80000","160000","2014-04-17 08:57:04"
"10089","21","20140417073800","PC","AAA01","12","120000","24000","96000","2014-04-17 07:38:00"
"10090","89","20140416074140","Mobile","AAA05","10","600000","200000","400000","2014-04-16 19:41:40"
"10091","73","20140416045614","Shop","AAA02","2","30000","4600","25400","2014-04-16 16:56:14"
"10092","52","20140416015520","Shop","AAA05","2","120000","40000","80000","2014-04-16 13:55:20"
"10093","43","20140416124539","Shop","AAA05","4","240000","80000","160000","2014-04-16 12:45:39"
"10094","32","20140416113641","PC","AAA02","6","90000","13800","76200","2014-04-16 11:36:41"
"10095","73","20140416103403","PC","AAA05","7","420000","140000","280000","2014-04-16 10:34:03"
"10096","10","20140416100832","PC","AAA04","6","48000","2400","45600","2014-04-16 10:08:32"
"10097","18","20140416080221","PC","AAA01","6","60000","12000","48000","2014-04-16 08:02:21"
"10098","59","20140415064500","Mobile","AAA05","1","60000","20000","40000","2014-04-15 18:45:00"
"10099","14","20140415013526","PC","AAA05","3","180000","60000","120000","2014-04-15 13:35:26"
"10100","81","20140415093810","PC","AAA02","3","45000","6900","38100","2014-04-15 09:38:10"
"10101","45","20140415073631","Shop","AAA04","3","24000","1200","22800","2014-04-15 07:36:31"
"10102","77","20140414031503","PC","AAA01","4","40000","8000","32000","2014-04-14 15:15:03"
"10103","100","20140414015325","Mobile","AAA03","3","51000","9000","42000","2014-04-14 13:53:25"
"10104","7","20140414125950","Shop","AAA03","6","102000","18000","84000","2014-04-14 12:59:50"
"10105","91","20140414113105","PC","AAA02","5","75000","11500","63500","2014-04-14 11:31:05"
"10106","72","20140414092021","PC","AAA02","1","15000","2300","12700","2014-04-14 09:20:21"
"10107","74","20140410072824","PC","AAA01","2","20000","4000","16000","2014-04-10 07:28:24"
"10108","32","20140409082744","Shop","AAA02","4","60000","9200","50800","2014-04-09 08:27:44"
"10109","76","20140409065550","PC","AAA02","2","30000","4600","25400","2014-04-09 06:55:50"
"10110","66","20140408091934","PC","AAA01","2","20000","4000","16000","2014-04-08 21:19:34"
"10111","67","20140408041716","Mobile","AAA02","1","15000","2300","12700","2014-04-08 16:17:16"
"10112","48","20140408010337","Shop","AAA05","2","120000","40000","80000","2014-04-08 13:03:37"
"10113","80","20140408125127","Shop","AAA01","3","30000","6000","24000","2014-04-08 12:51:27"
"10114","93","20140408111403","Mobile","AAA05","4","240000","80000","160000","2014-04-08 11:14:03"
"10115","25","20140408093357","PC","AAA04","9","72000","3600","68400","2014-04-08 09:33:57"
"10116","79","20140407120356","Mobile","AAA04","2","16000","800","15200","2014-04-07 12:03:56"
"10117","94","20140407101823","PC","AAA04","9","72000","3600","68400","2014-04-07 10:18:23"
"10118","73","20140407091250","Mobile","AAA01","4","40000","8000","32000","2014-04-07 09:12:50"
"10119","68","20140404113718","Shop","AAA01","4","40000","8000","32000","2014-04-04 11:37:18"
"10120","100","20140404100221","Shop","AAA04","7","56000","2800","53200","2014-04-04 10:02:21"
"10121","8","20140404082642","Mobile","AAA02","4","60000","9200","50800","2014-04-04 08:26:42"
"10122","81","20140404070023","PC","AAA04","1","8000","400","7600","2014-04-04 07:00:23"
"10123","64","20140403061234","Shop","AAA01","4","40000","8000","32000","2014-04-03 18:12:34"
"10124","97","20140403120031","PC","AAA04","3","24000","1200","22800","2014-04-03 12:00:31"
"10125","41","20140403103753","Mobile","AAA02","4","60000","9200","50800","2014-04-03 10:37:53"
"10126","31","20140403093227","Mobile","AAA01","1","10000","2000","8000","2014-04-03 09:32:27"
"10127","99","20140403083632","PC","AAA02","2","30000","4600","25400","2014-04-03 08:36:32"
"10128","31","20140403074312","PC","AAA04","4","32000","1600","30400","2014-04-03 07:43:12"
"10129","84","20140402033403","Mobile","AAA01","1","10000","2000","8000","2014-04-02 15:34:03"
"10130","48","20140402110456","PC","AAA03","4","68000","12000","56000","2014-04-02 11:04:56"
"10131","96","20140402091404","Mobile","AAA05","6","360000","120000","240000","2014-04-02 09:14:04"
"10132","34","20140402075454","PC","AAA01","9","90000","18000","72000","2014-04-02 07:54:54"
"10133","62","20140401094338","Mobile","AAA05","4","240000","80000","160000","2014-04-01 21:43:38"
"10134","13","20140401074532","PC","AAA05","2","120000","40000","80000","2014-04-01 19:45:32"
"10135","25","20140401015935","Mobile","AAA03","7","119000","21000","98000","2014-04-01 13:59:35"
"10136","52","20140401122043","PC","AAA05","2","120000","40000","80000","2014-04-01 12:20:43"
"10137","56","20140401105420","PC","AAA05","3","180000","60000","120000","2014-04-01 10:54:20"
"10138","2","20140401081442","Shop","AAA02","1","15000","2300","12700","2014-04-01 08:14:42"
"10139","20","20140401073706","PC","AAA05","4","240000","80000","160000","2014-04-01 07:37:06"
"10140","36","20140331085612","PC","AAA01","7","70000","14000","56000","2014-03-31 20:56:12"
"10141","42","20140331032759","Mobile","AAA02","6","90000","13800","76200","2014-03-31 15:27:59"
"10142","37","20140331020742","Mobile","AAA03","3","51000","9000","42000","2014-03-31 14:07:42"
"10143","49","20140331122352","PC","AAA02","9","135000","20700","114300","2014-03-31 12:23:52"
"10144","7","20140331112910","Shop","AAA01","8","80000","16000","64000","2014-03-31 11:29:10"
"10145","23","20140331103159","PC","AAA03","2","34000","6000","28000","2014-03-31 10:31:59"
"10146","61","20140331084207","Shop","AAA04","3","24000","1200","22800","2014-03-31 08:42:07"
"10147","7","20140330110153","PC","AAA05","1","60000","20000","40000","2014-03-30 11:01:53"
"10148","55","20140327060112","Mobile","AAA02","4","60000","9200","50800","2014-03-27 06:01:12"
"10149","17","20140326050525","PC","AAA05","2","120000","40000","80000","2014-03-26 17:05:25"
"10150","59","20140326033420","PC","AAA04","4","32000","1600","30400","2014-03-26 15:34:20"
"10151","53","20140326014102","PC","AAA01","2","20000","4000","16000","2014-03-26 13:41:02"
"10152","20","20140326092833","Mobile","AAA05","3","180000","60000","120000","2014-03-26 09:28:33"
"10153","24","20140326071539","PC","AAA02","2","30000","4600","25400","2014-03-26 07:15:39"
"10154","82","20140325090621","Mobile","AAA03","2","34000","6000","28000","2014-03-25 09:06:21"
"10155","81","20140324015042","PC","AAA02","1","15000","2300","12700","2014-03-24 13:50:42"
"10156","54","20140324113315","Mobile","AAA01","2","20000","4000","16000","2014-03-24 11:33:15"
"10157","9","20140322013000","PC","AAA05","2","120000","40000","80000","2014-03-22 01:30:00"
"10158","24","20140321035617","PC","AAA01","5","50000","10000","40000","2014-03-21 03:56:17"
"10159","84","20140320050835","Shop","AAA04","7","56000","2800","53200","2014-03-20 17:08:35"
"10160","91","20140320033850","Shop","AAA02","1","15000","2300","12700","2014-03-20 15:38:50"
"10161","97","20140320110952","Shop","AAA02","1","15000","2300","12700","2014-03-20 11:09:52"
"10162","47","20140320091535","PC","AAA01","7","70000","14000","56000","2014-03-20 09:15:35"
"10163","78","20140319034015","PC","AAA01","6","60000","12000","48000","2014-03-19 15:40:15"
"10164","49","20140319021236","PC","AAA04","11","88000","4400","83600","2014-03-19 14:12:36"
"10165","74","20140319123310","Mobile","AAA01","4","40000","8000","32000","2014-03-19 12:33:10"
"10166","28","20140319105934","Shop","AAA03","5","85000","15000","70000","2014-03-19 10:59:34"
"10167","21","20140318044938","PC","AAA05","1","60000","20000","40000","2014-03-18 16:49:38"
"10168","29","20140318034717","Shop","AAA02","3","45000","6900","38100","2014-03-18 15:47:17"
"10169","27","20140318024831","Shop","AAA02","2","30000","4600","25400","2014-03-18 14:48:31"
"10170","72","20140318012112","PC","AAA01","1","10000","2000","8000","2014-03-18 13:21:12"
"10171","10","20140318113754","Mobile","AAA02","4","60000","9200","50800","2014-03-18 11:37:54"
"10172","60","20140318095400","PC","AAA01","4","40000","8000","32000","2014-03-18 09:54:00"
"10173","7","20140318084650","PC","AAA04","6","48000","2400","45600","2014-03-18 08:46:50"
"10174","5","20140318073618","PC","AAA01","12","120000","24000","96000","2014-03-18 07:36:18"
"10175","54","20140317124504","Shop","AAA04","3","24000","1200","22800","2014-03-17 12:45:04"
"10176","25","20140317105345","Mobile","AAA02","5","75000","11500","63500","2014-03-17 10:53:45"
"10177","72","20140317091232","Mobile","AAA05","1","60000","20000","40000","2014-03-17 09:12:32"
"10178","9","20140310030653","Mobile","AAA05","1","60000","20000","40000","2014-03-10 15:06:53"
"10179","72","20140310014411","Mobile","AAA04","3","24000","1200","22800","2014-03-10 13:44:11"
"10180","34","20140310122548","Mobile","AAA01","4","40000","8000","32000","2014-03-10 12:25:48"
"10181","65","20140310095327","Shop","AAA04","9","72000","3600","68400","2014-03-10 09:53:27"
"10182","3","20140306024712","Shop","AAA04","12","96000","4800","91200","2014-03-06 02:47:12"
"10183","71","20140305022218","Mobile","AAA05","4","240000","80000","160000","2014-03-05 14:22:18"
"10184","97","20140305121438","PC","AAA02","1","15000","2300","12700","2014-03-05 12:14:38"
"10185","54","20140305103146","Shop","AAA02","1","15000","2300","12700","2014-03-05 10:31:46"
"10186","43","20140305100755","PC","AAA02","7","105000","16100","88900","2014-03-05 10:07:55"
"10187","18","20140305075240","PC","AAA02","3","45000","6900","38100","2014-03-05 07:52:40"
"10188","23","20140305120542","Mobile","AAA04","5","40000","2000","38000","2014-03-05 00:05:42"
"10189","64","20140304072753","Mobile","AAA02","2","30000","4600","25400","2014-03-04 07:27:53"
"10190","64","20140303050547","PC","AAA02","4","60000","9200","50800","2014-03-03 17:05:47"
"10191","34","20140303035039","Mobile","AAA04","10","80000","4000","76000","2014-03-03 15:50:39"
"10192","27","20140303024501","PC","AAA05","3","180000","60000","120000","2014-03-03 14:45:01"
"10193","37","20140303125328","Shop","AAA05","5","300000","100000","200000","2014-03-03 12:53:28"
"10194","95","20140303102940","Shop","AAA01","2","20000","4000","16000","2014-03-03 10:29:40"
"10195","4","20140303091253","Shop","AAA02","3","45000","6900","38100","2014-03-03 09:12:53"
"10196","89","20140227021559","PC","AAA03","6","102000","18000","84000","2014-02-27 14:15:59"
"10197","12","20140227011537","Shop","AAA05","7","420000","140000","280000","2014-02-27 13:15:37"
"10198","39","20140227115641","PC","AAA02","3","45000","6900","38100","2014-02-27 11:56:41"
"10199","21","20140227110215","PC","AAA04","2","16000","800","15200","2014-02-27 11:02:15"
"10200","45","20140227070009","Mobile","AAA04","1","8000","400","7600","2014-02-27 07:00:09"
"10201","70","20140227024246","Shop","AAA04","1","8000","400","7600","2014-02-27 02:42:46"
"10202","38","20140226040908","Shop","AAA04","5","40000","2000","38000","2014-02-26 16:09:08"
"10203","29","20140226024425","Shop","AAA03","5","85000","15000","70000","2014-02-26 14:44:25"
"10204","32","20140226013732","Shop","AAA03","13","221000","39000","182000","2014-02-26 13:37:32"
"10205","87","20140226113300","Shop","AAA01","6","60000","12000","48000","2014-02-26 11:33:00"
"10206","47","20140226104150","PC","AAA03","6","102000","18000","84000","2014-02-26 10:41:50"
"10207","75","20140226091131","PC","AAA05","3","180000","60000","120000","2014-02-26 09:11:31"
"10208","36","20140226072513","Mobile","AAA01","6","60000","12000","48000","2014-02-26 07:25:13"
"10209","44","20140225045500","PC","AAA05","4","240000","80000","160000","2014-02-25 16:55:00"
"10210","64","20140225020857","Shop","AAA04","2","16000","800","15200","2014-02-25 14:08:57"
"10211","4","20140225120624","Mobile","AAA04","4","32000","1600","30400","2014-02-25 12:06:24"
"10212","3","20140225085810","PC","AAA05","4","240000","80000","160000","2014-02-25 08:58:10"
"10213","64","20140225084045","Shop","AAA02","3","45000","6900","38100","2014-02-25 08:40:45"
"10214","58","20140224114055","Mobile","AAA04","4","32000","1600","30400","2014-02-24 23:40:55"
"10215","54","20140224032414","Mobile","AAA02","7","105000","16100","88900","2014-02-24 15:24:14"
"10216","64","20140224015435","Shop","AAA04","6","48000","2400","45600","2014-02-24 13:54:35"
"10217","61","20140224124617","PC","AAA04","2","16000","800","15200","2014-02-24 12:46:17"
"10218","64","20140222054914","PC","AAA04","7","56000","2800","53200","2014-02-22 05:49:14"
"10219","57","20140221022840","Shop","AAA05","1","60000","20000","40000","2014-02-21 14:28:40"
"10220","74","20140221112350","Shop","AAA05","1","60000","20000","40000","2014-02-21 11:23:50"
"10221","52","20140221095759","Mobile","AAA01","2","20000","4000","16000","2014-02-21 09:57:59"
"10222","35","20140220020029","Mobile","AAA02","4","60000","9200","50800","2014-02-20 14:00:29"
"10223","72","20140220121735","Shop","AAA02","2","30000","4600","25400","2014-02-20 12:17:35"
"10224","27","20140220103745","PC","AAA01","5","50000","10000","40000","2014-02-20 10:37:45"
"10225","85","20140219023118","Shop","AAA02","7","105000","16100","88900","2014-02-19 14:31:18"
"10226","77","20140219011636","Mobile","AAA04","1","8000","400","7600","2014-02-19 13:16:36"
"10227","55","20140219111859","Shop","AAA02","1","15000","2300","12700","2014-02-19 11:18:59"
"10228","47","20140219093357","Mobile","AAA01","5","50000","10000","40000","2014-02-19 09:33:57"
"10229","1","20140219075324","Mobile","AAA03","5","85000","15000","70000","2014-02-19 07:53:24"
"10230","23","20140219023635","Mobile","AAA05","3","180000","60000","120000","2014-02-19 02:36:35"
"10231","15","20140218114108","PC","AAA02","10","150000","23000","127000","2014-02-18 11:41:08"
"10232","1","20140218102915","PC","AAA03","3","51000","9000","42000","2014-02-18 10:29:15"
"10233","36","20140218092847","PC","AAA01","8","80000","16000","64000","2014-02-18 09:28:47"
"10234","94","20140217085508","PC","AAA05","8","480000","160000","320000","2014-02-17 20:55:08"
"10235","78","20140217045221","Shop","AAA05","4","240000","80000","160000","2014-02-17 16:52:21"
"10236","35","20140217032823","Shop","AAA01","3","30000","6000","24000","2014-02-17 15:28:23"
"10237","57","20140217020233","Mobile","AAA03","1","17000","3000","14000","2014-02-17 14:02:33"
"10238","53","20140217124224","Mobile","AAA01","2","20000","4000","16000","2014-02-17 12:42:24"
"10239","42","20140217114437","PC","AAA05","5","300000","100000","200000","2014-02-17 11:44:37"
"10240","23","20140217095322","PC","AAA04","2","16000","800","15200","2014-02-17 09:53:22"
"10241","25","20140213073832","Mobile","AAA02","9","135000","20700","114300","2014-02-13 07:38:32"
"10242","2","20140212040243","PC","AAA05","7","420000","140000","280000","2014-02-12 16:02:43"
"10243","71","20140212120745","PC","AAA02","5","75000","11500","63500","2014-02-12 12:07:45"
"10244","50","20140212100015","PC","AAA03","7","119000","21000","98000","2014-02-12 10:00:15"
"10245","65","20140212084332","Mobile","AAA04","1","8000","400","7600","2014-02-12 08:43:32"
"10246","46","20140211062327","PC","AAA04","3","24000","1200","22800","2014-02-11 18:23:27"
"10247","83","20140211040735","Shop","AAA04","9","72000","3600","68400","2014-02-11 16:07:35"
"10248","57","20140211022111","PC","AAA02","6","90000","13800","76200","2014-02-11 14:21:11"
"10249","99","20140211015348","Shop","AAA04","1","8000","400","7600","2014-02-11 13:53:48"
"10250","19","20140211115359","PC","AAA04","1","8000","400","7600","2014-02-11 11:53:59"
"10251","60","20140211110851","Mobile","AAA03","5","85000","15000","70000","2014-02-11 11:08:51"
"10252","83","20140211093432","Mobile","AAA03","5","85000","15000","70000","2014-02-11 09:34:32"
"10253","61","20140211081032","Shop","AAA04","4","32000","1600","30400","2014-02-11 08:10:32"
"10254","28","20140210091911","Mobile","AAA05","2","120000","40000","80000","2014-02-10 21:19:11"
"10255","64","20140210052119","PC","AAA05","1","60000","20000","40000","2014-02-10 17:21:19"
"10256","99","20140210010054","PC","AAA02","5","75000","11500","63500","2014-02-10 13:00:54"
"10257","50","20140210112500","Mobile","AAA05","2","120000","40000","80000","2014-02-10 11:25:00"
"10258","99","20140205114834","Shop","AAA03","4","68000","12000","56000","2014-02-05 23:48:34"
"10259","92","20140205083405","PC","AAA03","12","204000","36000","168000","2014-02-05 08:34:05"
"10260","32","20140205073637","Mobile","AAA05","2","120000","40000","80000","2014-02-05 07:36:37"
"10261","36","20140204052710","Shop","AAA03","8","136000","24000","112000","2014-02-04 17:27:10"
"10262","49","20140204035020","Mobile","AAA03","4","68000","12000","56000","2014-02-04 15:50:20"
"10263","8","20140204023205","PC","AAA01","5","50000","10000","40000","2014-02-04 14:32:05"
"10264","89","20140204013011","Mobile","AAA02","9","135000","20700","114300","2014-02-04 13:30:11"
"10265","9","20140204120359","Mobile","AAA03","4","68000","12000","56000","2014-02-04 12:03:59"
"10266","64","20140204101804","Shop","AAA01","1","10000","2000","8000","2014-02-04 10:18:04"
"10267","11","20140204071219","PC","AAA01","3","30000","6000","24000","2014-02-04 07:12:19"
"10268","17","20140203081124","Mobile","AAA02","1","15000","2300","12700","2014-02-03 20:11:24"
"10269","35","20140203045824","PC","AAA02","5","75000","11500","63500","2014-02-03 16:58:24"
"10270","72","20140203044554","Mobile","AAA03","2","34000","6000","28000","2014-02-03 16:45:54"
"10271","47","20140203033334","Shop","AAA05","4","240000","80000","160000","2014-02-03 15:33:34"
"10272","34","20140203122108","Shop","AAA01","13","130000","26000","104000","2014-02-03 12:21:08"
"10273","94","20140203104344","Shop","AAA04","14","112000","5600","106400","2014-02-03 10:43:44"
"10274","70","20140203093253","Mobile","AAA04","6","48000","2400","45600","2014-02-03 09:32:53"
"10275","28","20140129023052","Shop","AAA04","6","48000","2400","45600","2014-01-29 14:30:52"
"10276","82","20140129122038","Shop","AAA05","2","120000","40000","80000","2014-01-29 12:20:38"
"10277","62","20140129082449","Mobile","AAA02","5","75000","11500","63500","2014-01-29 08:24:49"
"10278","28","20140129062544","Shop","AAA05","2","120000","40000","80000","2014-01-29 06:25:44"
"10279","76","20140128060225","PC","AAA02","3","45000","6900","38100","2014-01-28 18:02:25"
"10280","51","20140128125102","Shop","AAA01","4","40000","8000","32000","2014-01-28 12:51:02"
"10281","64","20140128102324","Mobile","AAA03","2","34000","6000","28000","2014-01-28 10:23:24"
"10282","47","20140128083537","Shop","AAA05","2","120000","40000","80000","2014-01-28 08:35:37"
"10283","83","20140128064459","PC","AAA02","10","150000","23000","127000","2014-01-28 06:44:59"
"10284","34","20140127091144","Shop","AAA04","2","16000","800","15200","2014-01-27 21:11:44"
"10285","2","20140127033550","Mobile","AAA04","3","24000","1200","22800","2014-01-27 15:35:50"
"10286","81","20140127011426","PC","AAA05","1","60000","20000","40000","2014-01-27 13:14:26"
"10287","69","20140127111449","Shop","AAA01","3","30000","6000","24000","2014-01-27 11:14:49"
"10288","53","20140127094941","Shop","AAA01","5","50000","10000","40000","2014-01-27 09:49:41"
"10289","90","20140124094914","Mobile","AAA04","2","16000","800","15200","2014-01-24 09:49:14"
"10290","8","20140124072941","Shop","AAA04","2","16000","800","15200","2014-01-24 07:29:41"
"10291","20","20140123092042","Mobile","AAA03","3","51000","9000","42000","2014-01-23 21:20:42"
"10292","100","20140123042333","Mobile","AAA03","5","85000","15000","70000","2014-01-23 16:23:33"
"10293","44","20140123022926","PC","AAA02","2","30000","4600","25400","2014-01-23 14:29:26"
"10294","42","20140123012640","Mobile","AAA01","2","20000","4000","16000","2014-01-23 13:26:40"
"10295","39","20140123114446","PC","AAA03","5","85000","15000","70000","2014-01-23 11:44:46"
"10296","89","20140123093627","Shop","AAA01","5","50000","10000","40000","2014-01-23 09:36:27"
"10297","8","20140123081122","Mobile","AAA05","3","180000","60000","120000","2014-01-23 08:11:22"
"10298","17","20140123064029","Shop","AAA01","1","10000","2000","8000","2014-01-23 06:40:29"
"10299","89","20140122025919","Shop","AAA02","8","120000","18400","101600","2014-01-22 14:59:19"
"10300","95","20140122010644","PC","AAA03","5","85000","15000","70000","2014-01-22 13:06:44"
"10301","21","20140122121609","Mobile","AAA05","2","120000","40000","80000","2014-01-22 12:16:09"
"10302","24","20140122084429","Shop","AAA02","5","75000","11500","63500","2014-01-22 08:44:29"
"10303","47","20140122074933","Shop","AAA03","8","136000","24000","112000","2014-01-22 07:49:33"
"10304","44","20140121070831","Shop","AAA03","3","51000","9000","42000","2014-01-21 19:08:31"
"10305","11","20140121040736","Mobile","AAA01","4","40000","8000","32000","2014-01-21 16:07:36"
"10306","60","20140121114739","PC","AAA03","2","34000","6000","28000","2014-01-21 11:47:39"
"10307","86","20140121095729","Shop","AAA02","2","30000","4600","25400","2014-01-21 09:57:29"
"10308","43","20140121083318","Mobile","AAA02","5","75000","11500","63500","2014-01-21 08:33:18"
"10309","81","20140121064754","PC","AAA02","3","45000","6900","38100","2014-01-21 06:47:54"
"10310","77","20140120054811","PC","AAA03","4","68000","12000","56000","2014-01-20 17:48:11"
"10311","2","20140120040947","PC","AAA02","1","15000","2300","12700","2014-01-20 16:09:47"
"10312","42","20140120030538","Shop","AAA03","6","102000","18000","84000","2014-01-20 15:05:38"
"10313","55","20140120014600","Shop","AAA01","4","40000","8000","32000","2014-01-20 13:46:00"
"10314","61","20140120123539","Shop","AAA03","1","17000","3000","14000","2014-01-20 12:35:39"
"10315","23","20140120103522","PC","AAA05","4","240000","80000","160000","2014-01-20 10:35:22"
"10316","83","20140120080208","Shop","AAA02","8","120000","18400","101600","2014-01-20 08:02:08"
"10317","58","20140116115557","Mobile","AAA01","1","10000","2000","8000","2014-01-16 23:55:57"
"10318","25","20140116122119","Shop","AAA05","11","660000","220000","440000","2014-01-16 12:21:19"
"10319","22","20140116113757","Shop","AAA03","4","68000","12000","56000","2014-01-16 11:37:57"
"10320","40","20140116092222","Mobile","AAA05","4","240000","80000","160000","2014-01-16 09:22:22"
"10321","3","20140116065845","PC","AAA05","5","300000","100000","200000","2014-01-16 06:58:45"
"10322","39","20140115051838","Shop","AAA03","1","17000","3000","14000","2014-01-15 17:18:38"
"10323","11","20140115025912","Shop","AAA02","4","60000","9200","50800","2014-01-15 14:59:12"
"10324","72","20140115013735","Mobile","AAA01","2","20000","4000","16000","2014-01-15 13:37:35"
"10325","27","20140115114542","Mobile","AAA03","9","153000","27000","126000","2014-01-15 11:45:42"
"10326","62","20140115103944","Shop","AAA01","10","100000","20000","80000","2014-01-15 10:39:44"
"10327","98","20140115092545","Shop","AAA02","1","15000","2300","12700","2014-01-15 09:25:45"
"10328","100","20140115072702","Mobile","AAA02","4","60000","9200","50800","2014-01-15 07:27:02"
"10329","31","20140114085602","Shop","AAA03","5","85000","15000","70000","2014-01-14 20:56:02"
"10330","99","20140114024559","Shop","AAA02","3","45000","6900","38100","2014-01-14 14:45:59"
"10331","81","20140114014153","Shop","AAA04","1","8000","400","7600","2014-01-14 13:41:53"
"10332","39","20140114010046","Shop","AAA01","2","20000","4000","16000","2014-01-14 13:00:46"
"10333","65","20140114100549","Shop","AAA05","2","120000","40000","80000","2014-01-14 10:05:49"
"10334","41","20140114080230","PC","AAA03","4","68000","12000","56000","2014-01-14 08:02:30"
"10335","70","20140114064343","Shop","AAA03","8","136000","24000","112000","2014-01-14 06:43:43"
"10336","47","20140113013034","PC","AAA01","8","80000","16000","64000","2014-01-13 13:30:34"
"10337","8","20140113123648","PC","AAA05","9","540000","180000","360000","2014-01-13 12:36:48"
"10338","10","20140113122014","PC","AAA01","5","50000","10000","40000","2014-01-13 12:20:14"
"10339","28","20140113110158","Shop","AAA02","5","75000","11500","63500","2014-01-13 11:01:58"
"10340","66","20140108120059","Mobile","AAA03","3","51000","9000","42000","2014-01-08 00:00:59"
"10341","72","20140107010241","Mobile","AAA03","3","51000","9000","42000","2014-01-07 13:02:41"
"10342","32","20140107114455","Shop","AAA05","4","240000","80000","160000","2014-01-07 11:44:55"
"10343","71","20140107093507","PC","AAA05","3","180000","60000","120000","2014-01-07 09:35:07"
"10344","88","20140106080235","Shop","AAA02","2","30000","4600","25400","2014-01-06 20:02:35"
"10345","27","20140106092038","PC","AAA03","6","102000","18000","84000","2014-01-06 21:20:38"
"10346","15","20140106073319","PC","AAA01","16","160000","32000","128000","2014-01-06 19:33:19"
"10347","15","20140106014255","Shop","AAA02","5","75000","11500","63500","2014-01-06 13:42:55"
"10348","17","20140106113507","Mobile","AAA03","4","68000","12000","56000","2014-01-06 11:35:07"
"10349","15","20140106095015","PC","AAA05","8","480000","160000","320000","2014-01-06 09:50:15"
"10350","9","20140102063820","Shop","AAA05","2","120000","40000","80000","2014-01-02 18:38:20"
"10351","54","20140102012843","Mobile","AAA05","4","240000","80000","160000","2014-01-02 13:28:43"
"10352","57","20140102102556","Mobile","AAA04","1","8000","400","7600","2014-01-02 10:25:56"
"10353","29","20140102085303","Mobile","AAA03","5","85000","15000","70000","2014-01-02 08:53:03"
"10354","73","20140101043150","Shop","AAA03","1","17000","3000","14000","2014-01-01 16:31:50"
"10355","85","20140101030959","Shop","AAA01","3","30000","6000","24000","2014-01-01 15:09:59"
"10356","100","20140101110311","PC","AAA01","5","50000","10000","40000","2014-01-01 11:03:11"
"10357","85","20140101090733","Shop","AAA05","1","60000","20000","40000","2014-01-01 09:07:33"
"10358","33","20140101075305","Mobile","AAA03","1","17000","3000","14000","2014-01-01 07:53:05"
"10359","11","20131231091827","PC","AAA03","3","51000","9000","42000","2013-12-31 21:18:27"
"10360","59","20131231030343","Shop","AAA04","2","16000","800","15200","2013-12-31 15:03:43"
"10361","24","20131231012451","PC","AAA02","6","90000","13800","76200","2013-12-31 13:24:51"
"10362","60","20131231120243","PC","AAA01","4","40000","8000","32000","2013-12-31 12:02:43"
"10363","32","20131231084903","Shop","AAA01","4","40000","8000","32000","2013-12-31 08:49:03"
"10364","15","20131230034409","PC","AAA02","8","120000","18400","101600","2013-12-30 15:44:09"
"10365","75","20131230012500","Shop","AAA04","1","8000","400","7600","2013-12-30 13:25:00"
"10366","79","20131230115659","Mobile","AAA03","3","51000","9000","42000","2013-12-30 11:56:59"
"10367","37","20131230110304","Mobile","AAA04","1","8000","400","7600","2013-12-30 11:03:04"
"10368","85","20131230092519","Shop","AAA02","5","75000","11500","63500","2013-12-30 09:25:19"
"10369","83","20131226084033","Shop","AAA04","1","8000","400","7600","2013-12-26 20:40:33"
"10370","84","20131226022503","PC","AAA05","1","60000","20000","40000","2013-12-26 14:25:03"
"10371","25","20131226011218","PC","AAA05","2","120000","40000","80000","2013-12-26 13:12:18"
"10372","41","20131226075816","PC","AAA05","6","360000","120000","240000","2013-12-26 07:58:16"
"10373","95","20131225092027","Shop","AAA05","1","60000","20000","40000","2013-12-25 21:20:27"
"10374","83","20131225043133","Mobile","AAA03","5","85000","15000","70000","2013-12-25 16:31:33"
"10375","37","20131225033625","Mobile","AAA02","3","45000","6900","38100","2013-12-25 15:36:25"
"10376","87","20131225012351","Mobile","AAA02","4","60000","9200","50800","2013-12-25 13:23:51"
"10377","89","20131225112421","Shop","AAA01","4","40000","8000","32000","2013-12-25 11:24:21"
"10378","72","20131225081111","PC","AAA01","3","30000","6000","24000","2013-12-25 08:11:11"
"10379","10","20131225062843","Mobile","AAA01","4","40000","8000","32000","2013-12-25 06:28:43"
"10380","50","20131225122429","Shop","AAA02","8","120000","18400","101600","2013-12-25 00:24:29"
"10381","68","20131224092337","Shop","AAA04","2","16000","800","15200","2013-12-24 09:23:37"
"10382","37","20131224075407","Mobile","AAA05","5","300000","100000","200000","2013-12-24 07:54:07"
"10383","17","20131224024929","Mobile","AAA02","5","75000","11500","63500","2013-12-24 02:49:29"
"10384","41","20131220032025","Mobile","AAA01","2","20000","4000","16000","2013-12-20 15:20:25"
"10385","87","20131220020236","Shop","AAA05","1","60000","20000","40000","2013-12-20 14:02:36"
"10386","39","20131220122812","Mobile","AAA02","3","45000","6900","38100","2013-12-20 12:28:12"
"10387","27","20131220075803","Mobile","AAA02","5","75000","11500","63500","2013-12-20 07:58:03"
"10388","88","20131220062246","Shop","AAA02","4","60000","9200","50800","2013-12-20 06:22:46"
"10389","60","20131219064924","Shop","AAA03","1","17000","3000","14000","2013-12-19 18:49:24"
"10390","94","20131219021402","Shop","AAA01","9","90000","18000","72000","2013-12-19 14:14:02"
"10391","40","20131219120851","PC","AAA05","1","60000","20000","40000","2013-12-19 12:08:51"
"10392","47","20131219103817","PC","AAA01","4","40000","8000","32000","2013-12-19 10:38:17"
"10393","57","20131219083000","Mobile","AAA01","1","10000","2000","8000","2013-12-19 08:30:00"
"10394","26","20131219061459","PC","AAA03","1","17000","3000","14000","2013-12-19 06:14:59"
"10395","10","20131218095337","Shop","AAA05","6","360000","120000","240000","2013-12-18 09:53:37"
"10396","45","20131218092004","PC","AAA05","2","120000","40000","80000","2013-12-18 09:20:04"
"10397","20","20131218070515","PC","AAA05","1","60000","20000","40000","2013-12-18 07:05:15"
"10398","2","20131218045909","Mobile","AAA03","5","85000","15000","70000","2013-12-18 04:59:09"
"10399","80","20131217081730","Mobile","AAA01","4","40000","8000","32000","2013-12-17 08:17:30"
"10400","76","20131217071622","Mobile","AAA03","2","34000","6000","28000","2013-12-17 07:16:22"
"10401","22","20131216083403","Mobile","AAA03","4","68000","12000","56000","2013-12-16 08:34:03"
"10402","53","20131213074609","Mobile","AAA05","2","120000","40000","80000","2013-12-13 07:46:09"
"10403","2","20131212095926","Shop","AAA03","3","51000","9000","42000","2013-12-12 21:59:26"
"10404","50","20131212041734","Shop","AAA04","9","72000","3600","68400","2013-12-12 16:17:34"
"10405","99","20131212015225","Mobile","AAA04","3","24000","1200","22800","2013-12-12 13:52:25"
"10406","39","20131212074043","PC","AAA01","4","40000","8000","32000","2013-12-12 07:40:43"
"10407","88","20131211031223","Shop","AAA01","2","20000","4000","16000","2013-12-11 15:12:23"
"10408","42","20131211111022","PC","AAA03","1","17000","3000","14000","2013-12-11 11:10:22"
"10409","8","20131211085344","Mobile","AAA04","5","40000","2000","38000","2013-12-11 08:53:44"
"10410","25","20131211074607","PC","AAA03","2","34000","6000","28000","2013-12-11 07:46:07"
"10411","50","20131210113427","Mobile","AAA04","2","16000","800","15200","2013-12-10 11:34:27"
"10412","3","20131210064902","PC","AAA05","8","480000","160000","320000","2013-12-10 06:49:02"
"10413","78","20131209053923","PC","AAA01","3","30000","6000","24000","2013-12-09 17:39:23"
"10414","34","20131209034434","Shop","AAA02","1","15000","2300","12700","2013-12-09 15:44:34"
"10415","25","20131209020843","PC","AAA02","5","75000","11500","63500","2013-12-09 14:08:43"
"10416","28","20131209122716","Shop","AAA01","7","70000","14000","56000","2013-12-09 12:27:16"
"10417","36","20131209102706","PC","AAA03","7","119000","21000","98000","2013-12-09 10:27:06"
"10418","12","20131209085754","Shop","AAA02","2","30000","4600","25400","2013-12-09 08:57:54"
"10419","67","20131204114424","Mobile","AAA02","4","60000","9200","50800","2013-12-04 23:44:24"
"10420","41","20131204062733","Mobile","AAA03","4","68000","12000","56000","2013-12-04 06:27:33"
"10421","19","20131203033619","Mobile","AAA02","3","45000","6900","38100","2013-12-03 15:36:19"
"10422","15","20131203023904","Shop","AAA01","5","50000","10000","40000","2013-12-03 14:39:04"
"10423","73","20131203013724","Mobile","AAA03","6","102000","18000","84000","2013-12-03 13:37:24"
"10424","70","20131203114722","Mobile","AAA05","7","420000","140000","280000","2013-12-03 11:47:22"
"10425","10","20131203102308","Shop","AAA02","6","90000","13800","76200","2013-12-03 10:23:08"
"10426","4","20131203093511","PC","AAA01","5","50000","10000","40000","2013-12-03 09:35:11"
"10427","100","20131203083125","PC","AAA05","1","60000","20000","40000","2013-12-03 08:31:25"
"10428","21","20131203064514","PC","AAA04","2","16000","800","15200","2013-12-03 06:45:14"
"10429","31","20131202031603","PC","AAA01","1","10000","2000","8000","2013-12-02 15:16:03"
"10430","7","20131202011008","Mobile","AAA03","1","17000","3000","14000","2013-12-02 13:10:08"
"10431","54","20131202112958","Shop","AAA03","3","51000","9000","42000","2013-12-02 11:29:58"
"10432","77","20131127091418","Mobile","AAA03","1","17000","3000","14000","2013-11-27 21:14:18"
"10433","10","20131127043211","Shop","AAA02","11","165000","25300","139700","2013-11-27 16:32:11"
"10434","57","20131127020555","Mobile","AAA03","1","17000","3000","14000","2013-11-27 14:05:55"
"10435","2","20131127113831","PC","AAA01","3","30000","6000","24000","2013-11-27 11:38:31"
"10436","8","20131127080435","Shop","AAA03","6","102000","18000","84000","2013-11-27 08:04:35"
"10437","77","20131127063416","Shop","AAA01","4","40000","8000","32000","2013-11-27 06:34:16"
"10438","42","20131126011001","Mobile","AAA05","2","120000","40000","80000","2013-11-26 13:10:01"
"10439","72","20131126121729","Mobile","AAA05","3","180000","60000","120000","2013-11-26 12:17:29"
"10440","85","20131126110639","Shop","AAA04","1","8000","400","7600","2013-11-26 11:06:39"
"10441","27","20131126093936","Shop","AAA01","1","10000","2000","8000","2013-11-26 09:39:36"
"10442","28","20131126073645","Mobile","AAA03","8","136000","24000","112000","2013-11-26 07:36:45"
"10443","30","20131125024047","Shop","AAA05","4","240000","80000","160000","2013-11-25 14:40:47"
"10444","6","20131125114242","PC","AAA05","3","180000","60000","120000","2013-11-25 11:42:42"
"10445","20","20131125102910","Mobile","AAA03","1","17000","3000","14000","2013-11-25 10:29:10"
"10446","97","20131125092755","Mobile","AAA04","6","48000","2400","45600","2013-11-25 09:27:55"
"10447","9","20131120031229","PC","AAA01","4","40000","8000","32000","2013-11-20 15:12:29"
"10448","50","20131120014242","Shop","AAA02","6","90000","13800","76200","2013-11-20 13:42:42"
"10449","36","20131120112824","Mobile","AAA04","7","56000","2800","53200","2013-11-20 11:28:24"
"10450","65","20131119120142","Shop","AAA04","2","16000","800","15200","2013-11-19 12:01:42"
"10451","34","20131119110601","Shop","AAA05","1","60000","20000","40000","2013-11-19 11:06:01"
"10452","13","20131119084429","Mobile","AAA05","1","60000","20000","40000","2013-11-19 08:44:29"
"10453","15","20131118121009","PC","AAA02","10","150000","23000","127000","2013-11-18 12:10:09"
"10454","89","20131118111253","PC","AAA05","6","360000","120000","240000","2013-11-18 11:12:53"
"10455","94","20131114095413","Shop","AAA05","1","60000","20000","40000","2013-11-14 09:54:13"
"10456","71","20131114065512","Shop","AAA01","6","60000","12000","48000","2013-11-14 06:55:12"
"10457","62","20131113043200","Shop","AAA03","5","85000","15000","70000","2013-11-13 16:32:00"
"10458","77","20131113021807","PC","AAA05","2","120000","40000","80000","2013-11-13 14:18:07"
"10459","50","20131113121842","Shop","AAA03","10","170000","30000","140000","2013-11-13 12:18:42"
"10460","59","20131113104340","Shop","AAA05","3","180000","60000","120000","2013-11-13 10:43:40"
"10461","44","20131113071726","Shop","AAA02","8","120000","18400","101600","2013-11-13 07:17:26"
"10462","7","20131112082017","Shop","AAA01","1","10000","2000","8000","2013-11-12 20:20:17"
"10463","93","20131112035919","Mobile","AAA03","1","17000","3000","14000","2013-11-12 15:59:19"
"10464","19","20131112020909","PC","AAA04","1","8000","400","7600","2013-11-12 14:09:09"
"10465","83","20131112122231","Mobile","AAA01","3","30000","6000","24000","2013-11-12 12:22:31"
"10466","45","20131112102457","PC","AAA05","1","60000","20000","40000","2013-11-12 10:24:57"
"10467","21","20131111065229","PC","AAA02","7","105000","16100","88900","2013-11-11 06:52:29"
"10468","80","20131107032015","Shop","AAA04","2","16000","800","15200","2013-11-07 03:20:15"
"10469","76","20131106124441","Shop","AAA03","2","34000","6000","28000","2013-11-06 12:44:41"
"10470","11","20131106105449","Shop","AAA01","6","60000","12000","48000","2013-11-06 10:54:49"
"10471","66","20131106092019","Mobile","AAA05","3","180000","60000","120000","2013-11-06 09:20:19"
"10472","15","20131106075915","Mobile","AAA01","7","70000","14000","56000","2013-11-06 07:59:15"
"10473","84","20131105102945","Shop","AAA04","2","16000","800","15200","2013-11-05 10:29:45"
"10474","57","20131105080935","Shop","AAA02","2","30000","4600","25400","2013-11-05 08:09:35"
"10475","18","20131105070900","Mobile","AAA01","1","10000","2000","8000","2013-11-05 07:09:00"
"10476","34","20131104033743","Mobile","AAA03","5","85000","15000","70000","2013-11-04 15:37:43"
"10477","48","20131104015705","Shop","AAA05","2","120000","40000","80000","2013-11-04 13:57:05"
"10478","47","20131104101310","PC","AAA04","2","16000","800","15200","2013-11-04 10:13:10"
"10479","42","20131104091545","Shop","AAA05","6","360000","120000","240000","2013-11-04 09:15:45"
"10480","37","20131101075230","Shop","AAA02","3","45000","6900","38100","2013-11-01 07:52:30"
"10481","35","20131031061149","Mobile","AAA05","5","300000","100000","200000","2013-10-31 18:11:49"
"10482","74","20131031032252","Shop","AAA05","3","180000","60000","120000","2013-10-31 15:22:52"
"10483","56","20131031022135","Shop","AAA03","7","119000","21000","98000","2013-10-31 14:21:35"
"10484","32","20131031124339","Shop","AAA03","7","119000","21000","98000","2013-10-31 12:43:39"
"10485","95","20131031105231","Mobile","AAA03","3","51000","9000","42000","2013-10-31 10:52:31"
"10486","9","20131031083811","Mobile","AAA04","3","24000","1200","22800","2013-10-31 08:38:11"
"10487","53","20131030113530","Shop","AAA01","3","30000","6000","24000","2013-10-30 23:35:30"
"10488","84","20131030021712","Shop","AAA04","2","16000","800","15200","2013-10-30 14:17:12"
"10489","10","20131030125638","PC","AAA04","3","24000","1200","22800","2013-10-30 12:56:38"
"10490","5","20131030114732","PC","AAA04","8","64000","3200","60800","2013-10-30 11:47:32"
"10491","13","20131030101302","Shop","AAA03","1","17000","3000","14000","2013-10-30 10:13:02"
"10492","3","20131030092122","Shop","AAA02","7","105000","16100","88900","2013-10-30 09:21:22"
"10493","24","20131030073246","PC","AAA05","2","120000","40000","80000","2013-10-30 07:32:46"
"10494","75","20131029024805","Mobile","AAA05","1","60000","20000","40000","2013-10-29 14:48:05"
"10495","86","20131029014513","PC","AAA02","1","15000","2300","12700","2013-10-29 13:45:13"
"10496","32","20131029122952","PC","AAA05","6","360000","120000","240000","2013-10-29 12:29:52"
"10497","35","20131029112046","Mobile","AAA05","3","180000","60000","120000","2013-10-29 11:20:46"
"10498","46","20131029102420","Shop","AAA02","6","90000","13800","76200","2013-10-29 10:24:20"
"10499","87","20131029085556","PC","AAA03","1","17000","3000","14000","2013-10-29 08:55:56"
"10500","72","20131029065056","PC","AAA02","3","45000","6900","38100","2013-10-29 06:50:56"
"10501","78","20131029013950","Shop","AAA03","4","68000","12000","56000","2013-10-29 01:39:50"
"10502","10","20131028072943","PC","AAA05","7","420000","140000","280000","2013-10-28 19:29:43"
"10503","64","20131028023733","PC","AAA04","1","8000","400","7600","2013-10-28 14:37:33"
"10504","50","20131028121932","PC","AAA01","1","10000","2000","8000","2013-10-28 12:19:32"
"10505","2","20131028112343","Mobile","AAA05","1","60000","20000","40000","2013-10-28 11:23:43"
"10506","90","20131025084441","Shop","AAA02","2","30000","4600","25400","2013-10-25 08:44:41"
"10507","5","20131025071940","PC","AAA03","5","85000","15000","70000","2013-10-25 07:19:40"
"10508","15","20131024011725","PC","AAA05","8","480000","160000","320000","2013-10-24 13:17:25"
"10509","61","20131024103444","PC","AAA01","2","20000","4000","16000","2013-10-24 10:34:44"
"10510","75","20131024074223","Shop","AAA04","1","8000","400","7600","2013-10-24 07:42:23"
"10511","10","20131023073043","Shop","AAA03","5","85000","15000","70000","2013-10-23 19:30:43"
"10512","9","20131023112319","Shop","AAA01","3","30000","6000","24000","2013-10-23 11:23:19"
"10513","60","20131023084846","Shop","AAA01","3","30000","6000","24000","2013-10-23 08:48:46"
"10514","45","20131023071427","Mobile","AAA05","1","60000","20000","40000","2013-10-23 07:14:27"
"10515","54","20131022082609","Shop","AAA02","4","60000","9200","50800","2013-10-22 08:26:09"
"10516","50","20131022063610","PC","AAA03","5","85000","15000","70000","2013-10-22 06:36:10"
"10517","43","20131022024309","Shop","AAA03","6","102000","18000","84000","2013-10-22 02:43:09"
"10518","66","20131021011920","Shop","AAA02","1","15000","2300","12700","2013-10-21 01:19:20"
"10519","27","20131016094851","Shop","AAA05","6","360000","120000","240000","2013-10-16 09:48:51"
"10520","48","20131016083512","PC","AAA05","4","240000","80000","160000","2013-10-16 08:35:12"
"10521","48","20131016071114","PC","AAA01","2","20000","4000","16000","2013-10-16 07:11:14"
"10522","89","20131015103143","PC","AAA01","1","10000","2000","8000","2013-10-15 10:31:43"
"10523","13","20131015085112","Mobile","AAA03","2","34000","6000","28000","2013-10-15 08:51:12"
"10524","16","20131015072027","PC","AAA03","8","136000","24000","112000","2013-10-15 07:20:27"
"10525","54","20131014092202","Shop","AAA04","1","8000","400","7600","2013-10-14 21:22:02"
"10526","95","20131014021018","Shop","AAA03","3","51000","9000","42000","2013-10-14 14:10:18"
"10527","72","20131014125206","Mobile","AAA01","3","30000","6000","24000","2013-10-14 12:52:06"
"10528","95","20131014113617","PC","AAA04","3","24000","1200","22800","2013-10-14 11:36:17"
"10529","68","20131011014130","PC","AAA05","7","420000","140000","280000","2013-10-11 01:41:30"
"10530","3","20131010101816","Mobile","AAA01","5","50000","10000","40000","2013-10-10 10:18:16"
"10531","68","20131010091445","PC","AAA03","1","17000","3000","14000","2013-10-10 09:14:45"
"10532","65","20131010072742","Mobile","AAA04","7","56000","2800","53200","2013-10-10 07:27:42"
"10533","85","20131009090507","Mobile","AAA02","6","90000","13800","76200","2013-10-09 21:05:07"
"10534","5","20131009033815","PC","AAA05","5","300000","100000","200000","2013-10-09 15:38:15"
"10535","57","20131009014805","PC","AAA04","1","8000","400","7600","2013-10-09 13:48:05"
"10536","69","20131009114703","PC","AAA01","1","10000","2000","8000","2013-10-09 11:47:03"
"10537","42","20131009094407","Mobile","AAA03","5","85000","15000","70000","2013-10-09 09:44:07"
"10538","28","20131009072347","Mobile","AAA03","5","85000","15000","70000","2013-10-09 07:23:47"
"10539","100","20131008035827","Shop","AAA03","3","51000","9000","42000","2013-10-08 15:58:27"
"10540","98","20131008025159","PC","AAA01","1","10000","2000","8000","2013-10-08 14:51:59"
"10541","15","20131008012545","PC","AAA05","4","240000","80000","160000","2013-10-08 13:25:45"
"10542","24","20131008103100","Shop","AAA01","5","50000","10000","40000","2013-10-08 10:31:00"
"10543","68","20131008085803","Mobile","AAA05","1","60000","20000","40000","2013-10-08 08:58:03"
"10544","63","20131008071638","Mobile","AAA01","2","20000","4000","16000","2013-10-08 07:16:38"
"10545","21","20131007075102","PC","AAA03","3","51000","9000","42000","2013-10-07 19:51:02"
"10546","82","20131007025928","PC","AAA03","1","17000","3000","14000","2013-10-07 14:59:28"
"10547","49","20131007123451","Mobile","AAA05","7","420000","140000","280000","2013-10-07 12:34:51"
"10548","42","20131007105107","Mobile","AAA01","3","30000","6000","24000","2013-10-07 10:51:07"
"10549","59","20131007091859","PC","AAA02","3","45000","6900","38100","2013-10-07 09:18:59"
"10550","64","20131003093909","Mobile","AAA03","1","17000","3000","14000","2013-10-03 09:39:09"
"10551","89","20131003072659","PC","AAA03","11","187000","33000","154000","2013-10-03 07:26:59"
"10552","61","20131002025606","Mobile","AAA03","4","68000","12000","56000","2013-10-02 14:56:06"
"10553","53","20131002015854","Shop","AAA01","3","30000","6000","24000","2013-10-02 13:58:54"
"10554","99","20131002115629","Shop","AAA03","1","17000","3000","14000","2013-10-02 11:56:29"
"10555","7","20131002094233","PC","AAA02","7","105000","16100","88900","2013-10-02 09:42:33"
"10556","28","20131002080108","Mobile","AAA04","5","40000","2000","38000","2013-10-02 08:01:08"
"10557","25","20131002072507","Shop","AAA03","6","102000","18000","84000","2013-10-02 07:25:07"
"10558","42","20131001064647","Shop","AAA04","6","48000","2400","45600","2013-10-01 18:46:47"
"10559","30","20131001022413","Shop","AAA03","4","68000","12000","56000","2013-10-01 14:24:13"
"10560","58","20131001011205","PC","AAA03","1","17000","3000","14000","2013-10-01 13:12:05"
"10561","77","20131001120239","Mobile","AAA02","2","30000","4600","25400","2013-10-01 12:02:39"
"10562","30","20131001095400","PC","AAA01","6","60000","12000","48000","2013-10-01 09:54:00"
"10563","13","20131001082232","Mobile","AAA02","1","15000","2300","12700","2013-10-01 08:22:32"
"10564","18","20130930115256","PC","AAA01","5","50000","10000","40000","2013-09-30 11:52:56"
"10565","64","20130930102931","Shop","AAA04","3","24000","1200","22800","2013-09-30 10:29:31"
"10566","36","20130930101319","Mobile","AAA01","8","80000","16000","64000","2013-09-30 10:13:19"
"10567","34","20130930085321","Mobile","AAA05","11","660000","220000","440000","2013-09-30 08:53:21"
"10568","77","20130926080156","Shop","AAA01","3","30000","6000","24000","2013-09-26 20:01:56"
"10569","36","20130926023914","PC","AAA04","1","8000","400","7600","2013-09-26 14:39:14"
"10570","24","20130926100849","PC","AAA02","3","45000","6900","38100","2013-09-26 10:08:49"
"10571","50","20130926062012","Mobile","AAA02","6","90000","13800","76200","2013-09-26 06:20:12"
"10572","21","20130925060918","Shop","AAA01","2","20000","4000","16000","2013-09-25 06:09:18"
"10573","73","20130924124206","Mobile","AAA02","1","15000","2300","12700","2013-09-24 12:42:06"
"10574","55","20130924112045","Shop","AAA05","1","60000","20000","40000","2013-09-24 11:20:45"
"10575","54","20130924082722","Mobile","AAA03","4","68000","12000","56000","2013-09-24 08:27:22"
"10576","54","20130924074802","Mobile","AAA05","3","180000","60000","120000","2013-09-24 07:48:02"
"10577","77","20130923112012","Shop","AAA05","2","120000","40000","80000","2013-09-23 23:20:12"
"10578","34","20130923070220","Shop","AAA02","7","105000","16100","88900","2013-09-23 07:02:20"
"10579","30","20130918032459","Mobile","AAA03","1","17000","3000","14000","2013-09-18 03:24:59"
"10580","65","20130917023301","PC","AAA05","3","180000","60000","120000","2013-09-17 14:33:01"
"10581","26","20130917122619","Mobile","AAA05","3","180000","60000","120000","2013-09-17 12:26:19"
"10582","85","20130917084621","Shop","AAA02","3","45000","6900","38100","2013-09-17 08:46:21"
"10583","68","20130917065923","Mobile","AAA01","3","30000","6000","24000","2013-09-17 06:59:23"
"10584","62","20130916113532","Mobile","AAA05","8","480000","160000","320000","2013-09-16 11:35:32"
"10585","8","20130916083630","Mobile","AAA04","3","24000","1200","22800","2013-09-16 08:36:30"
"10586","72","20130913034308","Shop","AAA03","1","17000","3000","14000","2013-09-13 03:43:08"
"10587","36","20130912111308","Mobile","AAA01","3","30000","6000","24000","2013-09-12 23:13:08"
"10588","94","20130912081956","PC","AAA03","6","102000","18000","84000","2013-09-12 08:19:56"
"10589","100","20130911042351","PC","AAA02","2","30000","4600","25400","2013-09-11 16:23:51"
"10590","92","20130911032625","Shop","AAA05","5","300000","100000","200000","2013-09-11 15:26:25"
"10591","53","20130911024138","Shop","AAA01","4","40000","8000","32000","2013-09-11 14:41:38"
"10592","81","20130911013142","Shop","AAA04","2","16000","800","15200","2013-09-11 13:31:42"
"10593","27","20130911123443","PC","AAA02","8","120000","18400","101600","2013-09-11 12:34:43"
"10594","55","20130911092208","PC","AAA05","4","240000","80000","160000","2013-09-11 09:22:08"
"10595","11","20130911073344","Mobile","AAA01","4","40000","8000","32000","2013-09-11 07:33:44"
"10596","7","20130910032859","Shop","AAA03","1","17000","3000","14000","2013-09-10 15:28:59"
"10597","3","20130910031711","PC","AAA05","2","120000","40000","80000","2013-09-10 15:17:11"
"10598","73","20130910023255","Shop","AAA02","2","30000","4600","25400","2013-09-10 14:32:55"
"10599","66","20130910125001","Mobile","AAA05","4","240000","80000","160000","2013-09-10 12:50:01"
"10600","5","20130910091945","PC","AAA01","2","20000","4000","16000","2013-09-10 09:19:45"
"10601","82","20130910073808","Shop","AAA01","2","20000","4000","16000","2013-09-10 07:38:08"
"10602","12","20130909091708","Shop","AAA03","1","17000","3000","14000","2013-09-09 21:17:08"
"10603","67","20130909062740","PC","AAA04","1","8000","400","7600","2013-09-09 18:27:40"
"10604","50","20130909125052","PC","AAA03","3","51000","9000","42000","2013-09-09 12:50:52"
"10605","27","20130909114943","PC","AAA01","5","50000","10000","40000","2013-09-09 11:49:43"
"10606","72","20130909093849","Mobile","AAA05","1","60000","20000","40000","2013-09-09 09:38:49"
"10607","96","20130904031239","Mobile","AAA03","6","102000","18000","84000","2013-09-04 03:12:39"
"10608","73","20130903021328","Shop","AAA05","6","360000","120000","240000","2013-09-03 14:13:28"
"10609","9","20130903123224","PC","AAA04","3","24000","1200","22800","2013-09-03 12:32:24"
"10610","59","20130903110053","Shop","AAA03","4","68000","12000","56000","2013-09-03 11:00:53"
"10611","21","20130903092223","PC","AAA05","3","180000","60000","120000","2013-09-03 09:22:23"
"10612","38","20130903081551","Mobile","AAA01","4","40000","8000","32000","2013-09-03 08:15:51"
"10613","1","20130903062445","Mobile","AAA05","5","300000","100000","200000","2013-09-03 06:24:45"
"10614","100","20130902101058","PC","AAA01","4","40000","8000","32000","2013-09-02 10:10:58"
"10615","61","20130902081505","Shop","AAA03","1","17000","3000","14000","2013-09-02 08:15:05"
"10616","2","20130829033111","Mobile","AAA03","4","68000","12000","56000","2013-08-29 15:31:11"
"10617","75","20130829011805","Mobile","AAA05","4","240000","80000","160000","2013-08-29 13:18:05"
"10618","65","20130829093607","PC","AAA03","2","34000","6000","28000","2013-08-29 09:36:07"
"10619","76","20130829082130","PC","AAA01","1","10000","2000","8000","2013-08-29 08:21:30"
"10620","29","20130828105117","PC","AAA05","2","120000","40000","80000","2013-08-28 10:51:17"
"10621","99","20130828110440","Mobile","AAA03","3","51000","9000","42000","2013-08-28 11:04:40"
"10622","18","20130828095403","Mobile","AAA04","7","56000","2800","53200","2013-08-28 09:54:03"
"10623","76","20130828091218","PC","AAA03","3","51000","9000","42000","2013-08-28 09:12:18"
"10624","6","20130828063926","Shop","AAA03","3","51000","9000","42000","2013-08-28 06:39:26"
"10625","58","20130827103605","Shop","AAA02","3","45000","6900","38100","2013-08-27 10:36:05"
"10626","55","20130827054139","Mobile","AAA05","5","300000","100000","200000","2013-08-27 05:41:39"
"10627","55","20130826010238","Mobile","AAA01","1","10000","2000","8000","2013-08-26 13:02:38"
"10628","71","20130826122148","Shop","AAA03","2","34000","6000","28000","2013-08-26 12:21:48"
"10629","5","20130826110556","Shop","AAA02","5","75000","11500","63500","2013-08-26 11:05:56"
"10630","40","20130826092616","Shop","AAA04","1","8000","400","7600","2013-08-26 09:26:16"
"10631","19","20130822123609","PC","AAA05","1","60000","20000","40000","2013-08-22 00:36:09"
"10632","10","20130821061355","Mobile","AAA03","7","119000","21000","98000","2013-08-21 06:13:55"
"10633","92","20130820094418","PC","AAA01","3","30000","6000","24000","2013-08-20 21:44:18"
"10634","36","20130820041645","PC","AAA01","6","60000","12000","48000","2013-08-20 16:16:45"
"10635","64","20130820014217","PC","AAA05","6","360000","120000","240000","2013-08-20 13:42:17"
"10636","59","20130820113732","Shop","AAA05","3","180000","60000","120000","2013-08-20 11:37:32"
"10637","34","20130820094742","PC","AAA05","3","180000","60000","120000","2013-08-20 09:47:42"
"10638","53","20130820084851","PC","AAA04","3","24000","1200","22800","2013-08-20 08:48:51"
"10639","73","20130820070208","PC","AAA04","5","40000","2000","38000","2013-08-20 07:02:08"
"10640","8","20130819045838","PC","AAA05","2","120000","40000","80000","2013-08-19 16:58:38"
"10641","34","20130819030208","PC","AAA03","3","51000","9000","42000","2013-08-19 15:02:08"
"10642","83","20130819012206","Mobile","AAA03","7","119000","21000","98000","2013-08-19 13:22:06"
"10643","13","20130819114534","PC","AAA01","2","20000","4000","16000","2013-08-19 11:45:34"
"10644","57","20130819094838","Shop","AAA05","5","300000","100000","200000","2013-08-19 09:48:38"
"10645","55","20130816101057","Mobile","AAA05","1","60000","20000","40000","2013-08-16 10:10:57"
"10646","21","20130816081938","Shop","AAA03","2","34000","6000","28000","2013-08-16 08:19:38"
"10647","99","20130816065031","PC","AAA05","3","180000","60000","120000","2013-08-16 06:50:31"
"10648","58","20130815030953","Mobile","AAA03","1","17000","3000","14000","2013-08-15 15:09:53"
"10649","91","20130815023507","PC","AAA05","1","60000","20000","40000","2013-08-15 14:35:07"
"10650","26","20130815021011","Shop","AAA02","1","15000","2300","12700","2013-08-15 14:10:11"
"10651","92","20130815114926","PC","AAA02","2","30000","4600","25400","2013-08-15 11:49:26"
"10652","30","20130815102550","PC","AAA02","5","75000","11500","63500","2013-08-15 10:25:50"
"10653","79","20130815081149","PC","AAA02","2","30000","4600","25400","2013-08-15 08:11:49"
"10654","16","20130815074156","Mobile","AAA04","8","64000","3200","60800","2013-08-15 07:41:56"
"10655","23","20130814044752","Mobile","AAA01","5","50000","10000","40000","2013-08-14 16:47:52"
"10656","55","20130814022102","Shop","AAA03","1","17000","3000","14000","2013-08-14 14:21:02"
"10657","34","20130814124853","Shop","AAA03","6","102000","18000","84000","2013-08-14 12:48:53"
"10658","97","20130814112324","Shop","AAA02","3","45000","6900","38100","2013-08-14 11:23:24"
"10659","76","20130814093203","PC","AAA02","7","105000","16100","88900","2013-08-14 09:32:03"
"10660","89","20130814080023","Mobile","AAA03","8","136000","24000","112000","2013-08-14 08:00:23"
"10661","86","20130814054709","Shop","AAA02","1","15000","2300","12700","2013-08-14 05:47:09"
"10662","32","20130813092422","PC","AAA02","1","15000","2300","12700","2013-08-13 21:24:22"
"10663","66","20130813075736","Mobile","AAA02","6","90000","13800","76200","2013-08-13 19:57:36"
"10664","61","20130813044246","Shop","AAA01","1","10000","2000","8000","2013-08-13 16:42:46"
"10665","4","20130813114613","PC","AAA04","1","8000","400","7600","2013-08-13 11:46:13"
"10666","76","20130813110732","PC","AAA01","3","30000","6000","24000","2013-08-13 11:07:32"
"10667","40","20130813083220","PC","AAA03","1","17000","3000","14000","2013-08-13 08:32:20"
"10668","37","20130813074123","Mobile","AAA03","5","85000","15000","70000","2013-08-13 07:41:23"
"10669","25","20130812024331","Mobile","AAA02","4","60000","9200","50800","2013-08-12 14:43:31"
"10670","7","20130812013440","PC","AAA05","6","360000","120000","240000","2013-08-12 13:34:40"
"10671","7","20130812111744","PC","AAA02","6","90000","13800","76200","2013-08-12 11:17:44"
"10672","61","20130812095627","Mobile","AAA04","1","8000","400","7600","2013-08-12 09:56:27"
"10673","27","20130809115151","PC","AAA01","1","10000","2000","8000","2013-08-09 11:51:51"
"10674","40","20130809115237","Mobile","AAA05","2","120000","40000","80000","2013-08-09 11:52:37"
"10675","85","20130809055723","Mobile","AAA04","4","32000","1600","30400","2013-08-09 05:57:23"
"10676","32","20130808112139","Shop","AAA03","11","187000","33000","154000","2013-08-08 11:21:39"
"10677","86","20130808090736","Mobile","AAA03","1","17000","3000","14000","2013-08-08 09:07:36"
"10678","50","20130808071055","Shop","AAA05","9","540000","180000","360000","2013-08-08 07:10:55"
"10679","15","20130807012445","PC","AAA05","4","240000","80000","160000","2013-08-07 13:24:45"
"10680","68","20130807123128","Shop","AAA03","4","68000","12000","56000","2013-08-07 12:31:28"
"10681","3","20130807120147","PC","AAA03","7","119000","21000","98000","2013-08-07 12:01:47"
"10682","36","20130807075942","Mobile","AAA02","2","30000","4600","25400","2013-08-07 07:59:42"
"10683","1","20130806113519","Shop","AAA04","7","56000","2800","53200","2013-08-06 11:35:19"
"10684","37","20130806101858","PC","AAA02","4","60000","9200","50800","2013-08-06 10:18:58"
"10685","72","20130806092023","PC","AAA02","2","30000","4600","25400","2013-08-06 09:20:23"
"10686","54","20130806080332","PC","AAA05","1","60000","20000","40000","2013-08-06 08:03:32"
"10687","71","20130806065935","Mobile","AAA03","5","85000","15000","70000","2013-08-06 06:59:35"
"10688","21","20130805054131","Shop","AAA02","1","15000","2300","12700","2013-08-05 17:41:31"
"10689","55","20130805010829","Shop","AAA01","6","60000","12000","48000","2013-08-05 13:08:29"
"10690","20","20130805123404","PC","AAA02","1","15000","2300","12700","2013-08-05 12:34:04"
"10691","95","20130805104324","Shop","AAA03","3","51000","9000","42000","2013-08-05 10:43:24"
"10692","96","20130805091039","Mobile","AAA02","1","15000","2300","12700","2013-08-05 09:10:39"
"10693","40","20130731054345","Mobile","AAA01","6","60000","12000","48000","2013-07-31 05:43:45"
"10694","83","20130730010049","PC","AAA03","4","68000","12000","56000","2013-07-30 13:00:49"
"10695","15","20130730112602","PC","AAA01","4","40000","8000","32000","2013-07-30 11:26:02"
"10696","14","20130730092640","Mobile","AAA05","1","60000","20000","40000","2013-07-30 09:26:40"
"10697","42","20130730071954","Mobile","AAA05","2","120000","40000","80000","2013-07-30 07:19:54"
"10698","36","20130729013052","PC","AAA05","1","60000","20000","40000","2013-07-29 13:30:52"
"10699","7","20130729121621","PC","AAA01","6","60000","12000","48000","2013-07-29 12:16:21"
"10700","58","20130729121337","Mobile","AAA02","5","75000","11500","63500","2013-07-29 12:13:37"
"10701","89","20130729101123","Mobile","AAA01","2","20000","4000","16000","2013-07-29 10:11:23"
"10702","11","20130723040210","Shop","AAA01","11","110000","22000","88000","2013-07-23 16:02:10"
"10703","29","20130723031527","Mobile","AAA02","4","60000","9200","50800","2013-07-23 15:15:27"
"10704","31","20130723124547","Shop","AAA05","3","180000","60000","120000","2013-07-23 12:45:47"
"10705","28","20130723114022","Mobile","AAA02","6","90000","13800","76200","2013-07-23 11:40:22"
"10706","36","20130723092510","Shop","AAA01","9","90000","18000","72000","2013-07-23 09:25:10"
"10707","28","20130723082207","Mobile","AAA03","1","17000","3000","14000","2013-07-23 08:22:07"
"10708","44","20130723071230","Mobile","AAA01","4","40000","8000","32000","2013-07-23 07:12:30"
"10709","69","20130722032523","Shop","AAA03","1","17000","3000","14000","2013-07-22 15:25:23"
"10710","89","20130722021719","PC","AAA05","4","240000","80000","160000","2013-07-22 14:17:19"
"10711","7","20130722010858","Mobile","AAA02","5","75000","11500","63500","2013-07-22 13:08:58"
"10712","71","20130722115351","Shop","AAA02","2","30000","4600","25400","2013-07-22 11:53:51"
"10713","85","20130722103049","PC","AAA01","3","30000","6000","24000","2013-07-22 10:30:49"
"10714","43","20130722090357","Shop","AAA01","2","20000","4000","16000","2013-07-22 09:03:57"
"10715","76","20130718082401","Shop","AAA02","2","30000","4600","25400","2013-07-18 08:24:01"
"10716","31","20130718064459","Mobile","AAA03","6","102000","18000","84000","2013-07-18 06:44:59"
"10717","83","20130717031931","Mobile","AAA05","14","840000","280000","560000","2013-07-17 15:19:31"
"10718","86","20130717012043","Shop","AAA01","2","20000","4000","16000","2013-07-17 13:20:43"
"10719","12","20130717115739","Shop","AAA01","1","10000","2000","8000","2013-07-17 11:57:39"
"10720","74","20130717103212","Shop","AAA02","3","45000","6900","38100","2013-07-17 10:32:12"
"10721","64","20130717073638","PC","AAA02","5","75000","11500","63500","2013-07-17 07:36:38"
"10722","89","20130716023807","PC","AAA02","1","15000","2300","12700","2013-07-16 14:38:07"
"10723","83","20130716123007","Mobile","AAA03","2","34000","6000","28000","2013-07-16 12:30:07"
"10724","14","20130716115134","Shop","AAA02","1","15000","2300","12700","2013-07-16 11:51:34"
"10725","32","20130716101941","PC","AAA02","6","90000","13800","76200","2013-07-16 10:19:41"
"10726","66","20130716085708","Shop","AAA05","4","240000","80000","160000","2013-07-16 08:57:08"
"10727","57","20130716071724","Mobile","AAA02","1","15000","2300","12700","2013-07-16 07:17:24"
"10728","83","20130715071518","Mobile","AAA04","3","24000","1200","22800","2013-07-15 07:15:18"
"10729","41","20130711102158","Mobile","AAA05","5","300000","100000","200000","2013-07-11 22:21:58"
"10730","25","20130711062129","Mobile","AAA04","4","32000","1600","30400","2013-07-11 18:21:29"
"10731","12","20130711101231","PC","AAA01","5","50000","10000","40000","2013-07-11 10:12:31"
"10732","62","20130711092251","Mobile","AAA02","4","60000","9200","50800","2013-07-11 09:22:51"
"10733","16","20130711060618","Mobile","AAA01","7","70000","14000","56000","2013-07-11 06:06:18"
"10734","80","20130710094526","Shop","AAA04","4","32000","1600","30400","2013-07-10 09:45:26"
"10735","96","20130709021152","PC","AAA05","3","180000","60000","120000","2013-07-09 14:11:52"
"10736","95","20130709011949","Mobile","AAA05","1","60000","20000","40000","2013-07-09 13:19:49"
"10737","98","20130709115030","PC","AAA04","1","8000","400","7600","2013-07-09 11:50:30"
"10738","5","20130709104802","PC","AAA05","3","180000","60000","120000","2013-07-09 10:48:02"
"10739","49","20130709082349","Mobile","AAA01","3","30000","6000","24000","2013-07-09 08:23:49"
"10740","62","20130709071344","PC","AAA04","5","40000","2000","38000","2013-07-09 07:13:44"
"10741","34","20130708072827","Mobile","AAA05","3","180000","60000","120000","2013-07-08 19:28:27"
"10742","16","20130708014720","Mobile","AAA05","7","420000","140000","280000","2013-07-08 13:47:20"
"10743","40","20130708121551","PC","AAA01","1","10000","2000","8000","2013-07-08 12:15:51"
"10744","37","20130708103355","PC","AAA01","6","60000","12000","48000","2013-07-08 10:33:55"
"10745","42","20130708100421","Shop","AAA05","8","480000","160000","320000","2013-07-08 10:04:21"
"10746","94","20130708074325","PC","AAA05","5","300000","100000","200000","2013-07-08 07:43:25"
"10747","80","20130703060305","Shop","AAA05","3","180000","60000","120000","2013-07-03 06:03:05"
"10748","32","20130702121759","Mobile","AAA04","8","64000","3200","60800","2013-07-02 12:17:59"
"10749","5","20130702102737","Shop","AAA05","3","180000","60000","120000","2013-07-02 10:27:37"
"10750","87","20130702082012","PC","AAA05","6","360000","120000","240000","2013-07-02 08:20:12"
"10751","53","20130702064057","Shop","AAA05","1","60000","20000","40000","2013-07-02 06:40:57"
"10752","27","20130701032721","Shop","AAA05","2","120000","40000","80000","2013-07-01 15:27:21"
"10753","14","20130701020117","Mobile","AAA01","5","50000","10000","40000","2013-07-01 14:01:17"
"10754","93","20130701090054","PC","AAA01","1","10000","2000","8000","2013-07-01 09:00:54"
"10755","22","20130627124205","Shop","AAA04","2","16000","800","15200","2013-06-27 00:42:05"
"10756","79","20130626061351","PC","AAA04","1","8000","400","7600","2013-06-26 06:13:51"
"10757","69","20130625102546","Shop","AAA05","1","60000","20000","40000","2013-06-25 22:25:46"
"10758","72","20130625062950","PC","AAA02","1","15000","2300","12700","2013-06-25 18:29:50"
"10759","57","20130625012322","Mobile","AAA01","3","30000","6000","24000","2013-06-25 13:23:22"
"10760","51","20130625113730","Shop","AAA03","6","102000","18000","84000","2013-06-25 11:37:30"
"10761","47","20130625083751","PC","AAA02","6","90000","13800","76200","2013-06-25 08:37:51"
"10762","81","20130625064358","Shop","AAA02","3","45000","6900","38100","2013-06-25 06:43:58"
"10763","88","20130624030823","Mobile","AAA05","4","240000","80000","160000","2013-06-24 15:08:23"
"10764","42","20130624020739","Mobile","AAA02","2","30000","4600","25400","2013-06-24 14:07:39"
"10765","49","20130624105004","Shop","AAA02","3","45000","6900","38100","2013-06-24 10:50:04"
"10766","33","20130621011728","PC","AAA05","4","240000","80000","160000","2013-06-21 13:17:28"
"10767","83","20130621121326","Shop","AAA03","1","17000","3000","14000","2013-06-21 12:13:26"
"10768","23","20130621104843","Mobile","AAA01","1","10000","2000","8000","2013-06-21 10:48:43"
"10769","81","20130621085006","Mobile","AAA03","3","51000","9000","42000","2013-06-21 08:50:06"
"10770","93","20130621075024","PC","AAA03","2","34000","6000","28000","2013-06-21 07:50:24"
"10771","51","20130620033617","Mobile","AAA05","1","60000","20000","40000","2013-06-20 15:36:17"
"10772","30","20130620015030","Mobile","AAA04","1","8000","400","7600","2013-06-20 13:50:30"
"10773","30","20130620120103","PC","AAA01","8","80000","16000","64000","2013-06-20 12:01:03"
"10774","66","20130620101149","PC","AAA01","5","50000","10000","40000","2013-06-20 10:11:49"
"10775","85","20130620080958","Shop","AAA05","4","240000","80000","160000","2013-06-20 08:09:58"
"10776","44","20130620060810","Mobile","AAA03","1","17000","3000","14000","2013-06-20 06:08:10"
"10777","73","20130619032053","Mobile","AAA03","3","51000","9000","42000","2013-06-19 15:20:53"
"10778","63","20130619014830","PC","AAA05","1","60000","20000","40000","2013-06-19 13:48:30"
"10779","82","20130619104138","Mobile","AAA03","4","68000","12000","56000","2013-06-19 10:41:38"
"10780","5","20130619101154","Shop","AAA04","5","40000","2000","38000","2013-06-19 10:11:54"
"10781","82","20130619084101","Mobile","AAA01","1","10000","2000","8000","2013-06-19 08:41:01"
"10782","32","20130619065644","Shop","AAA02","1","15000","2300","12700","2013-06-19 06:56:44"
"10783","11","20130618104940","Shop","AAA03","3","51000","9000","42000","2013-06-18 22:49:40"
"10784","60","20130618045438","Mobile","AAA03","4","68000","12000","56000","2013-06-18 16:54:38"
"10785","8","20130618034739","PC","AAA02","1","15000","2300","12700","2013-06-18 15:47:39"
"10786","59","20130618022903","PC","AAA01","2","20000","4000","16000","2013-06-18 14:29:03"
"10787","57","20130618010057","Shop","AAA01","3","30000","6000","24000","2013-06-18 13:00:57"
"10788","11","20130618094206","Shop","AAA03","3","51000","9000","42000","2013-06-18 09:42:06"
"10789","52","20130618065738","Shop","AAA03","3","51000","9000","42000","2013-06-18 06:57:38"
"10790","52","20130617033255","Mobile","AAA05","2","120000","40000","80000","2013-06-17 15:32:55"
"10791","38","20130617014557","Shop","AAA01","1","10000","2000","8000","2013-06-17 13:45:57"
"10792","57","20130617120337","PC","AAA05","1","60000","20000","40000","2013-06-17 12:03:37"
"10793","62","20130617111444","Mobile","AAA04","6","48000","2400","45600","2013-06-17 11:14:44"
"10794","33","20130617100243","Shop","AAA04","2","16000","800","15200","2013-06-17 10:02:43"
"10795","82","20130617085645","PC","AAA03","6","102000","18000","84000","2013-06-17 08:56:45"
"10796","91","20130612032610","PC","AAA02","2","30000","4600","25400","2013-06-12 15:26:10"
"10797","19","20130612014005","Shop","AAA01","5","50000","10000","40000","2013-06-12 13:40:05"
"10798","85","20130612113541","Mobile","AAA01","5","50000","10000","40000","2013-06-12 11:35:41"
"10799","43","20130612094847","PC","AAA02","3","45000","6900","38100","2013-06-12 09:48:47"
"10800","74","20130611021357","PC","AAA03","5","85000","15000","70000","2013-06-11 14:13:57"
"10801","61","20130611120033","PC","AAA02","1","15000","2300","12700","2013-06-11 12:00:33"
"10802","18","20130611112518","Shop","AAA02","1","15000","2300","12700","2013-06-11 11:25:18"
"10803","19","20130611085302","Mobile","AAA05","1","60000","20000","40000","2013-06-11 08:53:02"
"10804","73","20130611065946","PC","AAA01","1","10000","2000","8000","2013-06-11 06:59:46"
"10805","21","20130610072938","Mobile","AAA03","4","68000","12000","56000","2013-06-10 07:29:38"
"10806","84","20130606040927","Mobile","AAA01","2","20000","4000","16000","2013-06-06 04:09:27"
"10807","39","20130605041308","PC","AAA01","2","20000","4000","16000","2013-06-05 16:13:08"
"10808","57","20130605015309","PC","AAA01","3","30000","6000","24000","2013-06-05 13:53:09"
"10809","23","20130605103835","Shop","AAA02","2","30000","4600","25400","2013-06-05 10:38:35"
"10810","58","20130605092227","PC","AAA04","4","32000","1600","30400","2013-06-05 09:22:27"
"10811","60","20130605073101","Shop","AAA02","2","30000","4600","25400","2013-06-05 07:31:01"
"10812","44","20130604015607","Shop","AAA03","2","34000","6000","28000","2013-06-04 13:56:07"
"10813","77","20130604063819","Mobile","AAA03","2","34000","6000","28000","2013-06-04 06:38:19"
"10814","95","20130603073139","PC","AAA01","2","20000","4000","16000","2013-06-03 19:31:39"
"10815","36","20130603030037","Mobile","AAA05","4","240000","80000","160000","2013-06-03 15:00:37"
"10816","58","20130603122516","Shop","AAA01","1","10000","2000","8000","2013-06-03 12:25:16"
"10817","10","20130603112139","Shop","AAA05","2","120000","40000","80000","2013-06-03 11:21:39"
"10818","30","20130529042627","PC","AAA03","1","17000","3000","14000","2013-05-29 04:26:27"
"10819","88","20130528043853","Mobile","AAA01","1","10000","2000","8000","2013-05-28 16:38:53"
"10820","76","20130528030741","Shop","AAA04","4","32000","1600","30400","2013-05-28 15:07:41"
"10821","28","20130528010808","Mobile","AAA05","4","240000","80000","160000","2013-05-28 13:08:08"
"10822","90","20130528115203","Mobile","AAA04","1","8000","400","7600","2013-05-28 11:52:03"
"10823","67","20130528102147","Mobile","AAA03","11","187000","33000","154000","2013-05-28 10:21:47"
"10824","47","20130528084605","Mobile","AAA04","3","24000","1200","22800","2013-05-28 08:46:05"
"10825","80","20130528071321","Mobile","AAA03","1","17000","3000","14000","2013-05-28 07:13:21"
"10826","99","20130527011139","Mobile","AAA03","2","34000","6000","28000","2013-05-27 13:11:39"
"10827","54","20130527121040","PC","AAA05","2","120000","40000","80000","2013-05-27 12:10:40"
"10828","41","20130527112711","Mobile","AAA01","3","30000","6000","24000","2013-05-27 11:27:11"
"10829","63","20130523054051","Shop","AAA01","4","40000","8000","32000","2013-05-23 17:40:51"
"10830","82","20130523033701","PC","AAA03","1","17000","3000","14000","2013-05-23 15:37:01"
"10831","4","20130523012339","Shop","AAA05","1","60000","20000","40000","2013-05-23 13:23:39"
"10832","76","20130523112548","PC","AAA03","2","34000","6000","28000","2013-05-23 11:25:48"
"10833","68","20130523095346","Shop","AAA02","6","90000","13800","76200","2013-05-23 09:53:46"
"10834","12","20130523081131","Mobile","AAA01","3","30000","6000","24000","2013-05-23 08:11:31"
"10835","71","20130523061117","Shop","AAA04","4","32000","1600","30400","2013-05-23 06:11:17"
"10836","60","20130522113338","Mobile","AAA01","2","20000","4000","16000","2013-05-22 11:33:38"
"10837","69","20130522092453","Shop","AAA01","1","10000","2000","8000","2013-05-22 09:24:53"
"10838","35","20130522072956","Mobile","AAA01","1","10000","2000","8000","2013-05-22 07:29:56"
"10839","16","20130521042650","PC","AAA01","5","50000","10000","40000","2013-05-21 16:26:50"
"10840","52","20130521030412","Shop","AAA03","1","17000","3000","14000","2013-05-21 15:04:12"
"10841","81","20130521011258","Shop","AAA05","1","60000","20000","40000","2013-05-21 13:12:58"
"10842","97","20130521111832","PC","AAA03","4","68000","12000","56000","2013-05-21 11:18:32"
"10843","57","20130521094029","Mobile","AAA05","3","180000","60000","120000","2013-05-21 09:40:29"
"10844","55","20130521080910","Shop","AAA05","1","60000","20000","40000","2013-05-21 08:09:10"
"10845","15","20130521074350","Mobile","AAA04","14","112000","5600","106400","2013-05-21 07:43:50"
"10846","54","20130521043057","Mobile","AAA04","5","40000","2000","38000","2013-05-21 04:30:57"
"10847","8","20130520054145","Mobile","AAA05","1","60000","20000","40000","2013-05-20 17:41:45"
"10848","24","20130520014757","Mobile","AAA02","1","15000","2300","12700","2013-05-20 13:47:57"
"10849","34","20130520121711","Mobile","AAA05","10","600000","200000","400000","2013-05-20 12:17:11"
"10850","84","20130520110045","Mobile","AAA05","1","60000","20000","40000","2013-05-20 11:00:45"
"10851","17","20130514063637","PC","AAA04","2","16000","800","15200","2013-05-14 18:36:37"
"10852","62","20130514044322","Mobile","AAA05","5","300000","100000","200000","2013-05-14 16:43:22"
"10853","33","20130514031454","Mobile","AAA04","2","16000","800","15200","2013-05-14 15:14:54"
"10854","50","20130514113230","PC","AAA02","5","75000","11500","63500","2013-05-14 11:32:30"
"10855","7","20130514093126","Mobile","AAA03","5","85000","15000","70000","2013-05-14 09:31:26"
"10856","18","20130514073738","Shop","AAA01","3","30000","6000","24000","2013-05-14 07:37:38"
"10857","77","20130513020534","PC","AAA04","3","24000","1200","22800","2013-05-13 14:05:34"
"10858","49","20130513122815","PC","AAA04","2","16000","800","15200","2013-05-13 12:28:15"
"10859","97","20130513110616","PC","AAA02","3","45000","6900","38100","2013-05-13 11:06:16"
"10860","26","20130513093808","Mobile","AAA03","2","34000","6000","28000","2013-05-13 09:38:08"
"10861","18","20130510095031","Shop","AAA01","1","10000","2000","8000","2013-05-10 21:50:31"
"10862","23","20130510064903","Mobile","AAA01","3","30000","6000","24000","2013-05-10 18:49:03"
"10863","57","20130510030733","PC","AAA03","1","17000","3000","14000","2013-05-10 15:07:33"
"10864","38","20130510124324","Shop","AAA03","1","17000","3000","14000","2013-05-10 12:43:24"
"10865","82","20130510111007","Shop","AAA05","7","420000","140000","280000","2013-05-10 11:10:07"
"10866","89","20130510091257","Mobile","AAA01","7","70000","14000","56000","2013-05-10 09:12:57"
"10867","41","20130509022437","PC","AAA03","1","17000","3000","14000","2013-05-09 14:24:37"
"10868","41","20130509125901","PC","AAA03","6","102000","18000","84000","2013-05-09 12:59:01"
"10869","82","20130509103721","PC","AAA03","5","85000","15000","70000","2013-05-09 10:37:21"
"10870","5","20130509074025","Mobile","AAA04","5","40000","2000","38000","2013-05-09 07:40:25"
"10871","8","20130508111042","Shop","AAA05","2","120000","40000","80000","2013-05-08 23:10:42"
"10872","64","20130508120917","Mobile","AAA02","2","30000","4600","25400","2013-05-08 12:09:17"
"10873","52","20130508103508","Mobile","AAA01","3","30000","6000","24000","2013-05-08 10:35:08"
"10874","11","20130508074904","PC","AAA04","4","32000","1600","30400","2013-05-08 07:49:04"
"10875","42","20130507063020","PC","AAA03","3","51000","9000","42000","2013-05-07 06:30:20"
"10876","71","20130506025613","PC","AAA03","4","68000","12000","56000","2013-05-06 14:56:13"
"10877","43","20130506010311","PC","AAA03","10","170000","30000","140000","2013-05-06 13:03:11"
"10878","89","20130506120405","Shop","AAA02","9","135000","20700","114300","2013-05-06 12:04:05"
"10879","11","20130506104438","Shop","AAA01","4","40000","8000","32000","2013-05-06 10:44:38"
"10880","25","20130506094242","PC","AAA02","3","45000","6900","38100","2013-05-06 09:42:42"
"10881","53","20130430081340","Mobile","AAA01","1","10000","2000","8000","2013-04-30 08:13:40"
"10882","1","20130430063415","Shop","AAA04","5","40000","2000","38000","2013-04-30 06:34:15"
"10883","3","20130429010922","PC","AAA01","4","40000","8000","32000","2013-04-29 13:09:22"
"10884","59","20130429120208","Mobile","AAA05","1","60000","20000","40000","2013-04-29 12:02:08"
"10885","27","20130429100625","Shop","AAA03","3","51000","9000","42000","2013-04-29 10:06:25"
"10886","24","20130429081621","Mobile","AAA03","1","17000","3000","14000","2013-04-29 08:16:21"
"10887","31","20130424115407","PC","AAA05","3","180000","60000","120000","2013-04-24 11:54:07"
"10888","47","20130424101706","Shop","AAA02","6","90000","13800","76200","2013-04-24 10:17:06"
"10889","63","20130424091512","PC","AAA05","2","120000","40000","80000","2013-04-24 09:15:12"
"10890","56","20130424072918","Shop","AAA05","6","360000","120000","240000","2013-04-24 07:29:18"
"10891","48","20130423123521","Shop","AAA03","1","17000","3000","14000","2013-04-23 12:35:21"
"10892","74","20130423105109","PC","AAA02","2","30000","4600","25400","2013-04-23 10:51:09"
"10893","78","20130423084712","PC","AAA02","1","15000","2300","12700","2013-04-23 08:47:12"
"10894","48","20130423074759","Mobile","AAA02","6","90000","13800","76200","2013-04-23 07:47:59"
"10895","53","20130422070104","Mobile","AAA01","1","10000","2000","8000","2013-04-22 19:01:04"
"10896","8","20130422110434","Mobile","AAA05","5","300000","100000","200000","2013-04-22 11:04:34"
"10897","88","20130422095203","Mobile","AAA01","1","10000","2000","8000","2013-04-22 09:52:03"
"10898","16","20130415105438","Shop","AAA03","7","119000","21000","98000","2013-04-15 10:54:38"
"10899","66","20130415085121","Shop","AAA05","1","60000","20000","40000","2013-04-15 08:51:21"
"10900","1","20130411064534","Shop","AAA04","3","24000","1200","22800","2013-04-11 18:45:34"
"10901","15","20130411023131","PC","AAA02","3","45000","6900","38100","2013-04-11 14:31:31"
"10902","55","20130411113951","PC","AAA03","1","17000","3000","14000","2013-04-11 11:39:51"
"10903","53","20130411080629","PC","AAA03","1","17000","3000","14000","2013-04-11 08:06:29"
"10904","4","20130410075500","PC","AAA03","1","17000","3000","14000","2013-04-10 19:55:00"
"10905","16","20130410044714","PC","AAA04","4","32000","1600","30400","2013-04-10 16:47:14"
"10906","92","20130410042337","Shop","AAA03","4","68000","12000","56000","2013-04-10 16:23:37"
"10907","67","20130410030540","Mobile","AAA02","4","60000","9200","50800","2013-04-10 15:05:40"
"10908","24","20130410014525","PC","AAA04","2","16000","800","15200","2013-04-10 13:45:25"
"10909","2","20130410124120","Shop","AAA02","1","15000","2300","12700","2013-04-10 12:41:20"
"10910","31","20130410110104","PC","AAA01","3","30000","6000","24000","2013-04-10 11:01:04"
"10911","85","20130410100047","PC","AAA03","7","119000","21000","98000","2013-04-10 10:00:47"
"10912","47","20130410082416","Mobile","AAA05","2","120000","40000","80000","2013-04-10 08:24:16"
"10913","15","20130410072800","PC","AAA02","14","210000","32200","177800","2013-04-10 07:28:00"
"10914","8","20130409052740","PC","AAA03","7","119000","21000","98000","2013-04-09 17:27:40"
"10915","99","20130409013520","Shop","AAA05","1","60000","20000","40000","2013-04-09 13:35:20"
"10916","3","20130409111913","PC","AAA02","4","60000","9200","50800","2013-04-09 11:19:13"
"10917","80","20130409100230","PC","AAA03","4","68000","12000","56000","2013-04-09 10:02:30"
"10918","96","20130409082842","PC","AAA03","4","68000","12000","56000","2013-04-09 08:28:42"
"10919","87","20130409062943","Mobile","AAA01","1","10000","2000","8000","2013-04-09 06:29:43"
"10920","13","20130408042839","PC","AAA05","1","60000","20000","40000","2013-04-08 16:28:39"
"10921","35","20130408024806","PC","AAA04","1","8000","400","7600","2013-04-08 14:48:06"
"10922","4","20130408102844","Shop","AAA01","1","10000","2000","8000","2013-04-08 10:28:44"
"10923","41","20130408083804","PC","AAA03","4","68000","12000","56000","2013-04-08 08:38:04"
"10924","67","20130402062555","Shop","AAA01","3","30000","6000","24000","2013-04-02 18:25:55"
"10925","37","20130402025347","Shop","AAA04","4","32000","1600","30400","2013-04-02 14:53:47"
"10926","61","20130402022230","PC","AAA05","2","120000","40000","80000","2013-04-02 14:22:30"
"10927","30","20130402124654","Mobile","AAA03","6","102000","18000","84000","2013-04-02 12:46:54"
"10928","41","20130402103745","PC","AAA02","3","45000","6900","38100","2013-04-02 10:37:45"
"10929","86","20130402072450","Shop","AAA04","1","8000","400","7600","2013-04-02 07:24:50"
"10930","87","20130401030236","Mobile","AAA04","5","40000","2000","38000","2013-04-01 15:02:36"
"10931","67","20130401013657","PC","AAA04","3","24000","1200","22800","2013-04-01 13:36:57"
"10932","54","20130401113113","Shop","AAA02","4","60000","9200","50800","2013-04-01 11:31:13"
"10933","36","20130401082730","Shop","AAA05","1","60000","20000","40000","2013-04-01 08:27:30"
"10934","27","20130328014111","Mobile","AAA02","3","45000","6900","38100","2013-03-28 01:41:11"
"10935","10","20130327012214","Shop","AAA01","3","30000","6000","24000","2013-03-27 13:22:14"
"10936","12","20130327120824","Mobile","AAA01","2","20000","4000","16000","2013-03-27 12:08:24"
"10937","77","20130327094448","PC","AAA01","5","50000","10000","40000","2013-03-27 09:44:48"
"10938","87","20130327075816","PC","AAA04","4","32000","1600","30400","2013-03-27 07:58:16"
"10939","84","20130326053115","Shop","AAA02","1","15000","2300","12700","2013-03-26 17:31:15"
"10940","57","20130326023859","PC","AAA01","1","10000","2000","8000","2013-03-26 14:38:59"
"10941","49","20130326012538","Shop","AAA05","6","360000","120000","240000","2013-03-26 13:25:38"
"10942","2","20130326075559","PC","AAA05","4","240000","80000","160000","2013-03-26 07:55:59"
"10943","12","20130325045625","Mobile","AAA02","1","15000","2300","12700","2013-03-25 16:56:25"
"10944","7","20130325032946","PC","AAA05","3","180000","60000","120000","2013-03-25 15:29:46"
"10945","27","20130325021429","Mobile","AAA05","7","420000","140000","280000","2013-03-25 14:14:29"
"10946","69","20130325121639","PC","AAA01","2","20000","4000","16000","2013-03-25 12:16:39"
"10947","83","20130325110927","Mobile","AAA01","11","110000","22000","88000","2013-03-25 11:09:27"
"10948","43","20130325091740","PC","AAA05","2","120000","40000","80000","2013-03-25 09:17:40"
"10949","70","20130321084823","PC","AAA02","6","90000","13800","76200","2013-03-21 20:48:23"
"10950","79","20130321035108","Shop","AAA05","1","60000","20000","40000","2013-03-21 15:51:08"
"10951","16","20130321023112","Mobile","AAA05","5","300000","100000","200000","2013-03-21 14:31:12"
"10952","49","20130321013059","Mobile","AAA04","7","56000","2800","53200","2013-03-21 13:30:59"
"10953","34","20130321121200","Shop","AAA04","7","56000","2800","53200","2013-03-21 12:12:00"
"10954","15","20130321085536","Mobile","AAA01","3","30000","6000","24000","2013-03-21 08:55:36"
"10955","85","20130321070505","Mobile","AAA05","4","240000","80000","160000","2013-03-21 07:05:05"
"10956","73","20130320091606","Shop","AAA04","5","40000","2000","38000","2013-03-20 21:16:06"
"10957","39","20130320022350","Shop","AAA02","1","15000","2300","12700","2013-03-20 14:23:50"
"10958","10","20130320010146","PC","AAA02","3","45000","6900","38100","2013-03-20 13:01:46"
"10959","11","20130320105146","Mobile","AAA03","7","119000","21000","98000","2013-03-20 10:51:46"
"10960","66","20130320084434","Mobile","AAA01","3","30000","6000","24000","2013-03-20 08:44:34"
"10961","81","20130320071251","PC","AAA01","2","20000","4000","16000","2013-03-20 07:12:51"
"10962","63","20130319064415","PC","AAA04","1","8000","400","7600","2013-03-19 18:44:15"
"10963","42","20130319040139","Mobile","AAA01","5","50000","10000","40000","2013-03-19 16:01:39"
"10964","85","20130319020533","PC","AAA02","1","15000","2300","12700","2013-03-19 14:05:33"
"10965","21","20130319010612","Shop","AAA04","1","8000","400","7600","2013-03-19 13:06:12"
"10966","10","20130319085227","Shop","AAA04","4","32000","1600","30400","2013-03-19 08:52:27"
"10967","90","20130319070221","Mobile","AAA01","3","30000","6000","24000","2013-03-19 07:02:21"
"10968","52","20130318013007","PC","AAA04","2","16000","800","15200","2013-03-18 13:30:07"
"10969","68","20130318122309","Mobile","AAA01","2","20000","4000","16000","2013-03-18 12:23:09"
"10970","87","20130318103902","Shop","AAA05","5","300000","100000","200000","2013-03-18 10:39:02"
"10971","97","20130318082958","PC","AAA02","1","15000","2300","12700","2013-03-18 08:29:58"
"10972","14","20130313060320","Shop","AAA04","1","8000","400","7600","2013-03-13 06:03:20"
"10973","52","20130312055937","Shop","AAA02","2","30000","4600","25400","2013-03-12 17:59:37"
"10974","44","20130312045251","Shop","AAA05","1","60000","20000","40000","2013-03-12 16:52:51"
"10975","56","20130312024821","PC","AAA05","5","300000","100000","200000","2013-03-12 14:48:21"
"10976","89","20130312122950","Shop","AAA01","3","30000","6000","24000","2013-03-12 12:29:50"
"10977","66","20130312105928","Mobile","AAA02","5","75000","11500","63500","2013-03-12 10:59:28"
"10978","92","20130312093710","Mobile","AAA03","4","68000","12000","56000","2013-03-12 09:37:10"
"10979","62","20130311081515","PC","AAA04","8","64000","3200","60800","2013-03-11 20:15:15"
"10980","63","20130311061750","Shop","AAA03","1","17000","3000","14000","2013-03-11 18:17:50"
"10981","42","20130311032203","Mobile","AAA03","3","51000","9000","42000","2013-03-11 15:22:03"
"10982","84","20130311011520","Shop","AAA04","1","8000","400","7600","2013-03-11 13:15:20"
"10983","43","20130311123432","PC","AAA02","2","30000","4600","25400","2013-03-11 12:34:32"
"10984","16","20130311105151","PC","AAA04","6","48000","2400","45600","2013-03-11 10:51:51"
"10985","76","20130311091433","PC","AAA04","1","8000","400","7600","2013-03-11 09:14:33"
"10986","25","20130308120947","Shop","AAA05","2","120000","40000","80000","2013-03-08 12:09:47"
"10987","16","20130308110028","Shop","AAA03","8","136000","24000","112000","2013-03-08 11:00:28"
"10988","38","20130308094044","PC","AAA01","4","40000","8000","32000","2013-03-08 09:40:44"
"10989","62","20130308085711","Mobile","AAA01","3","30000","6000","24000","2013-03-08 08:57:11"
"10990","9","20130307021721","PC","AAA04","1","8000","400","7600","2013-03-07 14:17:21"
"10991","5","20130307100533","Shop","AAA05","7","420000","140000","280000","2013-03-07 10:05:33"
"10992","86","20130307073419","PC","AAA03","1","17000","3000","14000","2013-03-07 07:34:19"
"10993","24","20130306041321","Mobile","AAA04","6","48000","2400","45600","2013-03-06 16:13:21"
"10994","100","20130306024812","Shop","AAA03","2","34000","6000","28000","2013-03-06 14:48:12"
"10995","98","20130306124008","Shop","AAA05","1","60000","20000","40000","2013-03-06 12:40:08"
"10996","82","20130306103750","Mobile","AAA03","2","34000","6000","28000","2013-03-06 10:37:50"
"10997","73","20130306084328","Shop","AAA02","7","105000","16100","88900","2013-03-06 08:43:28"
"10998","76","20130306072904","Mobile","AAA04","4","32000","1600","30400","2013-03-06 07:29:04"
"10999","44","20130305052713","Mobile","AAA02","3","45000","6900","38100","2013-03-05 17:27:13"
"11000","22","20130305040846","PC","AAA01","1","10000","2000","8000","2013-03-05 16:08:46"
"11001","3","20130305024638","Mobile","AAA03","9","153000","27000","126000","2013-03-05 14:46:38"
"11002","67","20130305012555","Mobile","AAA02","2","30000","4600","25400","2013-03-05 13:25:55"
"11003","30","20130305115458","Shop","AAA04","1","8000","400","7600","2013-03-05 11:54:58"
"11004","4","20130305102350","PC","AAA03","3","51000","9000","42000","2013-03-05 10:23:50"
"11005","17","20130305085033","Mobile","AAA02","1","15000","2300","12700","2013-03-05 08:50:33"
"11006","20","20130305070316","PC","AAA03","3","51000","9000","42000","2013-03-05 07:03:16"
"11007","40","20130304125446","Mobile","AAA04","2","16000","800","15200","2013-03-04 12:54:46"
"11008","36","20130304104916","PC","AAA01","6","60000","12000","48000","2013-03-04 10:49:16"
"11009","39","20130304100301","Mobile","AAA04","1","8000","400","7600","2013-03-04 10:03:01"
"11010","15","20130304081905","Shop","AAA04","9","72000","3600","68400","2013-03-04 08:19:05"
"11011","50","20130227061147","PC","AAA04","6","48000","2400","45600","2013-02-27 06:11:47"
"11012","89","20130226121520","Shop","AAA02","1","15000","2300","12700","2013-02-26 12:15:20"
"11013","91","20130226111927","PC","AAA05","3","180000","60000","120000","2013-02-26 11:19:27"
"11014","21","20130226074329","Mobile","AAA03","4","68000","12000","56000","2013-02-26 07:43:29"
"11015","49","20130225032729","PC","AAA01","4","40000","8000","32000","2013-02-25 15:27:29"
"11016","69","20130225020135","Mobile","AAA03","2","34000","6000","28000","2013-02-25 14:01:35"
"11017","21","20130225120956","Mobile","AAA05","5","300000","100000","200000","2013-02-25 12:09:56"
"11018","90","20130220023054","Shop","AAA02","2","30000","4600","25400","2013-02-20 14:30:54"
"11019","74","20130220124214","PC","AAA03","4","68000","12000","56000","2013-02-20 12:42:14"
"11020","54","20130220105312","PC","AAA05","1","60000","20000","40000","2013-02-20 10:53:12"
"11021","8","20130220091722","PC","AAA01","3","30000","6000","24000","2013-02-20 09:17:22"
"11022","83","20130220084132","Shop","AAA02","9","135000","20700","114300","2013-02-20 08:41:32"
"11023","51","20130220075631","Shop","AAA03","5","85000","15000","70000","2013-02-20 07:56:31"
"11024","63","20130219112104","PC","AAA03","2","34000","6000","28000","2013-02-19 23:21:04"
"11025","71","20130219070607","PC","AAA01","1","10000","2000","8000","2013-02-19 07:06:07"
"11026","41","20130218075411","Mobile","AAA03","5","85000","15000","70000","2013-02-18 19:54:11"
"11027","57","20130218121624","Shop","AAA01","4","40000","8000","32000","2013-02-18 12:16:24"
"11028","57","20130218091254","PC","AAA02","2","30000","4600","25400","2013-02-18 09:12:54"
"11029","99","20130214072020","Shop","AAA04","3","24000","1200","22800","2013-02-14 19:20:20"
"11030","76","20130214015515","Mobile","AAA04","3","24000","1200","22800","2013-02-14 13:55:15"
"11031","34","20130214085002","PC","AAA02","2","30000","4600","25400","2013-02-14 08:50:02"
"11032","54","20130214072125","Mobile","AAA03","1","17000","3000","14000","2013-02-14 07:21:25"
"11033","77","20130213093842","Shop","AAA03","1","17000","3000","14000","2013-02-13 09:38:42"
"11034","60","20130213082242","Mobile","AAA03","2","34000","6000","28000","2013-02-13 08:22:42"
"11035","99","20130213070233","Shop","AAA01","1","10000","2000","8000","2013-02-13 07:02:33"
"11036","98","20130212125730","PC","AAA01","1","10000","2000","8000","2013-02-12 12:57:30"
"11037","64","20130212113357","PC","AAA04","3","24000","1200","22800","2013-02-12 11:33:57"
"11038","42","20130212085625","Mobile","AAA02","1","15000","2300","12700","2013-02-12 08:56:25"
"11039","28","20130212075603","PC","AAA01","7","70000","14000","56000","2013-02-12 07:56:03"
"11040","21","20130211084858","PC","AAA02","4","60000","9200","50800","2013-02-11 08:48:58"
"11041","74","20130206045818","Shop","AAA01","4","40000","8000","32000","2013-02-06 04:58:18"
"11042","42","20130205033048","Shop","AAA03","10","170000","30000","140000","2013-02-05 15:30:48"
"11043","86","20130205021344","PC","AAA04","5","40000","2000","38000","2013-02-05 14:13:44"
"11044","2","20130205123342","Mobile","AAA03","1","17000","3000","14000","2013-02-05 12:33:42"
"11045","2","20130205102353","Mobile","AAA05","4","240000","80000","160000","2013-02-05 10:23:53"
"11046","97","20130205092905","Shop","AAA02","8","120000","18400","101600","2013-02-05 09:29:05"
"11047","77","20130205072146","PC","AAA02","1","15000","2300","12700","2013-02-05 07:21:46"
"11048","100","20130204083636","Mobile","AAA05","3","180000","60000","120000","2013-02-04 20:36:36"
"11049","12","20130204020801","PC","AAA02","4","60000","9200","50800","2013-02-04 14:08:01"
"11050","96","20130204125910","PC","AAA05","3","180000","60000","120000","2013-02-04 12:59:10"
"11051","15","20130204110358","Shop","AAA03","5","85000","15000","70000","2013-02-04 11:03:58"
"11052","87","20130130032105","PC","AAA04","2","16000","800","15200","2013-01-30 03:21:05"
"11053","46","20130129124437","PC","AAA01","1","10000","2000","8000","2013-01-29 12:44:37"
"11054","77","20130129111718","Mobile","AAA05","1","60000","20000","40000","2013-01-29 11:17:18"
"11055","5","20130129085535","PC","AAA04","3","24000","1200","22800","2013-01-29 08:55:35"
"11056","10","20130129065526","Shop","AAA05","9","540000","180000","360000","2013-01-29 06:55:26"
"11057","27","20130128041713","Shop","AAA05","5","300000","100000","200000","2013-01-28 16:17:13"
"11058","69","20130128015520","Shop","AAA05","1","60000","20000","40000","2013-01-28 13:55:20"
"11059","76","20130128010659","Shop","AAA03","2","34000","6000","28000","2013-01-28 13:06:59"
"11060","48","20130128110324","Mobile","AAA02","5","75000","11500","63500","2013-01-28 11:03:24"
"11061","47","20130128101416","PC","AAA05","4","240000","80000","160000","2013-01-28 10:14:16"
"11062","46","20130128090520","Mobile","AAA04","4","32000","1600","30400","2013-01-28 09:05:20"
"11063","36","20130125065814","Shop","AAA05","1","60000","20000","40000","2013-01-25 18:58:14"
"11064","51","20130125115141","Shop","AAA01","2","20000","4000","16000","2013-01-25 11:51:41"
"11065","27","20130125082258","Shop","AAA01","3","30000","6000","24000","2013-01-25 08:22:58"
"11066","33","20130125062921","Shop","AAA03","2","34000","6000","28000","2013-01-25 06:29:21"
"11067","98","20130124093322","Mobile","AAA03","2","34000","6000","28000","2013-01-24 09:33:22"
"11068","24","20130124081400","Mobile","AAA03","2","34000","6000","28000","2013-01-24 08:14:00"
"11069","39","20130124064800","PC","AAA05","4","240000","80000","160000","2013-01-24 06:48:00"
"11070","44","20130124035037","Mobile","AAA03","5","85000","15000","70000","2013-01-24 03:50:37"
"11071","53","20130123063323","Shop","AAA04","1","8000","400","7600","2013-01-23 06:33:23"
"11072","87","20130123024935","Mobile","AAA01","1","10000","2000","8000","2013-01-23 02:49:35"
"11073","77","20130122024143","Mobile","AAA02","2","30000","4600","25400","2013-01-22 14:41:43"
"11074","38","20130122125027","Mobile","AAA04","2","16000","800","15200","2013-01-22 12:50:27"
"11075","98","20130122095737","Shop","AAA05","4","240000","80000","160000","2013-01-22 09:57:37"
"11076","92","20130122083946","Mobile","AAA02","1","15000","2300","12700","2013-01-22 08:39:46"
"11077","24","20130122062410","Shop","AAA05","5","300000","100000","200000","2013-01-22 06:24:10"
"11078","48","20130121031025","PC","AAA04","2","16000","800","15200","2013-01-21 15:10:25"
"11079","73","20130121014903","PC","AAA03","1","17000","3000","14000","2013-01-21 13:49:03"
"11080","25","20130121121047","Mobile","AAA05","6","360000","120000","240000","2013-01-21 12:10:47"
"11081","86","20130121105134","Shop","AAA01","3","30000","6000","24000","2013-01-21 10:51:34"
"11082","18","20130118013326","PC","AAA05","4","240000","80000","160000","2013-01-18 13:33:26"
"11083","23","20130118122134","Shop","AAA03","3","51000","9000","42000","2013-01-18 12:21:34"
"11084","88","20130118111931","Shop","AAA05","1","60000","20000","40000","2013-01-18 11:19:31"
"11085","99","20130118094425","PC","AAA02","7","105000","16100","88900","2013-01-18 09:44:25"
"11086","30","20130118091503","Shop","AAA01","3","30000","6000","24000","2013-01-18 09:15:03"
"11087","6","20130118075351","Mobile","AAA03","4","68000","12000","56000","2013-01-18 07:53:51"
"11088","63","20130117120034","PC","AAA05","1","60000","20000","40000","2013-01-17 12:00:34"
"11089","12","20130117112939","PC","AAA03","1","17000","3000","14000","2013-01-17 11:29:39"
"11090","25","20130117102735","PC","AAA04","2","16000","800","15200","2013-01-17 10:27:35"
"11091","31","20130117091410","Shop","AAA05","2","120000","40000","80000","2013-01-17 09:14:10"
"11092","89","20130117065523","Shop","AAA03","4","68000","12000","56000","2013-01-17 06:55:23"
"11093","7","20130117121234","Mobile","AAA01","2","20000","4000","16000","2013-01-17 00:12:34"
"11094","26","20130116110025","Mobile","AAA03","2","34000","6000","28000","2013-01-16 11:00:25"
"11095","70","20130116092923","Mobile","AAA05","5","300000","100000","200000","2013-01-16 09:29:23"
"11096","78","20130116072627","Mobile","AAA05","1","60000","20000","40000","2013-01-16 07:26:27"
"11097","19","20130116035600","Mobile","AAA05","1","60000","20000","40000","2013-01-16 03:56:00"
"11098","5","20130115121511","Mobile","AAA01","1","10000","2000","8000","2013-01-15 12:15:11"
"11099","80","20130115102123","Mobile","AAA02","4","60000","9200","50800","2013-01-15 10:21:23"
"11100","61","20130115085858","PC","AAA05","4","240000","80000","160000","2013-01-15 08:58:58"
"11101","100","20130114113527","PC","AAA01","1","10000","2000","8000","2013-01-14 11:35:27"
"11102","9","20130114105027","PC","AAA05","1","60000","20000","40000","2013-01-14 10:50:27"
"11103","43","20130114083305","Mobile","AAA03","3","51000","9000","42000","2013-01-14 08:33:05"
"11104","73","20130109084314","Shop","AAA05","1","60000","20000","40000","2013-01-09 08:43:14"
"11105","9","20130109070402","Shop","AAA01","2","20000","4000","16000","2013-01-09 07:04:02"
"11106","50","20130108074339","Shop","AAA03","2","34000","6000","28000","2013-01-08 19:43:39"
"11107","56","20130108021549","Mobile","AAA03","2","34000","6000","28000","2013-01-08 14:15:49"
"11108","38","20130108103017","Shop","AAA03","6","102000","18000","84000","2013-01-08 10:30:17"
"11109","51","20130108075642","Shop","AAA01","6","60000","12000","48000","2013-01-08 07:56:42"
"11110","84","20130107040823","PC","AAA02","2","30000","4600","25400","2013-01-07 04:08:23"
"11111","73","20130102122656","Mobile","AAA01","7","70000","14000","56000","2013-01-02 00:26:56"
"11112","58","20130101082236","Shop","AAA02","1","15000","2300","12700","2013-01-01 08:22:36"
"11113","51","20121231053928","Shop","AAA05","3","180000","60000","120000","2012-12-31 17:39:28"
"11114","37","20121231035405","Shop","AAA04","4","32000","1600","30400","2012-12-31 15:54:05"
"11115","54","20121231023226","PC","AAA05","2","120000","40000","80000","2012-12-31 14:32:26"
"11116","13","20121231104150","PC","AAA04","2","16000","800","15200","2012-12-31 10:41:50"
"11117","15","20121231080943","PC","AAA04","4","32000","1600","30400","2012-12-31 08:09:43"
"11118","55","20121228100104","Mobile","AAA04","5","40000","2000","38000","2012-12-28 10:01:04"
"11119","69","20121228084055","PC","AAA05","2","120000","40000","80000","2012-12-28 08:40:55"
"11120","38","20121228073708","PC","AAA03","1","17000","3000","14000","2012-12-28 07:37:08"
"11121","89","20121227024905","PC","AAA01","11","110000","22000","88000","2012-12-27 14:49:05"
"11122","69","20121227124243","PC","AAA04","2","16000","800","15200","2012-12-27 12:42:43"
"11123","21","20121227110428","PC","AAA01","3","30000","6000","24000","2012-12-27 11:04:28"
"11124","4","20121227095317","Mobile","AAA04","3","24000","1200","22800","2012-12-27 09:53:17"
"11125","1","20121226033855","Mobile","AAA05","4","240000","80000","160000","2012-12-26 15:38:55"
"11126","51","20121226022714","Mobile","AAA02","5","75000","11500","63500","2012-12-26 14:27:14"
"11127","73","20121226011007","PC","AAA03","1","17000","3000","14000","2012-12-26 13:10:07"
"11128","34","20121226120943","Mobile","AAA03","1","17000","3000","14000","2012-12-26 12:09:43"
"11129","27","20121226104357","PC","AAA03","5","85000","15000","70000","2012-12-26 10:43:57"
"11130","76","20121226093144","PC","AAA05","1","60000","20000","40000","2012-12-26 09:31:44"
"11131","47","20121226073144","Mobile","AAA05","4","240000","80000","160000","2012-12-26 07:31:44"
"11132","67","20121225042954","Mobile","AAA03","3","51000","9000","42000","2012-12-25 16:29:54"
"11133","25","20121225023355","PC","AAA03","4","68000","12000","56000","2012-12-25 14:33:55"
"11134","75","20121225123812","Shop","AAA02","1","15000","2300","12700","2012-12-25 12:38:12"
"11135","34","20121225102848","Mobile","AAA02","6","90000","13800","76200","2012-12-25 10:28:48"
"11136","80","20121225071558","PC","AAA03","5","85000","15000","70000","2012-12-25 07:15:58"
"11137","49","20121224035910","PC","AAA03","8","136000","24000","112000","2012-12-24 15:59:10"
"11138","7","20121224021103","Shop","AAA02","2","30000","4600","25400","2012-12-24 14:11:03"
"11139","27","20121224123721","Shop","AAA02","3","45000","6900","38100","2012-12-24 12:37:21"
"11140","20","20121224091115","Mobile","AAA03","3","51000","9000","42000","2012-12-24 09:11:15"
"11141","90","20121217012619","Shop","AAA01","2","20000","4000","16000","2012-12-17 01:26:19"
"11142","75","20121214093309","Shop","AAA02","4","60000","9200","50800","2012-12-14 09:33:09"
"11143","47","20121214072703","Mobile","AAA04","5","40000","2000","38000","2012-12-14 07:27:03"
"11144","70","20121213011820","Mobile","AAA04","3","24000","1200","22800","2012-12-13 13:18:20"
"11145","89","20121213090743","PC","AAA03","6","102000","18000","84000","2012-12-13 09:07:43"
"11146","21","20121213071400","PC","AAA05","5","300000","100000","200000","2012-12-13 07:14:00"
"11147","52","20121212012025","PC","AAA04","4","32000","1600","30400","2012-12-12 13:20:25"
"11148","42","20121212123120","PC","AAA02","7","105000","16100","88900","2012-12-12 12:31:20"
"11149","17","20121212101248","Shop","AAA02","2","30000","4600","25400","2012-12-12 10:12:48"
"11150","24","20121212092230","Mobile","AAA03","2","34000","6000","28000","2012-12-12 09:22:30"
"11151","86","20121212085121","PC","AAA04","1","8000","400","7600","2012-12-12 08:51:21"
"11152","5","20121212065550","Mobile","AAA02","4","60000","9200","50800","2012-12-12 06:55:50"
"11153","91","20121212061208","Mobile","AAA04","4","32000","1600","30400","2012-12-12 06:12:08"
"11154","19","20121211012504","Shop","AAA01","1","10000","2000","8000","2012-12-11 13:25:04"
"11155","15","20121211115410","Shop","AAA02","3","45000","6900","38100","2012-12-11 11:54:10"
"11156","16","20121211110932","PC","AAA01","3","30000","6000","24000","2012-12-11 11:09:32"
"11157","36","20121211093725","PC","AAA03","9","153000","27000","126000","2012-12-11 09:37:25"
"11158","42","20121211073842","Mobile","AAA03","4","68000","12000","56000","2012-12-11 07:38:42"
"11159","91","20121210042242","Shop","AAA03","2","34000","6000","28000","2012-12-10 16:22:42"
"11160","40","20121210025101","Shop","AAA03","2","34000","6000","28000","2012-12-10 14:51:01"
"11161","35","20121210120954","Mobile","AAA04","2","16000","800","15200","2012-12-10 12:09:54"
"11162","29","20121210101410","Mobile","AAA05","1","60000","20000","40000","2012-12-10 10:14:10"
"11163","99","20121210085026","Shop","AAA03","2","34000","6000","28000","2012-12-10 08:50:26"
"11164","19","20121206014937","Shop","AAA05","1","60000","20000","40000","2012-12-06 13:49:37"
"11165","61","20121206103135","Shop","AAA02","1","15000","2300","12700","2012-12-06 10:31:35"
"11166","37","20121206084205","PC","AAA04","2","16000","800","15200","2012-12-06 08:42:05"
"11167","49","20121206070230","PC","AAA02","6","90000","13800","76200","2012-12-06 07:02:30"
"11168","34","20121205020207","Mobile","AAA01","1","10000","2000","8000","2012-12-05 14:02:07"
"11169","20","20121205123422","Mobile","AAA05","6","360000","120000","240000","2012-12-05 12:34:22"
"11170","26","20121205120021","PC","AAA04","1","8000","400","7600","2012-12-05 12:00:21"
"11171","42","20121205093942","Shop","AAA02","6","90000","13800","76200","2012-12-05 09:39:42"
"11172","15","20121205075202","Shop","AAA04","7","56000","2800","53200","2012-12-05 07:52:02"
"11173","1","20121204053410","Shop","AAA03","1","17000","3000","14000","2012-12-04 05:34:10"
"11174","1","20121203060502","Mobile","AAA04","4","32000","1600","30400","2012-12-03 06:05:02"
"11175","47","20121129041450","Shop","AAA01","1","10000","2000","8000","2012-11-29 04:14:50"
"11176","50","20121128043604","Mobile","AAA01","1","10000","2000","8000","2012-11-28 16:36:04"
"11177","92","20121128015818","Mobile","AAA02","6","90000","13800","76200","2012-11-28 13:58:18"
"11178","13","20121128095807","PC","AAA01","2","20000","4000","16000","2012-11-28 09:58:07"
"11179","72","20121128085839","PC","AAA01","2","20000","4000","16000","2012-11-28 08:58:39"
"11180","1","20121128071636","Shop","AAA05","1","60000","20000","40000","2012-11-28 07:16:36"
"11181","6","20121127073912","PC","AAA01","1","10000","2000","8000","2012-11-27 19:39:12"
"11182","87","20121127023251","Mobile","AAA02","2","30000","4600","25400","2012-11-27 14:32:51"
"11183","92","20121127014729","Mobile","AAA01","5","50000","10000","40000","2012-11-27 13:47:29"
"11184","80","20121127125408","PC","AAA02","2","30000","4600","25400","2012-11-27 12:54:08"
"11185","42","20121127122250","Mobile","AAA03","5","85000","15000","70000","2012-11-27 12:22:50"
"11186","41","20121127084818","Shop","AAA04","4","32000","1600","30400","2012-11-27 08:48:18"
"11187","91","20121127072135","Shop","AAA05","1","60000","20000","40000","2012-11-27 07:21:35"
"11188","74","20121126063640","Shop","AAA01","1","10000","2000","8000","2012-11-26 18:36:40"
"11189","27","20121126020214","Shop","AAA04","8","64000","3200","60800","2012-11-26 14:02:14"
"11190","6","20121126120909","PC","AAA02","3","45000","6900","38100","2012-11-26 12:09:09"
"11191","83","20121126103730","Mobile","AAA05","5","300000","100000","200000","2012-11-26 10:37:30"
"11192","89","20121126073738","Shop","AAA01","3","30000","6000","24000","2012-11-26 07:37:38"
"11193","82","20121122090524","Shop","AAA02","5","75000","11500","63500","2012-11-22 09:05:24"
"11194","27","20121122072652","Shop","AAA04","5","40000","2000","38000","2012-11-22 07:26:52"
"11195","4","20121121125701","Mobile","AAA05","1","60000","20000","40000","2012-11-21 12:57:01"
"11196","62","20121121111048","PC","AAA05","3","180000","60000","120000","2012-11-21 11:10:48"
"11197","23","20121121092631","Shop","AAA03","3","51000","9000","42000","2012-11-21 09:26:31"
"11198","29","20121121063832","Mobile","AAA03","3","51000","9000","42000","2012-11-21 06:38:32"
"11199","71","20121120124212","Mobile","AAA04","1","8000","400","7600","2012-11-20 12:42:12"
"11200","99","20121120112558","Shop","AAA05","1","60000","20000","40000","2012-11-20 11:25:58"
"11201","91","20121120093701","Mobile","AAA04","1","8000","400","7600","2012-11-20 09:37:01"
"11202","38","20121120083352","PC","AAA02","3","45000","6900","38100","2012-11-20 08:33:52"
"11203","9","20121120063834","Shop","AAA02","1","15000","2300","12700","2012-11-20 06:38:34"
"11204","35","20121119102855","PC","AAA01","4","40000","8000","32000","2012-11-19 10:28:55"
"11205","63","20121119082536","Shop","AAA03","3","51000","9000","42000","2012-11-19 08:25:36"
"11206","52","20121112090828","Mobile","AAA01","2","20000","4000","16000","2012-11-12 21:08:28"
"11207","81","20121112025604","Mobile","AAA04","2","16000","800","15200","2012-11-12 14:56:04"
"11208","81","20121112124346","Shop","AAA05","2","120000","40000","80000","2012-11-12 12:43:46"
"11209","59","20121112103640","PC","AAA02","1","15000","2300","12700","2012-11-12 10:36:40"
"11210","69","20121112090023","Mobile","AAA04","1","8000","400","7600","2012-11-12 09:00:23"
"11211","34","20121108014929","PC","AAA04","7","56000","2800","53200","2012-11-08 01:49:29"
"11212","68","20121107103726","Mobile","AAA04","3","24000","1200","22800","2012-11-07 10:37:26"
"11213","35","20121107090059","Mobile","AAA03","1","17000","3000","14000","2012-11-07 09:00:59"
"11214","96","20121107061932","PC","AAA04","6","48000","2400","45600","2012-11-07 06:19:32"
"11215","62","20121106012815","PC","AAA02","1","15000","2300","12700","2012-11-06 13:28:15"
"11216","16","20121106112629","Mobile","AAA05","10","600000","200000","400000","2012-11-06 11:26:29"
"11217","8","20121106101904","Shop","AAA02","7","105000","16100","88900","2012-11-06 10:19:04"
"11218","20","20121106082843","PC","AAA01","3","30000","6000","24000","2012-11-06 08:28:43"
"11219","94","20121105060319","PC","AAA02","2","30000","4600","25400","2012-11-05 18:03:19"
"11220","57","20121105115837","PC","AAA03","2","34000","6000","28000","2012-11-05 11:58:37"
"11221","62","20121105093243","Shop","AAA01","7","70000","14000","56000","2012-11-05 09:32:43"
"11222","91","20121101113800","PC","AAA04","2","16000","800","15200","2012-11-01 23:38:00"
"11223","87","20121101033300","PC","AAA04","3","24000","1200","22800","2012-11-01 15:33:00"
"11224","25","20121101020418","Mobile","AAA05","2","120000","40000","80000","2012-11-01 14:04:18"
"11225","1","20121101123110","Mobile","AAA02","5","75000","11500","63500","2012-11-01 12:31:10"
"11226","18","20121101112733","PC","AAA04","3","24000","1200","22800","2012-11-01 11:27:33"
"11227","20","20121101090056","Shop","AAA04","2","16000","800","15200","2012-11-01 09:00:56"
"11228","77","20121101071258","Mobile","AAA05","2","120000","40000","80000","2012-11-01 07:12:58"
"11229","75","20121031015435","Shop","AAA04","1","8000","400","7600","2012-10-31 13:54:35"
"11230","38","20121031123045","PC","AAA04","2","16000","800","15200","2012-10-31 12:30:45"
"11231","76","20121031100629","Mobile","AAA01","4","40000","8000","32000","2012-10-31 10:06:29"
"11232","26","20121031071908","PC","AAA05","1","60000","20000","40000","2012-10-31 07:19:08"
"11233","85","20121030032651","Mobile","AAA02","4","60000","9200","50800","2012-10-30 15:26:51"
"11234","13","20121030011430","Mobile","AAA03","1","17000","3000","14000","2012-10-30 13:14:30"
"11235","32","20121030101002","PC","AAA02","4","60000","9200","50800","2012-10-30 10:10:02"
"11236","29","20121030082807","PC","AAA05","2","120000","40000","80000","2012-10-30 08:28:07"
"11237","88","20121030064623","PC","AAA05","2","120000","40000","80000","2012-10-30 06:46:23"
"11238","32","20121029100331","PC","AAA05","8","480000","160000","320000","2012-10-29 22:03:31"
"11239","25","20121029050603","Shop","AAA05","3","180000","60000","120000","2012-10-29 17:06:03"
"11240","43","20121029035152","Shop","AAA05","1","60000","20000","40000","2012-10-29 15:51:52"
"11241","6","20121029013812","PC","AAA05","1","60000","20000","40000","2012-10-29 13:38:12"
"11242","89","20121029115620","PC","AAA02","4","60000","9200","50800","2012-10-29 11:56:20"
"11243","76","20121029095728","Shop","AAA04","1","8000","400","7600","2012-10-29 09:57:28"
"11244","38","20121023035814","Mobile","AAA03","1","17000","3000","14000","2012-10-23 03:58:14"
"11245","75","20121022101057","Shop","AAA05","1","60000","20000","40000","2012-10-22 10:10:57"
"11246","36","20121022075915","Mobile","AAA03","7","119000","21000","98000","2012-10-22 07:59:15"
"11247","45","20121017084124","PC","AAA04","3","24000","1200","22800","2012-10-17 20:41:24"
"11248","16","20121017013142","PC","AAA05","8","480000","160000","320000","2012-10-17 13:31:42"
"11249","39","20121017114956","Mobile","AAA03","4","68000","12000","56000","2012-10-17 11:49:56"
"11250","1","20121017113516","PC","AAA05","5","300000","100000","200000","2012-10-17 11:35:16"
"11251","79","20121017090853","Shop","AAA04","3","24000","1200","22800","2012-10-17 09:08:53"
"11252","6","20121017074505","Mobile","AAA05","2","120000","40000","80000","2012-10-17 07:45:05"
"11253","98","20121016065044","Mobile","AAA01","3","30000","6000","24000","2012-10-16 18:50:44"
"11254","92","20121016044553","Mobile","AAA04","3","24000","1200","22800","2012-10-16 16:45:53"
"11255","87","20121016040559","PC","AAA03","4","68000","12000","56000","2012-10-16 16:05:59"
"11256","57","20121016015932","PC","AAA05","2","120000","40000","80000","2012-10-16 13:59:32"
"11257","46","20121016011538","Shop","AAA04","2","16000","800","15200","2012-10-16 13:15:38"
"11258","20","20121016113112","Shop","AAA01","2","20000","4000","16000","2012-10-16 11:31:12"
"11259","86","20121016102131","Shop","AAA02","2","30000","4600","25400","2012-10-16 10:21:31"
"11260","21","20121016082658","Shop","AAA02","6","90000","13800","76200","2012-10-16 08:26:58"
"11261","27","20121016063723","Mobile","AAA02","4","60000","9200","50800","2012-10-16 06:37:23"
"11262","37","20121009083828","Mobile","AAA03","2","34000","6000","28000","2012-10-09 08:38:28"
"11263","8","20121009074338","Shop","AAA05","3","180000","60000","120000","2012-10-09 07:43:38"
"11264","19","20121009120515","PC","AAA04","1","8000","400","7600","2012-10-09 00:05:15"
"11265","18","20121008051544","Mobile","AAA04","7","56000","2800","53200","2012-10-08 17:15:44"
"11266","16","20121008030001","Shop","AAA03","2","34000","6000","28000","2012-10-08 15:00:01"
"11267","30","20121008091858","Mobile","AAA03","3","51000","9000","42000","2012-10-08 09:18:58"
"11268","16","20121004121125","PC","AAA02","5","75000","11500","63500","2012-10-04 00:11:25"
"11269","72","20121002124427","PC","AAA04","2","16000","800","15200","2012-10-02 12:44:27"
"11270","73","20121002100546","Mobile","AAA01","5","50000","10000","40000","2012-10-02 10:05:46"
"11271","86","20121002085715","Shop","AAA04","2","16000","800","15200","2012-10-02 08:57:15"
"11272","13","20121002062922","PC","AAA05","4","240000","80000","160000","2012-10-02 06:29:22"
"11273","86","20121001091347","PC","AAA02","6","90000","13800","76200","2012-10-01 21:13:47"
"11274","45","20121001061127","Shop","AAA03","3","51000","9000","42000","2012-10-01 18:11:27"
"11275","78","20121001035643","Shop","AAA01","1","10000","2000","8000","2012-10-01 15:56:43"
"11276","29","20121001020600","Mobile","AAA04","2","16000","800","15200","2012-10-01 14:06:00"
"11277","69","20121001115750","PC","AAA02","1","15000","2300","12700","2012-10-01 11:57:50"
"11278","21","20121001103003","PC","AAA02","1","15000","2300","12700","2012-10-01 10:30:03"
"11279","21","20120926110516","Mobile","AAA05","5","300000","100000","200000","2012-09-26 11:05:16"
"11280","12","20120926074930","Mobile","AAA05","1","60000","20000","40000","2012-09-26 07:49:30"
"11281","93","20120925080642","PC","AAA01","2","20000","4000","16000","2012-09-25 20:06:42"
"11282","96","20120925021525","Shop","AAA02","2","30000","4600","25400","2012-09-25 14:15:25"
"11283","39","20120925122131","Shop","AAA05","3","180000","60000","120000","2012-09-25 12:21:31"
"11284","69","20120925094947","Mobile","AAA05","2","120000","40000","80000","2012-09-25 09:49:47"
"11285","49","20120925065610","Shop","AAA03","5","85000","15000","70000","2012-09-25 06:56:10"
"11286","41","20120924071514","Shop","AAA02","4","60000","9200","50800","2012-09-24 19:15:14"
"11287","30","20120924030503","Mobile","AAA05","4","240000","80000","160000","2012-09-24 15:05:03"
"11288","99","20120924014546","Mobile","AAA05","2","120000","40000","80000","2012-09-24 13:45:46"
"11289","3","20120924120415","PC","AAA02","3","45000","6900","38100","2012-09-24 12:04:15"
"11290","7","20120924090256","PC","AAA04","5","40000","2000","38000","2012-09-24 09:02:56"
"11291","69","20120918104259","Mobile","AAA01","1","10000","2000","8000","2012-09-18 10:42:59"
"11292","37","20120918090600","PC","AAA05","8","480000","160000","320000","2012-09-18 09:06:00"
"11293","46","20120917033221","PC","AAA04","4","32000","1600","30400","2012-09-17 15:32:21"
"11294","65","20120917015732","Shop","AAA04","5","40000","2000","38000","2012-09-17 13:57:32"
"11295","21","20120917125557","PC","AAA02","6","90000","13800","76200","2012-09-17 12:55:57"
"11296","68","20120917112120","PC","AAA04","1","8000","400","7600","2012-09-17 11:21:20"
"11297","94","20120917091647","PC","AAA04","6","48000","2400","45600","2012-09-17 09:16:47"
"11298","75","20120913105237","Shop","AAA02","1","15000","2300","12700","2012-09-13 10:52:37"
"11299","10","20120913084723","Shop","AAA03","5","85000","15000","70000","2012-09-13 08:47:23"
"11300","32","20120912020045","Shop","AAA04","7","56000","2800","53200","2012-09-12 14:00:45"
"11301","5","20120912125702","Mobile","AAA01","5","50000","10000","40000","2012-09-12 12:57:02"
"11302","80","20120912111341","Mobile","AAA04","1","8000","400","7600","2012-09-12 11:13:41"
"11303","58","20120912094721","PC","AAA01","5","50000","10000","40000","2012-09-12 09:47:21"
"11304","84","20120912081736","PC","AAA02","1","15000","2300","12700","2012-09-12 08:17:36"
"11305","66","20120912072644","Shop","AAA04","1","8000","400","7600","2012-09-12 07:26:44"
"11306","6","20120911031136","PC","AAA05","1","60000","20000","40000","2012-09-11 15:11:36"
"11307","87","20120911110036","Mobile","AAA01","4","40000","8000","32000","2012-09-11 11:00:36"
"11308","54","20120911085323","PC","AAA03","1","17000","3000","14000","2012-09-11 08:53:23"
"11309","40","20120911072118","Shop","AAA02","2","30000","4600","25400","2012-09-11 07:21:18"
"11310","30","20120910092741","PC","AAA02","1","15000","2300","12700","2012-09-10 09:27:41"
"11311","98","20120907113002","PC","AAA02","1","15000","2300","12700","2012-09-07 23:30:02"
"11312","43","20120907105639","Mobile","AAA05","8","480000","160000","320000","2012-09-07 10:56:39"
"11313","32","20120907092850","Mobile","AAA05","4","240000","80000","160000","2012-09-07 09:28:50"
"11314","76","20120907073902","Mobile","AAA04","2","16000","800","15200","2012-09-07 07:39:02"
"11315","54","20120906045828","Mobile","AAA01","1","10000","2000","8000","2012-09-06 16:58:28"
"11316","74","20120906024709","Shop","AAA03","1","17000","3000","14000","2012-09-06 14:47:09"
"11317","97","20120906012218","Shop","AAA05","1","60000","20000","40000","2012-09-06 13:22:18"
"11318","44","20120906120509","PC","AAA01","6","60000","12000","48000","2012-09-06 12:05:09"
"11319","67","20120906102253","Shop","AAA01","5","50000","10000","40000","2012-09-06 10:22:53"
"11320","73","20120906091829","Shop","AAA03","1","17000","3000","14000","2012-09-06 09:18:29"
"11321","6","20120906073753","Mobile","AAA05","3","180000","60000","120000","2012-09-06 07:37:53"
"11322","39","20120905032720","PC","AAA05","3","180000","60000","120000","2012-09-05 15:27:20"
"11323","56","20120905020756","PC","AAA03","4","68000","12000","56000","2012-09-05 14:07:56"
"11324","72","20120905112117","PC","AAA04","1","8000","400","7600","2012-09-05 11:21:17"
"11325","92","20120905093011","Mobile","AAA01","5","50000","10000","40000","2012-09-05 09:30:11"
"11326","17","20120905075122","Mobile","AAA03","1","17000","3000","14000","2012-09-05 07:51:22"
"11327","65","20120904120843","PC","AAA04","4","32000","1600","30400","2012-09-04 12:08:43"
"11328","52","20120904103428","Mobile","AAA03","3","51000","9000","42000","2012-09-04 10:34:28"
"11329","73","20120904091344","Mobile","AAA01","1","10000","2000","8000","2012-09-04 09:13:44"
"11330","86","20120904072807","Mobile","AAA02","1","15000","2300","12700","2012-09-04 07:28:07"
"11331","83","20120903090418","Mobile","AAA02","6","90000","13800","76200","2012-09-03 21:04:18"
"11332","73","20120903021548","PC","AAA03","2","34000","6000","28000","2012-09-03 14:15:48"
"11333","20","20120903093257","Shop","AAA04","1","8000","400","7600","2012-09-03 09:32:57"
"11334","42","20120827103759","PC","AAA02","6","90000","13800","76200","2012-08-27 10:37:59"
"11335","3","20120827083033","Shop","AAA03","1","17000","3000","14000","2012-08-27 08:30:33"
"11336","100","20120821041027","Mobile","AAA05","1","60000","20000","40000","2012-08-21 16:10:27"
"11337","95","20120821124637","Shop","AAA01","3","30000","6000","24000","2012-08-21 12:46:37"
"11338","25","20120821101042","Mobile","AAA03","6","102000","18000","84000","2012-08-21 10:10:42"
"11339","48","20120821070300","PC","AAA02","1","15000","2300","12700","2012-08-21 07:03:00"
"11340","60","20120820075048","Mobile","AAA03","1","17000","3000","14000","2012-08-20 19:50:48"
"11341","46","20120820030203","PC","AAA03","7","119000","21000","98000","2012-08-20 15:02:03"
"11342","17","20120820015835","Mobile","AAA05","1","60000","20000","40000","2012-08-20 13:58:35"
"11343","98","20120820113624","Shop","AAA03","2","34000","6000","28000","2012-08-20 11:36:24"
"11344","32","20120820095015","Shop","AAA03","3","51000","9000","42000","2012-08-20 09:50:15"
"11345","22","20120817030947","PC","AAA03","1","17000","3000","14000","2012-08-17 03:09:47"
"11346","9","20120816083442","Mobile","AAA01","1","10000","2000","8000","2012-08-16 08:34:42"
"11347","42","20120816013125","Mobile","AAA03","4","68000","12000","56000","2012-08-16 01:31:25"
"11348","46","20120815032944","Shop","AAA04","3","24000","1200","22800","2012-08-15 15:29:44"
"11349","65","20120815012228","Shop","AAA04","7","56000","2800","53200","2012-08-15 13:22:28"
"11350","86","20120815115630","PC","AAA03","1","17000","3000","14000","2012-08-15 11:56:30"
"11351","82","20120815112634","PC","AAA03","4","68000","12000","56000","2012-08-15 11:26:34"
"11352","22","20120815101521","Shop","AAA04","1","8000","400","7600","2012-08-15 10:15:21"
"11353","41","20120815083142","PC","AAA04","3","24000","1200","22800","2012-08-15 08:31:42"
"11354","74","20120815080256","Shop","AAA03","1","17000","3000","14000","2012-08-15 08:02:56"
"11355","93","20120814102349","PC","AAA01","3","30000","6000","24000","2012-08-14 10:23:49"
"11356","13","20120814081338","Mobile","AAA02","1","15000","2300","12700","2012-08-14 08:13:38"
"11357","15","20120814064816","Mobile","AAA03","6","102000","18000","84000","2012-08-14 06:48:16"
"11358","28","20120813070549","Mobile","AAA05","3","180000","60000","120000","2012-08-13 19:05:49"
"11359","77","20120813010606","PC","AAA05","1","60000","20000","40000","2012-08-13 13:06:06"
"11360","34","20120813114716","PC","AAA05","3","180000","60000","120000","2012-08-13 11:47:16"
"11361","29","20120813074024","Shop","AAA01","4","40000","8000","32000","2012-08-13 07:40:24"
"11362","94","20120809074157","PC","AAA03","3","51000","9000","42000","2012-08-09 07:41:57"
"11363","46","20120808014243","PC","AAA02","1","15000","2300","12700","2012-08-08 13:42:43"
"11364","95","20120808124931","Mobile","AAA02","3","45000","6900","38100","2012-08-08 12:49:31"
"11365","71","20120808092055","PC","AAA03","3","51000","9000","42000","2012-08-08 09:20:55"
"11366","84","20120808064606","Shop","AAA02","2","30000","4600","25400","2012-08-08 06:46:06"
"11367","5","20120807050826","Shop","AAA03","1","17000","3000","14000","2012-08-07 17:08:26"
"11368","77","20120807033555","Mobile","AAA01","3","30000","6000","24000","2012-08-07 15:35:55"
"11369","33","20120807024757","Shop","AAA01","2","20000","4000","16000","2012-08-07 14:47:57"
"11370","9","20120807010033","PC","AAA04","1","8000","400","7600","2012-08-07 13:00:33"
"11371","45","20120807110347","PC","AAA03","1","17000","3000","14000","2012-08-07 11:03:47"
"11372","27","20120807082753","PC","AAA04","7","56000","2800","53200","2012-08-07 08:27:53"
"11373","39","20120807071802","PC","AAA01","2","20000","4000","16000","2012-08-07 07:18:02"
"11374","72","20120806063240","Mobile","AAA04","1","8000","400","7600","2012-08-06 18:32:40"
"11375","60","20120806020706","Shop","AAA04","1","8000","400","7600","2012-08-06 14:07:06"
"11376","65","20120806122926","Shop","AAA04","3","24000","1200","22800","2012-08-06 12:29:26"
"11377","40","20120806104058","Mobile","AAA05","2","120000","40000","80000","2012-08-06 10:40:58"
"11378","34","20120806091018","Mobile","AAA04","4","32000","1600","30400","2012-08-06 09:10:18"
"11379","18","20120803030930","PC","AAA05","2","120000","40000","80000","2012-08-03 03:09:30"
"11380","3","20120802053424","Shop","AAA03","5","85000","15000","70000","2012-08-02 17:34:24"
"11381","16","20120802030721","Mobile","AAA04","2","16000","800","15200","2012-08-02 15:07:21"
"11382","12","20120802020833","PC","AAA02","2","30000","4600","25400","2012-08-02 14:08:33"
"11383","56","20120802010659","Mobile","AAA01","3","30000","6000","24000","2012-08-02 13:06:59"
"11384","7","20120802113824","Mobile","AAA01","4","40000","8000","32000","2012-08-02 11:38:24"
"11385","91","20120802102253","PC","AAA04","1","8000","400","7600","2012-08-02 10:22:53"
"11386","44","20120802075754","PC","AAA01","2","20000","4000","16000","2012-08-02 07:57:54"
"11387","95","20120801111902","PC","AAA03","1","17000","3000","14000","2012-08-01 11:19:02"
"11388","92","20120801094835","Shop","AAA04","4","32000","1600","30400","2012-08-01 09:48:35"
"11389","12","20120801064237","Mobile","AAA02","2","30000","4600","25400","2012-08-01 06:42:37"
"11390","7","20120731081115","Shop","AAA01","5","50000","10000","40000","2012-07-31 20:11:15"
"11391","18","20120731123113","Mobile","AAA04","3","24000","1200","22800","2012-07-31 12:31:13"
"11392","46","20120731102845","PC","AAA05","1","60000","20000","40000","2012-07-31 10:28:45"
"11393","50","20120730020215","Mobile","AAA04","1","8000","400","7600","2012-07-30 14:02:15"
"11394","22","20120730104439","PC","AAA04","3","24000","1200","22800","2012-07-30 10:44:39"
"11395","96","20120730092121","PC","AAA04","7","56000","2800","53200","2012-07-30 09:21:21"
"11396","5","20120727095226","PC","AAA04","7","56000","2800","53200","2012-07-27 21:52:26"
"11397","44","20120727042944","Shop","AAA04","3","24000","1200","22800","2012-07-27 16:29:44"
"11398","50","20120727030414","Mobile","AAA01","5","50000","10000","40000","2012-07-27 15:04:14"
"11399","92","20120727020107","PC","AAA03","3","51000","9000","42000","2012-07-27 14:01:07"
"11400","82","20120727114402","Mobile","AAA04","1","8000","400","7600","2012-07-27 11:44:02"
"11401","27","20120727105423","PC","AAA01","3","30000","6000","24000","2012-07-27 10:54:23"
"11402","91","20120727095612","Shop","AAA01","1","10000","2000","8000","2012-07-27 09:56:12"
"11403","85","20120727084241","PC","AAA02","2","30000","4600","25400","2012-07-27 08:42:41"
"11404","84","20120726043406","Mobile","AAA02","2","30000","4600","25400","2012-07-26 16:34:06"
"11405","62","20120726033728","PC","AAA03","5","85000","15000","70000","2012-07-26 15:37:28"
"11406","14","20120726011446","Shop","AAA03","1","17000","3000","14000","2012-07-26 13:14:46"
"11407","18","20120726104151","Mobile","AAA01","4","40000","8000","32000","2012-07-26 10:41:51"
"11408","50","20120726091531","PC","AAA04","6","48000","2400","45600","2012-07-26 09:15:31"
"11409","67","20120726064118","Shop","AAA01","3","30000","6000","24000","2012-07-26 06:41:18"
"11410","28","20120725065106","PC","AAA04","4","32000","1600","30400","2012-07-25 18:51:06"
"11411","72","20120725034518","Mobile","AAA01","1","10000","2000","8000","2012-07-25 15:45:18"
"11412","22","20120725014810","Shop","AAA02","1","15000","2300","12700","2012-07-25 13:48:10"
"11413","16","20120725120901","PC","AAA02","1","15000","2300","12700","2012-07-25 12:09:01"
"11414","87","20120725110602","PC","AAA03","1","17000","3000","14000","2012-07-25 11:06:02"
"11415","12","20120725093258","Mobile","AAA03","1","17000","3000","14000","2012-07-25 09:32:58"
"11416","5","20120724043553","PC","AAA05","5","300000","100000","200000","2012-07-24 16:35:53"
"11417","95","20120724010726","PC","AAA02","1","15000","2300","12700","2012-07-24 13:07:26"
"11418","96","20120724103417","Mobile","AAA02","2","30000","4600","25400","2012-07-24 10:34:17"
"11419","3","20120724071302","PC","AAA03","9","153000","27000","126000","2012-07-24 07:13:02"
"11420","3","20120723061423","Shop","AAA04","1","8000","400","7600","2012-07-23 06:14:23"
"11421","70","20120720102754","Mobile","AAA03","5","85000","15000","70000","2012-07-20 10:27:54"
"11422","85","20120720090628","Shop","AAA05","2","120000","40000","80000","2012-07-20 09:06:28"
"11423","91","20120720075637","Mobile","AAA05","5","300000","100000","200000","2012-07-20 07:56:37"
"11424","62","20120719055117","Shop","AAA01","4","40000","8000","32000","2012-07-19 17:51:17"
"11425","23","20120719052055","Mobile","AAA03","5","85000","15000","70000","2012-07-19 17:20:55"
"11426","99","20120719034342","PC","AAA04","2","16000","800","15200","2012-07-19 15:43:42"
"11427","39","20120719023227","Mobile","AAA02","2","30000","4600","25400","2012-07-19 14:32:27"
"11428","34","20120719123258","PC","AAA04","4","32000","1600","30400","2012-07-19 12:32:58"
"11429","47","20120719111955","Shop","AAA03","3","51000","9000","42000","2012-07-19 11:19:55"
"11430","64","20120719100010","PC","AAA05","5","300000","100000","200000","2012-07-19 10:00:10"
"11431","6","20120719090456","PC","AAA04","1","8000","400","7600","2012-07-19 09:04:56"
"11432","19","20120718053022","Mobile","AAA02","1","15000","2300","12700","2012-07-18 17:30:22"
"11433","16","20120718034622","Shop","AAA02","3","45000","6900","38100","2012-07-18 15:46:22"
"11434","73","20120718015946","Shop","AAA01","3","30000","6000","24000","2012-07-18 13:59:46"
"11435","55","20120718121120","Shop","AAA01","1","10000","2000","8000","2012-07-18 12:11:20"
"11436","32","20120718103449","Shop","AAA04","2","16000","800","15200","2012-07-18 10:34:49"
"11437","50","20120718084600","PC","AAA05","7","420000","140000","280000","2012-07-18 08:46:00"
"11438","54","20120717032519","Shop","AAA02","5","75000","11500","63500","2012-07-17 15:25:19"
"11439","61","20120717011613","Mobile","AAA01","3","30000","6000","24000","2012-07-17 13:16:13"
"11440","15","20120717104741","Shop","AAA01","2","20000","4000","16000","2012-07-17 10:47:41"
"11441","55","20120717094852","Mobile","AAA01","4","40000","8000","32000","2012-07-17 09:48:52"
"11442","66","20120716023343","Mobile","AAA01","4","40000","8000","32000","2012-07-16 14:33:43"
"11443","76","20120716111338","Mobile","AAA05","3","180000","60000","120000","2012-07-16 11:13:38"
"11444","45","20120716102714","Mobile","AAA04","3","24000","1200","22800","2012-07-16 10:27:14"
"11445","42","20120716083338","Mobile","AAA01","2","20000","4000","16000","2012-07-16 08:33:38"
"11446","20","20120714124059","PC","AAA03","1","17000","3000","14000","2012-07-14 00:40:59"
"11447","45","20120712030406","Mobile","AAA02","4","60000","9200","50800","2012-07-12 15:04:06"
"11448","18","20120712013357","PC","AAA05","2","120000","40000","80000","2012-07-12 13:33:57"
"11449","83","20120712123613","Shop","AAA04","7","56000","2800","53200","2012-07-12 12:36:13"
"11450","16","20120712113215","PC","AAA03","4","68000","12000","56000","2012-07-12 11:32:15"
"11451","57","20120712093628","PC","AAA03","1","17000","3000","14000","2012-07-12 09:36:28"
"11452","43","20120712075330","PC","AAA02","4","60000","9200","50800","2012-07-12 07:53:30"
"11453","36","20120711055544","PC","AAA03","3","51000","9000","42000","2012-07-11 17:55:44"
"11454","67","20120711034438","PC","AAA05","6","360000","120000","240000","2012-07-11 15:44:38"
"11455","4","20120711014141","Shop","AAA05","2","120000","40000","80000","2012-07-11 13:41:41"
"11456","5","20120711122846","Shop","AAA03","3","51000","9000","42000","2012-07-11 12:28:46"
"11457","28","20120711120927","PC","AAA04","1","8000","400","7600","2012-07-11 12:09:27"
"11458","39","20120711110450","PC","AAA01","2","20000","4000","16000","2012-07-11 11:04:50"
"11459","67","20120711094344","Shop","AAA01","5","50000","10000","40000","2012-07-11 09:43:44"
"11460","72","20120711091636","PC","AAA02","2","30000","4600","25400","2012-07-11 09:16:36"
"11461","98","20120711074807","PC","AAA05","1","60000","20000","40000","2012-07-11 07:48:07"
"11462","11","20120710070855","Shop","AAA04","1","8000","400","7600","2012-07-10 19:08:55"
"11463","56","20120710123300","PC","AAA05","1","60000","20000","40000","2012-07-10 12:33:00"
"11464","31","20120710112142","Mobile","AAA03","4","68000","12000","56000","2012-07-10 11:21:42"
"11465","6","20120710100020","Mobile","AAA03","4","68000","12000","56000","2012-07-10 10:00:20"
"11466","7","20120710063131","Mobile","AAA04","3","24000","1200","22800","2012-07-10 06:31:31"
"11467","75","20120709125430","PC","AAA01","1","10000","2000","8000","2012-07-09 12:54:30"
"11468","49","20120709123209","PC","AAA01","5","50000","10000","40000","2012-07-09 12:32:09"
"11469","29","20120709102128","PC","AAA03","4","68000","12000","56000","2012-07-09 10:21:28"
"11470","74","20120709090554","Mobile","AAA04","3","24000","1200","22800","2012-07-09 09:05:54"
"11471","82","20120705072354","PC","AAA05","1","60000","20000","40000","2012-07-05 07:23:54"
"11472","86","20120704035842","Shop","AAA03","1","17000","3000","14000","2012-07-04 15:58:42"
"11473","35","20120704021417","Shop","AAA03","2","34000","6000","28000","2012-07-04 14:14:17"
"11474","19","20120703081827","PC","AAA03","3","51000","9000","42000","2012-07-03 08:18:27"
"11475","36","20120703051605","PC","AAA02","6","90000","13800","76200","2012-07-03 05:16:05"
"11476","56","20120702090521","Shop","AAA03","5","85000","15000","70000","2012-07-02 21:05:21"
"11477","36","20120702020602","Shop","AAA02","4","60000","9200","50800","2012-07-02 14:06:02"
"11478","85","20120702123101","Shop","AAA04","2","16000","800","15200","2012-07-02 12:31:01"
"11479","99","20120702091838","Shop","AAA02","1","15000","2300","12700","2012-07-02 09:18:38"
"11480","55","20120628023652","Shop","AAA03","4","68000","12000","56000","2012-06-28 02:36:52"
"11481","87","20120627101957","Mobile","AAA02","2","30000","4600","25400","2012-06-27 10:19:57"
"11482","81","20120627082032","PC","AAA05","2","120000","40000","80000","2012-06-27 08:20:32"
"11483","62","20120627063001","Shop","AAA04","4","32000","1600","30400","2012-06-27 06:30:01"
"11484","10","20120626091849","PC","AAA01","4","40000","8000","32000","2012-06-26 09:18:49"
"11485","43","20120625014650","PC","AAA02","4","60000","9200","50800","2012-06-25 13:46:50"
"11486","87","20120625113912","Mobile","AAA01","1","10000","2000","8000","2012-06-25 11:39:12"
"11487","7","20120625103438","Mobile","AAA04","2","16000","800","15200","2012-06-25 10:34:38"
"11488","97","20120625092028","Mobile","AAA01","5","50000","10000","40000","2012-06-25 09:20:28"
"11489","48","20120620110354","Mobile","AAA05","5","300000","100000","200000","2012-06-20 11:03:54"
"11490","67","20120620075006","PC","AAA01","5","50000","10000","40000","2012-06-20 07:50:06"
"11491","82","20120619063316","Shop","AAA05","3","180000","60000","120000","2012-06-19 18:33:16"
"11492","98","20120619015329","Mobile","AAA01","2","20000","4000","16000","2012-06-19 13:53:29"
"11493","5","20120619101757","PC","AAA01","3","30000","6000","24000","2012-06-19 10:17:57"
"11494","97","20120619090137","Shop","AAA02","1","15000","2300","12700","2012-06-19 09:01:37"
"11495","88","20120619062236","PC","AAA01","1","10000","2000","8000","2012-06-19 06:22:36"
"11496","72","20120618031259","PC","AAA02","4","60000","9200","50800","2012-06-18 15:12:59"
"11497","20","20120618022028","Mobile","AAA05","1","60000","20000","40000","2012-06-18 14:20:28"
"11498","83","20120618121050","Shop","AAA03","5","85000","15000","70000","2012-06-18 12:10:50"
"11499","12","20120618102641","Shop","AAA02","1","15000","2300","12700","2012-06-18 10:26:41"
"11500","46","20120618092600","Mobile","AAA03","5","85000","15000","70000","2012-06-18 09:26:00"
"11501","51","20120613100144","Shop","AAA03","3","51000","9000","42000","2012-06-13 10:01:44"
"11502","51","20120613070748","PC","AAA01","4","40000","8000","32000","2012-06-13 07:07:48"
"11503","7","20120612022912","Shop","AAA04","4","32000","1600","30400","2012-06-12 14:29:12"
"11504","39","20120612090229","Mobile","AAA05","1","60000","20000","40000","2012-06-12 09:02:29"
"11505","66","20120612073826","Shop","AAA02","3","45000","6900","38100","2012-06-12 07:38:26"
"11506","28","20120611103033","Mobile","AAA01","8","80000","16000","64000","2012-06-11 10:30:33"
"11507","13","20120611095119","PC","AAA03","1","17000","3000","14000","2012-06-11 09:51:19"
"11508","84","20120609045245","PC","AAA03","2","34000","6000","28000","2012-06-09 04:52:45"
"11509","52","20120608034559","PC","AAA02","2","30000","4600","25400","2012-06-08 15:45:59"
"11510","94","20120608020359","Shop","AAA01","5","50000","10000","40000","2012-06-08 14:03:59"
"11511","97","20120608125743","Mobile","AAA04","2","16000","800","15200","2012-06-08 12:57:43"
"11512","45","20120608113024","PC","AAA03","1","17000","3000","14000","2012-06-08 11:30:24"
"11513","59","20120608093714","PC","AAA03","4","68000","12000","56000","2012-06-08 09:37:14"
"11514","82","20120608074439","Shop","AAA04","2","16000","800","15200","2012-06-08 07:44:39"
"11515","87","20120607021717","Shop","AAA02","1","15000","2300","12700","2012-06-07 14:17:17"
"11516","89","20120607094232","Shop","AAA05","6","360000","120000","240000","2012-06-07 09:42:32"
"11517","78","20120607083116","Shop","AAA04","1","8000","400","7600","2012-06-07 08:31:16"
"11518","12","20120607074304","PC","AAA01","1","10000","2000","8000","2012-06-07 07:43:04"
"11519","48","20120606082940","Mobile","AAA02","4","60000","9200","50800","2012-06-06 20:29:40"
"11520","41","20120606033928","PC","AAA01","3","30000","6000","24000","2012-06-06 15:39:28"
"11521","13","20120606121738","PC","AAA01","1","10000","2000","8000","2012-06-06 12:17:38"
"11522","49","20120606092417","PC","AAA04","7","56000","2800","53200","2012-06-06 09:24:17"
"11523","17","20120606070501","Mobile","AAA01","1","10000","2000","8000","2012-06-06 07:05:01"
"11524","4","20120605023917","Mobile","AAA01","1","10000","2000","8000","2012-06-05 14:39:17"
"11525","46","20120605011447","Shop","AAA05","4","240000","80000","160000","2012-06-05 13:14:47"
"11526","92","20120605110012","Shop","AAA01","5","50000","10000","40000","2012-06-05 11:00:12"
"11527","90","20120605095811","Mobile","AAA01","1","10000","2000","8000","2012-06-05 09:58:11"
"11528","3","20120605085450","Shop","AAA05","6","360000","120000","240000","2012-06-05 08:54:50"
"11529","97","20120605081759","PC","AAA04","2","16000","800","15200","2012-06-05 08:17:59"
"11530","68","20120605070659","PC","AAA01","1","10000","2000","8000","2012-06-05 07:06:59"
"11531","81","20120604100233","Mobile","AAA05","2","120000","40000","80000","2012-06-04 10:02:33"
"11532","36","20120604074511","PC","AAA04","2","16000","800","15200","2012-06-04 07:45:11"
"11533","80","20120531023210","Mobile","AAA03","1","17000","3000","14000","2012-05-31 14:32:10"
"11534","31","20120531010238","Mobile","AAA04","3","24000","1200","22800","2012-05-31 13:02:38"
"11535","82","20120531103317","PC","AAA05","1","60000","20000","40000","2012-05-31 10:33:17"
"11536","89","20120531081934","Mobile","AAA03","8","136000","24000","112000","2012-05-31 08:19:34"
"11537","81","20120531060053","Mobile","AAA05","2","120000","40000","80000","2012-05-31 06:00:53"
"11538","85","20120530010829","Shop","AAA04","1","8000","400","7600","2012-05-30 13:08:29"
"11539","11","20120530110359","Mobile","AAA04","4","32000","1600","30400","2012-05-30 11:03:59"
"11540","88","20120530100319","Mobile","AAA03","2","34000","6000","28000","2012-05-30 10:03:19"
"11541","62","20120530090257","Shop","AAA02","6","90000","13800","76200","2012-05-30 09:02:57"
"11542","65","20120530072707","Shop","AAA05","2","120000","40000","80000","2012-05-30 07:27:07"
"11543","18","20120530031101","Mobile","AAA03","2","34000","6000","28000","2012-05-30 03:11:01"
"11544","27","20120529120628","Shop","AAA05","11","660000","220000","440000","2012-05-29 12:06:28"
"11545","96","20120529093349","Mobile","AAA03","3","51000","9000","42000","2012-05-29 09:33:49"
"11546","97","20120529074726","Shop","AAA04","5","40000","2000","38000","2012-05-29 07:47:26"
"11547","16","20120528022731","PC","AAA02","6","90000","13800","76200","2012-05-28 14:27:31"
"11548","8","20120528095353","Mobile","AAA02","2","30000","4600","25400","2012-05-28 09:53:53"
"11549","27","20120525095139","Mobile","AAA05","5","300000","100000","200000","2012-05-25 09:51:39"
"11550","16","20120525091905","PC","AAA01","6","60000","12000","48000","2012-05-25 09:19:05"
"11551","48","20120524100437","Shop","AAA04","1","8000","400","7600","2012-05-24 22:04:37"
"11552","70","20120524064942","PC","AAA02","9","135000","20700","114300","2012-05-24 18:49:42"
"11553","33","20120524125013","Shop","AAA04","1","8000","400","7600","2012-05-24 12:50:13"
"11554","99","20120524114500","PC","AAA03","1","17000","3000","14000","2012-05-24 11:45:00"
"11555","62","20120524092003","PC","AAA05","3","180000","60000","120000","2012-05-24 09:20:03"
"11556","71","20120524082708","Shop","AAA04","1","8000","400","7600","2012-05-24 08:27:08"
"11557","15","20120524074930","PC","AAA04","5","40000","2000","38000","2012-05-24 07:49:30"
"11558","67","20120523024859","PC","AAA01","5","50000","10000","40000","2012-05-23 14:48:59"
"11559","73","20120523125156","Shop","AAA03","5","85000","15000","70000","2012-05-23 12:51:56"
"11560","66","20120523110205","PC","AAA03","4","68000","12000","56000","2012-05-23 11:02:05"
"11561","78","20120523090552","Mobile","AAA03","4","68000","12000","56000","2012-05-23 09:05:52"
"11562","18","20120523071841","PC","AAA01","1","10000","2000","8000","2012-05-23 07:18:41"
"11563","59","20120522113335","Shop","AAA03","3","51000","9000","42000","2012-05-22 11:33:35"
"11564","35","20120522084411","Shop","AAA05","1","60000","20000","40000","2012-05-22 08:44:11"
"11565","32","20120522071625","Mobile","AAA01","3","30000","6000","24000","2012-05-22 07:16:25"
"11566","31","20120521100158","Shop","AAA03","5","85000","15000","70000","2012-05-21 10:01:58"
"11567","99","20120521080608","Mobile","AAA01","1","10000","2000","8000","2012-05-21 08:06:08"
"11568","47","20120515025302","Mobile","AAA05","2","120000","40000","80000","2012-05-15 14:53:02"
"11569","99","20120515021912","PC","AAA02","1","15000","2300","12700","2012-05-15 14:19:12"
"11570","17","20120515102400","PC","AAA02","1","15000","2300","12700","2012-05-15 10:24:00"
"11571","61","20120515080351","PC","AAA01","3","30000","6000","24000","2012-05-15 08:03:51"
"11572","46","20120515055249","PC","AAA03","1","17000","3000","14000","2012-05-15 05:52:49"
"11573","40","20120514055731","Shop","AAA05","1","60000","20000","40000","2012-05-14 17:57:31"
"11574","96","20120514042912","Mobile","AAA01","3","30000","6000","24000","2012-05-14 16:29:12"
"11575","43","20120514024418","PC","AAA05","1","60000","20000","40000","2012-05-14 14:44:18"
"11576","50","20120514011201","PC","AAA04","5","40000","2000","38000","2012-05-14 13:12:01"
"11577","89","20120514114323","Mobile","AAA03","7","119000","21000","98000","2012-05-14 11:43:23"
"11578","49","20120514101955","Shop","AAA01","7","70000","14000","56000","2012-05-14 10:19:55"
"11579","63","20120514081636","Mobile","AAA05","2","120000","40000","80000","2012-05-14 08:16:36"
"11580","73","20120511053021","Shop","AAA01","1","10000","2000","8000","2012-05-11 05:30:21"
"11581","1","20120511124224","Mobile","AAA05","7","420000","140000","280000","2012-05-11 00:42:24"
"11582","38","20120510105841","Shop","AAA03","5","85000","15000","70000","2012-05-10 10:58:41"
"11583","4","20120510090102","Shop","AAA01","1","10000","2000","8000","2012-05-10 09:01:02"
"11584","46","20120508061114","Mobile","AAA03","4","68000","12000","56000","2012-05-08 06:11:14"
"11585","28","20120507042731","PC","AAA03","2","34000","6000","28000","2012-05-07 16:27:31"
"11586","77","20120507021820","Mobile","AAA01","2","20000","4000","16000","2012-05-07 14:18:20"
"11587","20","20120507124836","Mobile","AAA04","4","32000","1600","30400","2012-05-07 12:48:36"
"11588","71","20120507105058","PC","AAA04","1","8000","400","7600","2012-05-07 10:50:58"
"11589","33","20120507085855","Mobile","AAA05","1","60000","20000","40000","2012-05-07 08:58:55"
"11590","79","20120502105221","Shop","AAA04","2","16000","800","15200","2012-05-02 10:52:21"
"11591","12","20120502091350","Shop","AAA01","1","10000","2000","8000","2012-05-02 09:13:50"
"11592","25","20120502064733","Shop","AAA04","1","8000","400","7600","2012-05-02 06:47:33"
"11593","15","20120501035327","PC","AAA05","7","420000","140000","280000","2012-05-01 15:53:27"
"11594","60","20120501012713","Shop","AAA04","4","32000","1600","30400","2012-05-01 13:27:13"
"11595","39","20120501114003","Mobile","AAA03","2","34000","6000","28000","2012-05-01 11:40:03"
"11596","8","20120501100901","Mobile","AAA01","4","40000","8000","32000","2012-05-01 10:09:01"
"11597","25","20120501081153","PC","AAA05","3","180000","60000","120000","2012-05-01 08:11:53"
"11598","36","20120501070426","Shop","AAA02","9","135000","20700","114300","2012-05-01 07:04:26"
"11599","26","20120430114629","Shop","AAA02","5","75000","11500","63500","2012-04-30 11:46:29"
"11600","88","20120430094736","Mobile","AAA02","3","45000","6900","38100","2012-04-30 09:47:36"
"11601","65","20120427083107","Shop","AAA05","2","120000","40000","80000","2012-04-27 08:31:07"
"11602","60","20120427070446","PC","AAA03","1","17000","3000","14000","2012-04-27 07:04:46"
"11603","69","20120426012417","PC","AAA02","2","30000","4600","25400","2012-04-26 13:24:17"
"11604","94","20120426113739","Shop","AAA04","5","40000","2000","38000","2012-04-26 11:37:39"
"11605","41","20120426082950","PC","AAA04","6","48000","2400","45600","2012-04-26 08:29:50"
"11606","34","20120426061356","Shop","AAA04","1","8000","400","7600","2012-04-26 06:13:56"
"11607","76","20120425122909","PC","AAA01","3","30000","6000","24000","2012-04-25 12:29:09"
"11608","33","20120425105704","PC","AAA05","1","60000","20000","40000","2012-04-25 10:57:04"
"11609","93","20120425084453","PC","AAA01","2","20000","4000","16000","2012-04-25 08:44:53"
"11610","98","20120425071223","Shop","AAA05","1","60000","20000","40000","2012-04-25 07:12:23"
"11611","2","20120424091911","Mobile","AAA04","2","16000","800","15200","2012-04-24 21:19:11"
"11612","100","20120424063652","Mobile","AAA01","2","20000","4000","16000","2012-04-24 18:36:52"
"11613","45","20120424023804","Mobile","AAA05","1","60000","20000","40000","2012-04-24 14:38:04"
"11614","78","20120424125359","Shop","AAA04","5","40000","2000","38000","2012-04-24 12:53:59"
"11615","3","20120424102947","Shop","AAA05","14","840000","280000","560000","2012-04-24 10:29:47"
"11616","24","20120424080045","PC","AAA04","1","8000","400","7600","2012-04-24 08:00:45"
"11617","54","20120424063141","Shop","AAA04","2","16000","800","15200","2012-04-24 06:31:41"
"11618","97","20120423032511","Mobile","AAA03","3","51000","9000","42000","2012-04-23 15:25:11"
"11619","5","20120423021712","PC","AAA02","6","90000","13800","76200","2012-04-23 14:17:12"
"11620","27","20120423124917","Shop","AAA01","2","20000","4000","16000","2012-04-23 12:49:17"
"11621","78","20120423111628","Mobile","AAA01","4","40000","8000","32000","2012-04-23 11:16:28"
"11622","18","20120423101135","Shop","AAA01","2","20000","4000","16000","2012-04-23 10:11:35"
"11623","35","20120423082521","Mobile","AAA02","1","15000","2300","12700","2012-04-23 08:25:21"
"11624","11","20120417093654","Shop","AAA01","5","50000","10000","40000","2012-04-17 21:36:54"
"11625","5","20120417021208","Shop","AAA02","6","90000","13800","76200","2012-04-17 14:12:08"
"11626","50","20120417121627","PC","AAA02","4","60000","9200","50800","2012-04-17 12:16:27"
"11627","76","20120417111810","PC","AAA02","1","15000","2300","12700","2012-04-17 11:18:10"
"11628","54","20120417102154","PC","AAA05","3","180000","60000","120000","2012-04-17 10:21:54"
"11629","2","20120417091038","PC","AAA03","1","17000","3000","14000","2012-04-17 09:10:38"
"11630","27","20120417082427","Shop","AAA01","5","50000","10000","40000","2012-04-17 08:24:27"
"11631","62","20120417063906","Mobile","AAA01","5","50000","10000","40000","2012-04-17 06:39:06"
"11632","27","20120416010047","Mobile","AAA05","6","360000","120000","240000","2012-04-16 13:00:47"
"11633","37","20120416110600","Shop","AAA04","5","40000","2000","38000","2012-04-16 11:06:00"
"11634","87","20120416092421","Mobile","AAA03","6","102000","18000","84000","2012-04-16 09:24:21"
"11635","28","20120412103500","Mobile","AAA01","1","10000","2000","8000","2012-04-12 10:35:00"
"11636","36","20120412081528","Shop","AAA03","6","102000","18000","84000","2012-04-12 08:15:28"
"11637","31","20120412072348","Mobile","AAA02","3","45000","6900","38100","2012-04-12 07:23:48"
"11638","55","20120411063628","Mobile","AAA01","5","50000","10000","40000","2012-04-11 18:36:28"
"11639","52","20120411011835","Mobile","AAA05","5","300000","100000","200000","2012-04-11 13:18:35"
"11640","56","20120411080009","PC","AAA03","5","85000","15000","70000","2012-04-11 08:00:09"
"11641","32","20120411070859","Shop","AAA02","5","75000","11500","63500","2012-04-11 07:08:59"
"11642","54","20120410080936","Mobile","AAA02","3","45000","6900","38100","2012-04-10 20:09:36"
"11643","65","20120410111119","Mobile","AAA03","1","17000","3000","14000","2012-04-10 11:11:19"
"11644","13","20120410085614","Mobile","AAA05","1","60000","20000","40000","2012-04-10 08:56:14"
"11645","34","20120410064558","Shop","AAA05","3","180000","60000","120000","2012-04-10 06:45:58"
"11646","15","20120409030942","Shop","AAA03","3","51000","9000","42000","2012-04-09 15:09:42"
"11647","78","20120409124009","Mobile","AAA03","1","17000","3000","14000","2012-04-09 12:40:09"
"11648","12","20120409110659","Mobile","AAA03","1","17000","3000","14000","2012-04-09 11:06:59"
"11649","68","20120409090812","Mobile","AAA01","2","20000","4000","16000","2012-04-09 09:08:12"
"11650","44","20120405081548","Shop","AAA02","3","45000","6900","38100","2012-04-05 08:15:48"
"11651","6","20120405063738","PC","AAA02","3","45000","6900","38100","2012-04-05 06:37:38"
"11652","94","20120404022855","Shop","AAA04","3","24000","1200","22800","2012-04-04 14:28:55"
"11653","47","20120404083729","PC","AAA04","2","16000","800","15200","2012-04-04 08:37:29"
"11654","6","20120404065456","PC","AAA05","1","60000","20000","40000","2012-04-04 06:54:56"
"11655","99","20120403031257","PC","AAA01","1","10000","2000","8000","2012-04-03 15:12:57"
"11656","75","20120403013803","Shop","AAA04","1","8000","400","7600","2012-04-03 13:38:03"
"11657","41","20120403115157","Shop","AAA02","6","90000","13800","76200","2012-04-03 11:51:57"
"11658","6","20120403104707","Shop","AAA04","2","16000","800","15200","2012-04-03 10:47:07"
"11659","6","20120403095109","PC","AAA03","1","17000","3000","14000","2012-04-03 09:51:09"
"11660","21","20120403082626","Mobile","AAA05","6","360000","120000","240000","2012-04-03 08:26:26"
"11661","80","20120402125526","Mobile","AAA04","4","32000","1600","30400","2012-04-02 00:55:26"
"11662","86","20120328084400","PC","AAA02","3","45000","6900","38100","2012-03-28 08:44:00"
"11663","89","20120328071540","Mobile","AAA04","1","8000","400","7600","2012-03-28 07:15:40"
"11664","28","20120327110340","Mobile","AAA05","5","300000","100000","200000","2012-03-27 11:03:40"
"11665","47","20120327091425","Shop","AAA01","2","20000","4000","16000","2012-03-27 09:14:25"
"11666","81","20120326105443","Mobile","AAA02","3","45000","6900","38100","2012-03-26 10:54:43"
"11667","81","20120326101518","Mobile","AAA03","3","51000","9000","42000","2012-03-26 10:15:18"
"11668","40","20120326084910","PC","AAA04","4","32000","1600","30400","2012-03-26 08:49:10"
"11669","61","20120326121629","Mobile","AAA05","2","120000","40000","80000","2012-03-26 00:16:29"
"11670","78","20120318032027","Mobile","AAA02","2","30000","4600","25400","2012-03-18 15:20:27"
"11671","70","20120315034452","PC","AAA02","3","45000","6900","38100","2012-03-15 15:44:52"
"11672","75","20120315104618","PC","AAA05","1","60000","20000","40000","2012-03-15 10:46:18"
"11673","65","20120315093255","PC","AAA04","2","16000","800","15200","2012-03-15 09:32:55"
"11674","16","20120314015024","PC","AAA04","8","64000","3200","60800","2012-03-14 13:50:24"
"11675","93","20120314121824","PC","AAA03","2","34000","6000","28000","2012-03-14 12:18:24"
"11676","28","20120314101811","Mobile","AAA04","3","24000","1200","22800","2012-03-14 10:18:11"
"11677","5","20120314071323","Shop","AAA04","4","32000","1600","30400","2012-03-14 07:13:23"
"11678","84","20120313030816","Shop","AAA04","2","16000","800","15200","2012-03-13 15:08:16"
"11679","48","20120313011943","Mobile","AAA04","4","32000","1600","30400","2012-03-13 13:19:43"
"11680","41","20120313112902","Mobile","AAA03","2","34000","6000","28000","2012-03-13 11:29:02"
"11681","24","20120313095241","Mobile","AAA05","2","120000","40000","80000","2012-03-13 09:52:41"
"11682","98","20120313073532","Mobile","AAA01","2","20000","4000","16000","2012-03-13 07:35:32"
"11683","92","20120312022326","Shop","AAA02","3","45000","6900","38100","2012-03-12 14:23:26"
"11684","57","20120312125851","PC","AAA01","3","30000","6000","24000","2012-03-12 12:58:51"
"11685","28","20120312114752","PC","AAA01","5","50000","10000","40000","2012-03-12 11:47:52"
"11686","35","20120312083952","PC","AAA04","1","8000","400","7600","2012-03-12 08:39:52"
"11687","98","20120307102105","Mobile","AAA03","3","51000","9000","42000","2012-03-07 22:21:05"
"11688","73","20120307054209","Mobile","AAA03","8","136000","24000","112000","2012-03-07 17:42:09"
"11689","68","20120307035913","Mobile","AAA04","2","16000","800","15200","2012-03-07 15:59:13"
"11690","89","20120307024007","Shop","AAA01","6","60000","12000","48000","2012-03-07 14:40:07"
"11691","28","20120307120757","Mobile","AAA03","1","17000","3000","14000","2012-03-07 12:07:57"
"11692","46","20120307104438","PC","AAA05","3","180000","60000","120000","2012-03-07 10:44:38"
"11693","12","20120306104341","PC","AAA01","2","20000","4000","16000","2012-03-06 10:43:41"
"11694","60","20120306092859","Mobile","AAA05","2","120000","40000","80000","2012-03-06 09:28:59"
"11695","50","20120306073659","PC","AAA01","1","10000","2000","8000","2012-03-06 07:36:59"
"11696","58","20120305114726","PC","AAA02","1","15000","2300","12700","2012-03-05 11:47:26"
"11697","7","20120305103206","Shop","AAA01","5","50000","10000","40000","2012-03-05 10:32:06"
"11698","1","20120305083427","PC","AAA03","3","51000","9000","42000","2012-03-05 08:34:27"
"11699","50","20120302092212","PC","AAA01","5","50000","10000","40000","2012-03-02 09:22:12"
"11700","2","20120302023225","PC","AAA01","1","10000","2000","8000","2012-03-02 02:32:25"
"11701","7","20120301041133","Mobile","AAA03","1","17000","3000","14000","2012-03-01 04:11:33"
"11702","38","20120229050508","Shop","AAA04","4","32000","1600","30400","2012-02-29 05:05:08"
"11703","52","20120228052359","Shop","AAA02","2","30000","4600","25400","2012-02-28 17:23:59"
"11704","16","20120228022928","PC","AAA03","3","51000","9000","42000","2012-02-28 14:29:28"
"11705","90","20120228124517","Shop","AAA03","2","34000","6000","28000","2012-02-28 12:45:17"
"11706","90","20120228112322","PC","AAA05","1","60000","20000","40000","2012-02-28 11:23:22"
"11707","35","20120228101848","Shop","AAA01","1","10000","2000","8000","2012-02-28 10:18:48"
"11708","67","20120228074046","PC","AAA04","1","8000","400","7600","2012-02-28 07:40:46"
"11709","73","20120227022606","Shop","AAA04","3","24000","1200","22800","2012-02-27 14:26:06"
"11710","46","20120227123752","Mobile","AAA04","1","8000","400","7600","2012-02-27 12:37:52"
"11711","39","20120227112503","Mobile","AAA04","5","40000","2000","38000","2012-02-27 11:25:03"
"11712","10","20120222061745","PC","AAA03","4","68000","12000","56000","2012-02-22 06:17:45"
"11713","59","20120221124328","PC","AAA01","2","20000","4000","16000","2012-02-21 12:43:28"
"11714","98","20120221095648","PC","AAA03","3","51000","9000","42000","2012-02-21 09:56:48"
"11715","9","20120221081558","Mobile","AAA05","1","60000","20000","40000","2012-02-21 08:15:58"
"11716","8","20120221063404","PC","AAA05","1","60000","20000","40000","2012-02-21 06:34:04"
"11717","96","20120220050745","Shop","AAA01","6","60000","12000","48000","2012-02-20 05:07:45"
"11718","46","20120215022150","PC","AAA03","1","17000","3000","14000","2012-02-15 14:21:50"
"11719","41","20120215010637","Mobile","AAA02","2","30000","4600","25400","2012-02-15 13:06:37"
"11720","19","20120215115326","Mobile","AAA01","1","10000","2000","8000","2012-02-15 11:53:26"
"11721","46","20120215075023","PC","AAA01","2","20000","4000","16000","2012-02-15 07:50:23"
"11722","9","20120214113030","Shop","AAA05","1","60000","20000","40000","2012-02-14 11:30:30"
"11723","62","20120214095437","Mobile","AAA04","5","40000","2000","38000","2012-02-14 09:54:37"
"11724","54","20120214084220","PC","AAA04","1","8000","400","7600","2012-02-14 08:42:20"
"11725","32","20120214070258","Shop","AAA01","4","40000","8000","32000","2012-02-14 07:02:58"
"11726","38","20120213115325","PC","AAA04","2","16000","800","15200","2012-02-13 11:53:25"
"11727","94","20120213101642","PC","AAA02","4","60000","9200","50800","2012-02-13 10:16:42"
"11728","54","20120209071916","Shop","AAA03","7","119000","21000","98000","2012-02-09 19:19:16"
"11729","33","20120209025502","PC","AAA02","2","30000","4600","25400","2012-02-09 14:55:02"
"11730","48","20120209013915","Shop","AAA02","2","30000","4600","25400","2012-02-09 13:39:15"
"11731","16","20120209115405","Mobile","AAA03","5","85000","15000","70000","2012-02-09 11:54:05"
"11732","66","20120209093032","Mobile","AAA02","6","90000","13800","76200","2012-02-09 09:30:32"
"11733","84","20120208122632","Shop","AAA04","1","8000","400","7600","2012-02-08 12:26:32"
"11734","76","20120208112001","Mobile","AAA03","2","34000","6000","28000","2012-02-08 11:20:01"
"11735","11","20120208094815","PC","AAA03","5","85000","15000","70000","2012-02-08 09:48:15"
"11736","51","20120208090741","Shop","AAA02","5","75000","11500","63500","2012-02-08 09:07:41"
"11737","23","20120208063048","PC","AAA05","1","60000","20000","40000","2012-02-08 06:30:48"
"11738","4","20120207092254","Shop","AAA01","5","50000","10000","40000","2012-02-07 09:22:54"
"11739","49","20120207074548","Shop","AAA04","2","16000","800","15200","2012-02-07 07:45:48"
"11740","81","20120206032632","Shop","AAA04","2","16000","800","15200","2012-02-06 15:26:32"
"11741","22","20120206021911","Shop","AAA01","2","20000","4000","16000","2012-02-06 14:19:11"
"11742","24","20120206125206","PC","AAA02","1","15000","2300","12700","2012-02-06 12:52:06"
"11743","66","20120206120126","Mobile","AAA03","3","51000","9000","42000","2012-02-06 12:01:26"
"11744","17","20120206102437","PC","AAA01","1","10000","2000","8000","2012-02-06 10:24:37"
"11745","96","20120206080744","Mobile","AAA04","5","40000","2000","38000","2012-02-06 08:07:44"
"11746","34","20120201091000","PC","AAA03","4","68000","12000","56000","2012-02-01 21:10:00"
"11747","13","20120201025624","PC","AAA02","2","30000","4600","25400","2012-02-01 14:56:24"
"11748","73","20120201120800","Mobile","AAA05","5","300000","100000","200000","2012-02-01 12:08:00"
"11749","43","20120201113614","Mobile","AAA01","3","30000","6000","24000","2012-02-01 11:36:14"
"11750","2","20120201102106","PC","AAA03","1","17000","3000","14000","2012-02-01 10:21:06"
"11751","25","20120201064419","Shop","AAA04","1","8000","400","7600","2012-02-01 06:44:19"
"11752","47","20120131031650","PC","AAA05","1","60000","20000","40000","2012-01-31 15:16:50"
"11753","53","20120131014310","Shop","AAA04","1","8000","400","7600","2012-01-31 13:43:10"
"11754","91","20120131125156","PC","AAA05","2","120000","40000","80000","2012-01-31 12:51:56"
"11755","79","20120131115148","Mobile","AAA04","3","24000","1200","22800","2012-01-31 11:51:48"
"11756","54","20120131100032","Mobile","AAA05","2","120000","40000","80000","2012-01-31 10:00:32"
"11757","53","20120131073219","Shop","AAA02","4","60000","9200","50800","2012-01-31 07:32:19"
"11758","89","20120131021457","Mobile","AAA05","5","300000","100000","200000","2012-01-31 02:14:57"
"11759","73","20120130033751","Mobile","AAA01","4","40000","8000","32000","2012-01-30 03:37:51"
"11760","54","20120127123338","Shop","AAA05","3","180000","60000","120000","2012-01-27 00:33:38"
"11761","63","20120126094725","Mobile","AAA01","2","20000","4000","16000","2012-01-26 09:47:25"
"11762","61","20120125032643","PC","AAA05","2","120000","40000","80000","2012-01-25 15:26:43"
"11763","36","20120125014126","Shop","AAA02","10","150000","23000","127000","2012-01-25 13:41:26"
"11764","66","20120125110739","PC","AAA04","1","8000","400","7600","2012-01-25 11:07:39"
"11765","22","20120125082709","PC","AAA04","2","16000","800","15200","2012-01-25 08:27:09"
"11766","15","20120125062641","PC","AAA04","9","72000","3600","68400","2012-01-25 06:26:41"
"11767","24","20120124031519","Shop","AAA05","1","60000","20000","40000","2012-01-24 15:15:19"
"11768","22","20120124013518","PC","AAA01","3","30000","6000","24000","2012-01-24 13:35:18"
"11769","75","20120124010921","PC","AAA03","1","17000","3000","14000","2012-01-24 13:09:21"
"11770","78","20120124093943","Shop","AAA05","2","120000","40000","80000","2012-01-24 09:39:43"
"11771","98","20120124082949","PC","AAA03","1","17000","3000","14000","2012-01-24 08:29:49"
"11772","94","20120124065113","PC","AAA02","8","120000","18400","101600","2012-01-24 06:51:13"
"11773","88","20120123024818","PC","AAA02","2","30000","4600","25400","2012-01-23 14:48:18"
"11774","8","20120123124609","PC","AAA01","3","30000","6000","24000","2012-01-23 12:46:09"
"11775","89","20120123105035","Shop","AAA03","4","68000","12000","56000","2012-01-23 10:50:35"
"11776","45","20120119124008","PC","AAA04","1","8000","400","7600","2012-01-19 12:40:08"
"11777","59","20120119105128","Shop","AAA05","1","60000","20000","40000","2012-01-19 10:51:28"
"11778","62","20120119092220","Shop","AAA05","4","240000","80000","160000","2012-01-19 09:22:20"
"11779","96","20120119083320","PC","AAA02","1","15000","2300","12700","2012-01-19 08:33:20"
"11780","38","20120119053702","Mobile","AAA03","1","17000","3000","14000","2012-01-19 05:37:02"
"11781","97","20120118104204","PC","AAA04","5","40000","2000","38000","2012-01-18 10:42:04"
"11782","47","20120118073105","Mobile","AAA03","4","68000","12000","56000","2012-01-18 07:31:05"
"11783","26","20120117115009","Mobile","AAA05","1","60000","20000","40000","2012-01-17 23:50:09"
"11784","57","20120117072924","Shop","AAA02","3","45000","6900","38100","2012-01-17 07:29:24"
"11785","13","20120116051317","Shop","AAA04","1","8000","400","7600","2012-01-16 17:13:17"
"11786","71","20120116022801","Mobile","AAA02","1","15000","2300","12700","2012-01-16 14:28:01"
"11787","97","20120116014724","Mobile","AAA04","2","16000","800","15200","2012-01-16 13:47:24"
"11788","2","20120116122540","PC","AAA04","2","16000","800","15200","2012-01-16 12:25:40"
"11789","68","20120116103627","PC","AAA03","3","51000","9000","42000","2012-01-16 10:36:27"
"11790","69","20120116092720","PC","AAA02","1","15000","2300","12700","2012-01-16 09:27:20"
"11791","35","20120113024331","Mobile","AAA04","1","8000","400","7600","2012-01-13 14:43:31"
"11792","94","20120113092856","Mobile","AAA02","6","90000","13800","76200","2012-01-13 09:28:56"
"11793","96","20120113072533","Mobile","AAA05","5","300000","100000","200000","2012-01-13 07:25:33"
"11794","78","20120112125621","Shop","AAA05","2","120000","40000","80000","2012-01-12 12:56:21"
"11795","7","20120112112924","Mobile","AAA05","2","120000","40000","80000","2012-01-12 11:29:24"
"11796","68","20120112095920","Shop","AAA04","2","16000","800","15200","2012-01-12 09:59:20"
"11797","82","20120112083634","Shop","AAA04","3","24000","1200","22800","2012-01-12 08:36:34"
"11798","51","20120112063609","Mobile","AAA04","1","8000","400","7600","2012-01-12 06:36:09"
"11799","48","20120111121153","Shop","AAA02","5","75000","11500","63500","2012-01-11 12:11:53"
"11800","11","20120111110432","Mobile","AAA01","3","30000","6000","24000","2012-01-11 11:04:32"
"11801","58","20120111073110","Mobile","AAA02","2","30000","4600","25400","2012-01-11 07:31:10"
"11802","29","20120110055830","Mobile","AAA03","6","102000","18000","84000","2012-01-10 17:58:30"
"11803","11","20120110035908","PC","AAA05","2","120000","40000","80000","2012-01-10 15:59:08"
"11804","35","20120110014446","Mobile","AAA03","3","51000","9000","42000","2012-01-10 13:44:46"
"11805","3","20120110124428","Shop","AAA01","1","10000","2000","8000","2012-01-10 12:44:28"
"11806","3","20120110104303","Mobile","AAA04","8","64000","3200","60800","2012-01-10 10:43:03"
"11807","64","20120110095512","Shop","AAA05","1","60000","20000","40000","2012-01-10 09:55:12"
"11808","17","20120110075447","Mobile","AAA02","3","45000","6900","38100","2012-01-10 07:54:47"
"11809","21","20120105073215","Shop","AAA03","2","34000","6000","28000","2012-01-05 07:32:15"
"11810","30","20120103060543","PC","AAA02","2","30000","4600","25400","2012-01-03 18:05:43"
"11811","21","20120103042501","PC","AAA02","8","120000","18400","101600","2012-01-03 16:25:01"
"11812","67","20120103030440","Shop","AAA03","1","17000","3000","14000","2012-01-03 15:04:40"
"11813","17","20120103012553","Mobile","AAA01","1","10000","2000","8000","2012-01-03 13:25:53"
"11814","98","20120103101237","Shop","AAA04","2","16000","800","15200","2012-01-03 10:12:37"
"11815","30","20120103065349","PC","AAA01","2","20000","4000","16000","2012-01-03 06:53:49"
"11816","70","20120103014054","PC","AAA04","5","40000","2000","38000","2012-01-03 01:40:54"
"11817","19","20120102040102","Mobile","AAA03","3","51000","9000","42000","2012-01-02 16:01:02"
"11818","12","20120102125956","Shop","AAA01","1","10000","2000","8000","2012-01-02 12:59:56"
"11819","52","20120102105939","PC","AAA02","1","15000","2300","12700","2012-01-02 10:59:39"
"11820","12","20120102085353","Mobile","AAA02","3","45000","6900","38100","2012-01-02 08:53:53"
"11821","2","20111230055722","PC","AAA04","2","16000","800","15200","2011-12-30 05:57:22"
"11822","33","20111229123515","Shop","AAA02","2","30000","4600","25400","2011-12-29 12:35:15"
"11823","55","20111229092033","Mobile","AAA03","2","34000","6000","28000","2011-12-29 09:20:33"
"11824","16","20111229070958","Shop","AAA01","2","20000","4000","16000","2011-12-29 07:09:58"
"11825","88","20111228114833","PC","AAA03","1","17000","3000","14000","2011-12-28 23:48:33"
"11826","42","20111228083035","Shop","AAA01","5","50000","10000","40000","2011-12-28 08:30:35"
"11827","34","20111228065901","PC","AAA03","5","85000","15000","70000","2011-12-28 06:59:01"
"11828","71","20111227113732","Mobile","AAA05","1","60000","20000","40000","2011-12-27 23:37:32"
"11829","10","20111227074108","Shop","AAA02","2","30000","4600","25400","2011-12-27 07:41:08"
"11830","24","20111226052132","Mobile","AAA02","1","15000","2300","12700","2011-12-26 17:21:32"
"11831","69","20111226033550","Shop","AAA03","2","34000","6000","28000","2011-12-26 15:35:50"
"11832","41","20111226013224","PC","AAA03","2","34000","6000","28000","2011-12-26 13:32:24"
"11833","64","20111226122815","PC","AAA03","4","68000","12000","56000","2011-12-26 12:28:15"
"11834","76","20111226110500","PC","AAA05","1","60000","20000","40000","2011-12-26 11:05:00"
"11835","81","20111226090805","Shop","AAA01","2","20000","4000","16000","2011-12-26 09:08:05"
"11836","14","20111220083757","Shop","AAA02","1","15000","2300","12700","2011-12-20 20:37:57"
"11837","92","20111220054856","PC","AAA02","1","15000","2300","12700","2011-12-20 17:48:56"
"11838","79","20111220034202","PC","AAA05","1","60000","20000","40000","2011-12-20 15:42:02"
"11839","67","20111220024805","Mobile","AAA01","2","20000","4000","16000","2011-12-20 14:48:05"
"11840","14","20111220012016","Mobile","AAA04","2","16000","800","15200","2011-12-20 13:20:16"
"11841","29","20111220100513","Shop","AAA04","2","16000","800","15200","2011-12-20 10:05:13"
"11842","21","20111220075300","Shop","AAA03","5","85000","15000","70000","2011-12-20 07:53:00"
"11843","65","20111219031035","Mobile","AAA02","5","75000","11500","63500","2011-12-19 15:10:35"
"11844","64","20111219022851","Shop","AAA01","1","10000","2000","8000","2011-12-19 14:28:51"
"11845","44","20111219013523","Shop","AAA05","2","120000","40000","80000","2011-12-19 13:35:23"
"11846","10","20111219114712","Mobile","AAA04","9","72000","3600","68400","2011-12-19 11:47:12"
"11847","8","20111219105951","PC","AAA05","4","240000","80000","160000","2011-12-19 10:59:51"
"11848","89","20111219084033","Shop","AAA02","3","45000","6900","38100","2011-12-19 08:40:33"
"11849","38","20111213115439","Mobile","AAA03","2","34000","6000","28000","2011-12-13 11:54:39"
"11850","53","20111213103315","PC","AAA05","1","60000","20000","40000","2011-12-13 10:33:15"
"11851","3","20111213085805","Mobile","AAA01","3","30000","6000","24000","2011-12-13 08:58:05"
"11852","25","20111213071947","Mobile","AAA01","2","20000","4000","16000","2011-12-13 07:19:47"
"11853","57","20111212112105","PC","AAA03","1","17000","3000","14000","2011-12-12 23:21:05"
"11854","67","20111212024007","Shop","AAA05","4","240000","80000","160000","2011-12-12 02:40:07"
"11855","98","20111206083639","Shop","AAA04","1","8000","400","7600","2011-12-06 20:36:39"
"11856","87","20111206021704","Shop","AAA03","1","17000","3000","14000","2011-12-06 14:17:04"
"11857","55","20111206120600","Mobile","AAA04","4","32000","1600","30400","2011-12-06 12:06:00"
"11858","75","20111206100150","PC","AAA01","1","10000","2000","8000","2011-12-06 10:01:50"
"11859","91","20111206053711","PC","AAA01","1","10000","2000","8000","2011-12-06 05:37:11"
"11860","51","20111205021443","PC","AAA03","4","68000","12000","56000","2011-12-05 14:14:43"
"11861","15","20111205110443","PC","AAA04","2","16000","800","15200","2011-12-05 11:04:43"
"11862","53","20111205091355","PC","AAA03","1","17000","3000","14000","2011-12-05 09:13:55"
"11863","52","20111201011846","Shop","AAA05","2","120000","40000","80000","2011-12-01 01:18:46"
"11864","48","20111130032311","PC","AAA04","4","32000","1600","30400","2011-11-30 15:23:11"
"11865","50","20111130012142","PC","AAA03","2","34000","6000","28000","2011-11-30 13:21:42"
"11866","18","20111130111527","Shop","AAA01","3","30000","6000","24000","2011-11-30 11:15:27"
"11867","78","20111130102956","PC","AAA04","4","32000","1600","30400","2011-11-30 10:29:56"
"11868","99","20111130100216","PC","AAA04","1","8000","400","7600","2011-11-30 10:02:16"
"11869","83","20111130061436","Shop","AAA03","5","85000","15000","70000","2011-11-30 06:14:36"
"11870","80","20111129022805","Shop","AAA03","5","85000","15000","70000","2011-11-29 14:28:05"
"11871","62","20111129122523","PC","AAA03","3","51000","9000","42000","2011-11-29 12:25:23"
"11872","21","20111129105701","Mobile","AAA03","3","51000","9000","42000","2011-11-29 10:57:01"
"11873","12","20111129095226","Shop","AAA05","2","120000","40000","80000","2011-11-29 09:52:26"
"11874","40","20111129055233","Mobile","AAA04","2","16000","800","15200","2011-11-29 05:52:33"
"11875","24","20111128053825","PC","AAA04","4","32000","1600","30400","2011-11-28 05:38:25"
"11876","1","20111122043850","Shop","AAA05","1","60000","20000","40000","2011-11-22 04:38:50"
"11877","37","20111121124445","Shop","AAA01","5","50000","10000","40000","2011-11-21 12:44:45"
"11878","39","20111121105050","Mobile","AAA05","4","240000","80000","160000","2011-11-21 10:50:50"
"11879","17","20111121093314","Shop","AAA04","1","8000","400","7600","2011-11-21 09:33:14"
"11880","20","20111117121903","Shop","AAA01","2","20000","4000","16000","2011-11-17 12:19:03"
"11881","23","20111117092956","Shop","AAA02","2","30000","4600","25400","2011-11-17 09:29:56"
"11882","50","20111117082744","Shop","AAA05","1","60000","20000","40000","2011-11-17 08:27:44"
"11883","62","20111117070349","PC","AAA05","1","60000","20000","40000","2011-11-17 07:03:49"
"11884","44","20111116082342","Shop","AAA05","7","420000","140000","280000","2011-11-16 08:23:42"
"11885","90","20111116061624","PC","AAA05","1","60000","20000","40000","2011-11-16 06:16:24"
"11886","1","20111115043307","PC","AAA03","6","102000","18000","84000","2011-11-15 16:33:07"
"11887","48","20111115031721","Mobile","AAA03","3","51000","9000","42000","2011-11-15 15:17:21"
"11888","36","20111115014524","Mobile","AAA03","5","85000","15000","70000","2011-11-15 13:45:24"
"11889","50","20111115091732","PC","AAA05","5","300000","100000","200000","2011-11-15 09:17:32"
"11890","22","20111115082225","Shop","AAA01","1","10000","2000","8000","2011-11-15 08:22:25"
"11891","84","20111115063942","PC","AAA01","2","20000","4000","16000","2011-11-15 06:39:42"
"11892","92","20111114055539","PC","AAA02","1","15000","2300","12700","2011-11-14 05:55:39"
"11893","93","20111109020356","Mobile","AAA01","1","10000","2000","8000","2011-11-09 14:03:56"
"11894","28","20111109123821","Shop","AAA04","1","8000","400","7600","2011-11-09 12:38:21"
"11895","39","20111109010015","PC","AAA05","3","180000","60000","120000","2011-11-09 01:00:15"
"11896","65","20111108054417","PC","AAA01","2","20000","4000","16000","2011-11-08 05:44:17"
"11897","89","20111107100818","Shop","AAA05","4","240000","80000","160000","2011-11-07 22:08:18"
"11898","28","20111107050730","Mobile","AAA05","4","240000","80000","160000","2011-11-07 17:07:30"
"11899","15","20111107030441","Shop","AAA04","8","64000","3200","60800","2011-11-07 15:04:41"
"11900","92","20111107021847","PC","AAA02","1","15000","2300","12700","2011-11-07 14:18:47"
"11901","84","20111107104425","Shop","AAA03","1","17000","3000","14000","2011-11-07 10:44:25"
"11902","16","20111107094407","PC","AAA04","3","24000","1200","22800","2011-11-07 09:44:07"
"11903","10","20111102015708","Mobile","AAA01","4","40000","8000","32000","2011-11-02 13:57:08"
"11904","27","20111102113200","Shop","AAA04","3","24000","1200","22800","2011-11-02 11:32:00"
"11905","96","20111102083635","Mobile","AAA04","4","32000","1600","30400","2011-11-02 08:36:35"
"11906","75","20111102062724","PC","AAA04","1","8000","400","7600","2011-11-02 06:27:24"
"11907","22","20111101055653","PC","AAA02","3","45000","6900","38100","2011-11-01 17:56:53"
"11908","48","20111101035721","PC","AAA04","1","8000","400","7600","2011-11-01 15:57:21"
"11909","89","20111101021822","PC","AAA05","2","120000","40000","80000","2011-11-01 14:18:22"
"11910","73","20111101121552","Mobile","AAA04","4","32000","1600","30400","2011-11-01 12:15:52"
"11911","79","20111101104855","PC","AAA03","2","34000","6000","28000","2011-11-01 10:48:55"
"11912","26","20111101090120","PC","AAA04","1","8000","400","7600","2011-11-01 09:01:20"
"11913","88","20111101074703","PC","AAA02","3","45000","6900","38100","2011-11-01 07:47:03"
"11914","33","20111031023108","Shop","AAA01","1","10000","2000","8000","2011-10-31 14:31:08"
"11915","15","20111031125434","Shop","AAA02","1","15000","2300","12700","2011-10-31 12:54:34"
"11916","20","20111031123631","Mobile","AAA02","1","15000","2300","12700","2011-10-31 12:36:31"
"11917","56","20111031101914","Shop","AAA04","2","16000","800","15200","2011-10-31 10:19:14"
"11918","89","20111028033115","Shop","AAA05","4","240000","80000","160000","2011-10-28 15:31:15"
"11919","31","20111028012829","PC","AAA03","1","17000","3000","14000","2011-10-28 13:28:29"
"11920","32","20111028111120","PC","AAA02","5","75000","11500","63500","2011-10-28 11:11:20"
"11921","86","20111028081201","PC","AAA02","2","30000","4600","25400","2011-10-28 08:12:01"
"11922","75","20111028061717","Mobile","AAA03","2","34000","6000","28000","2011-10-28 06:17:17"
"11923","56","20111027071555","Mobile","AAA02","3","45000","6900","38100","2011-10-27 19:15:55"
"11924","72","20111027120425","PC","AAA01","1","10000","2000","8000","2011-10-27 12:04:25"
"11925","37","20111027085039","PC","AAA05","4","240000","80000","160000","2011-10-27 08:50:39"
"11926","26","20111027080356","Shop","AAA01","1","10000","2000","8000","2011-10-27 08:03:56"
"11927","60","20111027055505","Shop","AAA02","3","45000","6900","38100","2011-10-27 05:55:05"
"11928","48","20111026073132","Shop","AAA02","2","30000","4600","25400","2011-10-26 19:31:32"
"11929","17","20111026012007","Mobile","AAA02","1","15000","2300","12700","2011-10-26 13:20:07"
"11930","3","20111026115656","PC","AAA04","6","48000","2400","45600","2011-10-26 11:56:56"
"11931","46","20111026100840","Shop","AAA05","3","180000","60000","120000","2011-10-26 10:08:40"
"11932","32","20111026083144","Mobile","AAA04","4","32000","1600","30400","2011-10-26 08:31:44"
"11933","17","20111026061506","PC","AAA05","2","120000","40000","80000","2011-10-26 06:15:06"
"11934","18","20111025024204","Shop","AAA02","4","60000","9200","50800","2011-10-25 14:42:04"
"11935","67","20111025092030","Shop","AAA01","2","20000","4000","16000","2011-10-25 09:20:30"
"11936","58","20111025072745","Shop","AAA05","2","120000","40000","80000","2011-10-25 07:27:45"
"11937","22","20111024050935","Shop","AAA03","3","51000","9000","42000","2011-10-24 17:09:35"
"11938","53","20111024034158","PC","AAA01","1","10000","2000","8000","2011-10-24 15:41:58"
"11939","61","20111024021703","Mobile","AAA03","2","34000","6000","28000","2011-10-24 14:17:03"
"11940","57","20111024105059","Mobile","AAA01","1","10000","2000","8000","2011-10-24 10:50:59"
"11941","67","20111024092227","Shop","AAA03","2","34000","6000","28000","2011-10-24 09:22:27"
"11942","25","20111022021321","PC","AAA02","1","15000","2300","12700","2011-10-22 02:13:21"
"11943","54","20111021051417","Shop","AAA03","1","17000","3000","14000","2011-10-21 05:14:17"
"11944","92","20111020031654","Mobile","AAA03","9","153000","27000","126000","2011-10-20 03:16:54"
"11945","86","20111019041549","Mobile","AAA05","2","120000","40000","80000","2011-10-19 04:15:49"
"11946","40","20111018025231","Shop","AAA04","2","16000","800","15200","2011-10-18 14:52:31"
"11947","72","20111018111238","PC","AAA01","1","10000","2000","8000","2011-10-18 11:12:38"
"11948","42","20111018095758","PC","AAA02","6","90000","13800","76200","2011-10-18 09:57:58"
"11949","51","20111018085053","Shop","AAA04","3","24000","1200","22800","2011-10-18 08:50:53"
"11950","28","20111018063315","PC","AAA01","1","10000","2000","8000","2011-10-18 06:33:15"
"11951","81","20111017102014","Shop","AAA04","1","8000","400","7600","2011-10-17 10:20:14"
"11952","28","20111011043109","PC","AAA03","5","85000","15000","70000","2011-10-11 04:31:09"
"11953","23","20111010101244","Mobile","AAA03","2","34000","6000","28000","2011-10-10 10:12:44"
"11954","26","20111010084912","PC","AAA04","2","16000","800","15200","2011-10-10 08:49:12"
"11955","97","20111007022023","Mobile","AAA04","1","8000","400","7600","2011-10-07 02:20:23"
"11956","85","20111006070752","Shop","AAA02","1","15000","2300","12700","2011-10-06 19:07:52"
"11957","80","20111006010308","PC","AAA01","1","10000","2000","8000","2011-10-06 13:03:08"
"11958","26","20111006095834","PC","AAA05","1","60000","20000","40000","2011-10-06 09:58:34"
"11959","97","20111006081218","Mobile","AAA04","3","24000","1200","22800","2011-10-06 08:12:18"
"11960","18","20111006070310","Mobile","AAA02","1","15000","2300","12700","2011-10-06 07:03:10"
"11961","73","20111005125301","Shop","AAA03","2","34000","6000","28000","2011-10-05 12:53:01"
"11962","83","20111005122051","Shop","AAA05","1","60000","20000","40000","2011-10-05 12:20:51"
"11963","84","20111005093119","Shop","AAA01","1","10000","2000","8000","2011-10-05 09:31:19"
"11964","97","20111005064802","Mobile","AAA01","4","40000","8000","32000","2011-10-05 06:48:02"
"11965","91","20111004060246","Shop","AAA05","1","60000","20000","40000","2011-10-04 18:02:46"
"11966","38","20111004123618","Shop","AAA05","7","420000","140000","280000","2011-10-04 12:36:18"
"11967","97","20111004110430","Shop","AAA05","1","60000","20000","40000","2011-10-04 11:04:30"
"11968","94","20111004092317","PC","AAA02","2","30000","4600","25400","2011-10-04 09:23:17"
"11969","84","20111003073612","PC","AAA02","2","30000","4600","25400","2011-10-03 19:36:12"
"11970","23","20111003034844","Shop","AAA01","1","10000","2000","8000","2011-10-03 15:48:44"
"11971","73","20111003021531","Mobile","AAA01","3","30000","6000","24000","2011-10-03 14:15:31"
"11972","30","20111003122708","Shop","AAA03","1","17000","3000","14000","2011-10-03 12:27:08"
"11973","37","20111003120832","PC","AAA01","1","10000","2000","8000","2011-10-03 12:08:32"
"11974","46","20111003094609","PC","AAA03","3","51000","9000","42000","2011-10-03 09:46:09"
"11975","7","20110929090732","PC","AAA01","1","10000","2000","8000","2011-09-29 21:07:32"
"11976","42","20110929075209","PC","AAA04","2","16000","800","15200","2011-09-29 19:52:09"
"11977","37","20110929122422","PC","AAA03","1","17000","3000","14000","2011-09-29 12:24:22"
"11978","36","20110929090217","Shop","AAA02","2","30000","4600","25400","2011-09-29 09:02:17"
"11979","97","20110929070436","PC","AAA04","3","24000","1200","22800","2011-09-29 07:04:36"
"11980","3","20110928043227","PC","AAA03","7","119000","21000","98000","2011-09-28 16:32:27"
"11981","27","20110928030142","PC","AAA03","3","51000","9000","42000","2011-09-28 15:01:42"
"11982","60","20110928122138","PC","AAA01","1","10000","2000","8000","2011-09-28 12:21:38"
"11983","70","20110928111425","Mobile","AAA05","3","180000","60000","120000","2011-09-28 11:14:25"
"11984","88","20110928103245","PC","AAA05","1","60000","20000","40000","2011-09-28 10:32:45"
"11985","34","20110928080514","PC","AAA04","3","24000","1200","22800","2011-09-28 08:05:14"
"11986","60","20110927070746","Mobile","AAA05","2","120000","40000","80000","2011-09-27 19:07:46"
"11987","90","20110927122809","PC","AAA03","1","17000","3000","14000","2011-09-27 12:28:09"
"11988","18","20110927103927","PC","AAA01","3","30000","6000","24000","2011-09-27 10:39:27"
"11989","32","20110927084321","PC","AAA05","4","240000","80000","160000","2011-09-27 08:43:21"
"11990","40","20110927054426","PC","AAA01","2","20000","4000","16000","2011-09-27 05:44:26"
"11991","54","20110926070424","Shop","AAA01","1","10000","2000","8000","2011-09-26 19:04:24"
"11992","5","20110926014703","Shop","AAA03","2","34000","6000","28000","2011-09-26 13:47:03"
"11993","79","20110926121911","Shop","AAA04","1","8000","400","7600","2011-09-26 12:19:11"
"11994","16","20110926101705","Shop","AAA05","3","180000","60000","120000","2011-09-26 10:17:05"
"11995","11","20110926083916","Mobile","AAA01","2","20000","4000","16000","2011-09-26 08:39:16"
"11996","77","20110923101223","Mobile","AAA04","1","8000","400","7600","2011-09-23 10:12:23"
"11997","73","20110923064706","PC","AAA01","1","10000","2000","8000","2011-09-23 06:47:06"
"11998","14","20110922035948","Mobile","AAA01","1","10000","2000","8000","2011-09-22 15:59:48"
"11999","35","20110922020929","Shop","AAA03","1","17000","3000","14000","2011-09-22 14:09:29"
"12000","89","20110922013513","PC","AAA05","3","180000","60000","120000","2011-09-22 13:35:13"
"12001","15","20110922121231","PC","AAA04","7","56000","2800","53200","2011-09-22 12:12:31"
"12002","15","20110922101728","Shop","AAA05","9","540000","180000","360000","2011-09-22 10:17:28"
"12003","76","20110922083331","PC","AAA04","1","8000","400","7600","2011-09-22 08:33:31"
"12004","9","20110922070646","Mobile","AAA01","1","10000","2000","8000","2011-09-22 07:06:46"
"12005","45","20110921051446","Mobile","AAA05","1","60000","20000","40000","2011-09-21 17:14:46"
"12006","43","20110921015414","Mobile","AAA05","5","300000","100000","200000","2011-09-21 13:54:14"
"12007","92","20110921100923","Shop","AAA04","4","32000","1600","30400","2011-09-21 10:09:23"
"12008","42","20110920035208","Mobile","AAA02","2","30000","4600","25400","2011-09-20 15:52:08"
"12009","26","20110920020537","Shop","AAA05","2","120000","40000","80000","2011-09-20 14:05:37"
"12010","62","20110920113314","Mobile","AAA01","7","70000","14000","56000","2011-09-20 11:33:14"
"12011","77","20110920073215","Mobile","AAA05","4","240000","80000","160000","2011-09-20 07:32:15"
"12012","51","20110919104115","Shop","AAA05","1","60000","20000","40000","2011-09-19 10:41:15"
"12013","53","20110919090205","PC","AAA02","1","15000","2300","12700","2011-09-19 09:02:05"
"12014","40","20110918050752","Shop","AAA03","1","17000","3000","14000","2011-09-18 05:07:52"
"12015","5","20110916091031","PC","AAA03","2","34000","6000","28000","2011-09-16 09:10:31"
"12016","89","20110916072349","Shop","AAA02","3","45000","6900","38100","2011-09-16 07:23:49"
"12017","81","20110915081847","PC","AAA03","1","17000","3000","14000","2011-09-15 20:18:47"
"12018","90","20110915013428","Shop","AAA01","1","10000","2000","8000","2011-09-15 13:34:28"
"12019","93","20110915110052","Mobile","AAA05","2","120000","40000","80000","2011-09-15 11:00:52"
"12020","75","20110915100032","PC","AAA02","1","15000","2300","12700","2011-09-15 10:00:32"
"12021","16","20110915073928","PC","AAA03","7","119000","21000","98000","2011-09-15 07:39:28"
"12022","79","20110915061053","PC","AAA02","3","45000","6900","38100","2011-09-15 06:10:53"
"12023","21","20110915021106","Shop","AAA04","3","24000","1200","22800","2011-09-15 02:11:06"
"12024","91","20110914012123","Mobile","AAA05","1","60000","20000","40000","2011-09-14 13:21:23"
"12025","54","20110914122009","Mobile","AAA02","4","60000","9200","50800","2011-09-14 12:20:09"
"12026","90","20110914105141","Shop","AAA05","2","120000","40000","80000","2011-09-14 10:51:41"
"12027","98","20110914083508","Mobile","AAA01","1","10000","2000","8000","2011-09-14 08:35:08"
"12028","15","20110914063044","Mobile","AAA01","9","90000","18000","72000","2011-09-14 06:30:44"
"12029","54","20110913055622","Shop","AAA05","3","180000","60000","120000","2011-09-13 17:56:22"
"12030","63","20110913052906","Shop","AAA05","2","120000","40000","80000","2011-09-13 17:29:06"
"12031","37","20110913035420","PC","AAA01","2","20000","4000","16000","2011-09-13 15:54:20"
"12032","31","20110913024923","Shop","AAA01","1","10000","2000","8000","2011-09-13 14:49:23"
"12033","40","20110913122929","Mobile","AAA01","2","20000","4000","16000","2011-09-13 12:29:29"
"12034","99","20110913110821","Shop","AAA02","1","15000","2300","12700","2011-09-13 11:08:21"
"12035","27","20110913092329","Shop","AAA01","1","10000","2000","8000","2011-09-13 09:23:29"
"12036","9","20110912123952","PC","AAA04","1","8000","400","7600","2011-09-12 12:39:52"
"12037","78","20110912114524","Mobile","AAA01","1","10000","2000","8000","2011-09-12 11:45:24"
"12038","21","20110912093055","Mobile","AAA02","1","15000","2300","12700","2011-09-12 09:30:55"
"12039","66","20110905020720","Shop","AAA03","1","17000","3000","14000","2011-09-05 14:07:20"
"12040","73","20110905123123","PC","AAA02","6","90000","13800","76200","2011-09-05 12:31:23"
"12041","41","20110905105524","Mobile","AAA03","1","17000","3000","14000","2011-09-05 10:55:24"
"12042","6","20110905094214","Shop","AAA02","1","15000","2300","12700","2011-09-05 09:42:14"
"12043","54","20110830113554","Mobile","AAA03","2","34000","6000","28000","2011-08-30 11:35:54"
"12044","97","20110830101154","Mobile","AAA01","1","10000","2000","8000","2011-08-30 10:11:54"
"12045","48","20110830081440","PC","AAA03","1","17000","3000","14000","2011-08-30 08:14:40"
"12046","50","20110830063830","Mobile","AAA02","1","15000","2300","12700","2011-08-30 06:38:30"
"12047","85","20110829100159","Mobile","AAA05","5","300000","100000","200000","2011-08-29 22:01:59"
"12048","25","20110829022315","Mobile","AAA04","7","56000","2800","53200","2011-08-29 14:23:15"
"12049","81","20110829010208","PC","AAA01","1","10000","2000","8000","2011-08-29 13:02:08"
"12050","67","20110829111618","PC","AAA04","6","48000","2400","45600","2011-08-29 11:16:18"
"12051","95","20110829095836","Mobile","AAA04","3","24000","1200","22800","2011-08-29 09:58:36"
"12052","34","20110824114723","Mobile","AAA03","4","68000","12000","56000","2011-08-24 11:47:23"
"12053","4","20110824101212","Mobile","AAA01","1","10000","2000","8000","2011-08-24 10:12:12"
"12054","77","20110824090809","PC","AAA05","1","60000","20000","40000","2011-08-24 09:08:09"
"12055","58","20110824071654","Mobile","AAA05","3","180000","60000","120000","2011-08-24 07:16:54"
"12056","54","20110823054935","Mobile","AAA01","1","10000","2000","8000","2011-08-23 17:49:35"
"12057","25","20110823024256","Shop","AAA03","3","51000","9000","42000","2011-08-23 14:42:56"
"12058","16","20110823015419","Shop","AAA05","5","300000","100000","200000","2011-08-23 13:54:19"
"12059","26","20110823112100","Shop","AAA03","1","17000","3000","14000","2011-08-23 11:21:00"
"12060","21","20110823095052","PC","AAA05","4","240000","80000","160000","2011-08-23 09:50:52"
"12061","19","20110823080801","Shop","AAA01","1","10000","2000","8000","2011-08-23 08:08:01"
"12062","54","20110823072559","Shop","AAA01","1","10000","2000","8000","2011-08-23 07:25:59"
"12063","47","20110822123031","PC","AAA04","1","8000","400","7600","2011-08-22 12:30:31"
"12064","35","20110822110143","Shop","AAA03","1","17000","3000","14000","2011-08-22 11:01:43"
"12065","39","20110822081929","Shop","AAA05","3","180000","60000","120000","2011-08-22 08:19:29"
"12066","44","20110822125535","Mobile","AAA03","3","51000","9000","42000","2011-08-22 00:55:35"
"12067","65","20110817075806","Shop","AAA04","3","24000","1200","22800","2011-08-17 19:58:06"
"12068","58","20110817031954","Shop","AAA02","1","15000","2300","12700","2011-08-17 15:19:54"
"12069","1","20110817010347","Shop","AAA03","2","34000","6000","28000","2011-08-17 13:03:47"
"12070","34","20110817115145","Shop","AAA02","1","15000","2300","12700","2011-08-17 11:51:45"
"12071","83","20110817071332","Shop","AAA02","5","75000","11500","63500","2011-08-17 07:13:32"
"12072","45","20110816113059","Mobile","AAA05","1","60000","20000","40000","2011-08-16 23:30:59"
"12073","73","20110816043217","Shop","AAA04","3","24000","1200","22800","2011-08-16 04:32:17"
"12074","100","20110815080405","Mobile","AAA02","1","15000","2300","12700","2011-08-15 08:04:05"
"12075","97","20110812041838","Shop","AAA05","3","180000","60000","120000","2011-08-12 04:18:38"
"12076","96","20110811091425","Mobile","AAA01","4","40000","8000","32000","2011-08-11 09:14:25"
"12077","80","20110811063845","Shop","AAA05","1","60000","20000","40000","2011-08-11 06:38:45"
"12078","25","20110810012123","PC","AAA03","5","85000","15000","70000","2011-08-10 13:21:23"
"12079","96","20110810111138","PC","AAA03","1","17000","3000","14000","2011-08-10 11:11:38"
"12080","40","20110810073722","PC","AAA02","2","30000","4600","25400","2011-08-10 07:37:22"
"12081","66","20110809080626","PC","AAA02","4","60000","9200","50800","2011-08-09 20:06:26"
"12082","20","20110809013559","Shop","AAA02","2","30000","4600","25400","2011-08-09 13:35:59"
"12083","64","20110809104420","Shop","AAA05","1","60000","20000","40000","2011-08-09 10:44:20"
"12084","26","20110809074903","Shop","AAA05","3","180000","60000","120000","2011-08-09 07:49:03"
"12085","99","20110808071836","Mobile","AAA05","1","60000","20000","40000","2011-08-08 19:18:36"
"12086","32","20110808040700","Mobile","AAA05","3","180000","60000","120000","2011-08-08 16:07:00"
"12087","31","20110808020818","Mobile","AAA03","2","34000","6000","28000","2011-08-08 14:08:18"
"12088","98","20110808010038","PC","AAA02","2","30000","4600","25400","2011-08-08 13:00:38"
"12089","10","20110808110544","Mobile","AAA03","4","68000","12000","56000","2011-08-08 11:05:44"
"12090","97","20110808091643","Shop","AAA02","1","15000","2300","12700","2011-08-08 09:16:43"
"12091","36","20110806085349","PC","AAA04","3","24000","1200","22800","2011-08-06 08:53:49"
"12092","2","20110805104815","Shop","AAA03","1","17000","3000","14000","2011-08-05 10:48:15"
"12093","49","20110805083951","Shop","AAA04","4","32000","1600","30400","2011-08-05 08:39:51"
"12094","49","20110805062825","PC","AAA01","1","10000","2000","8000","2011-08-05 06:28:25"
"12095","100","20110805022307","Shop","AAA01","1","10000","2000","8000","2011-08-05 02:23:07"
"12096","68","20110804053842","PC","AAA04","1","8000","400","7600","2011-08-04 17:38:42"
"12097","92","20110804035514","Mobile","AAA04","2","16000","800","15200","2011-08-04 15:55:14"
"12098","74","20110804031003","Mobile","AAA05","3","180000","60000","120000","2011-08-04 15:10:03"
"12099","84","20110804015028","Mobile","AAA01","2","20000","4000","16000","2011-08-04 13:50:28"
"12100","12","20110804124752","PC","AAA03","2","34000","6000","28000","2011-08-04 12:47:52"
"12101","72","20110804091804","PC","AAA01","4","40000","8000","32000","2011-08-04 09:18:04"
"12102","67","20110804074623","Mobile","AAA05","3","180000","60000","120000","2011-08-04 07:46:23"
"12103","10","20110804055339","PC","AAA05","4","240000","80000","160000","2011-08-04 05:53:39"
"12104","90","20110803115518","Shop","AAA01","1","10000","2000","8000","2011-08-03 11:55:18"
"12105","59","20110803095323","Shop","AAA04","2","16000","800","15200","2011-08-03 09:53:23"
"12106","89","20110803082851","Shop","AAA03","6","102000","18000","84000","2011-08-03 08:28:51"
"12107","89","20110803073622","Shop","AAA04","8","64000","3200","60800","2011-08-03 07:36:22"
"12108","30","20110802065505","Shop","AAA04","2","16000","800","15200","2011-08-02 18:55:05"
"12109","19","20110802013856","Mobile","AAA05","2","120000","40000","80000","2011-08-02 13:38:56"
"12110","6","20110802062336","PC","AAA01","1","10000","2000","8000","2011-08-02 06:23:36"
"12111","96","20110801043540","PC","AAA03","1","17000","3000","14000","2011-08-01 16:35:40"
"12112","15","20110801022626","Shop","AAA04","5","40000","2000","38000","2011-08-01 14:26:26"
"12113","71","20110801122652","Mobile","AAA04","7","56000","2800","53200","2011-08-01 12:26:52"
"12114","36","20110801101602","Mobile","AAA04","2","16000","800","15200","2011-08-01 10:16:02"
"12115","96","20110801083924","PC","AAA03","7","119000","21000","98000","2011-08-01 08:39:24"
"12116","32","20110726050628","Shop","AAA01","4","40000","8000","32000","2011-07-26 17:06:28"
"12117","60","20110726125353","Mobile","AAA02","2","30000","4600","25400","2011-07-26 12:53:53"
"12118","64","20110726114726","PC","AAA01","2","20000","4000","16000","2011-07-26 11:47:26"
"12119","21","20110726100144","Mobile","AAA02","1","15000","2300","12700","2011-07-26 10:01:44"
"12120","56","20110726085328","Shop","AAA04","3","24000","1200","22800","2011-07-26 08:53:28"
"12121","11","20110726072447","Shop","AAA04","4","32000","1600","30400","2011-07-26 07:24:47"
"12122","18","20110725054546","PC","AAA03","3","51000","9000","42000","2011-07-25 17:45:46"
"12123","67","20110725032957","Shop","AAA05","2","120000","40000","80000","2011-07-25 15:29:57"
"12124","46","20110725022243","PC","AAA03","2","34000","6000","28000","2011-07-25 14:22:43"
"12125","74","20110725123233","PC","AAA02","1","15000","2300","12700","2011-07-25 12:32:33"
"12126","23","20110725101007","Mobile","AAA01","1","10000","2000","8000","2011-07-25 10:10:07"
"12127","94","20110725082156","Shop","AAA02","3","45000","6900","38100","2011-07-25 08:21:56"
"12128","7","20110721054632","Mobile","AAA05","2","120000","40000","80000","2011-07-21 17:46:32"
"12129","27","20110721024733","Mobile","AAA02","7","105000","16100","88900","2011-07-21 14:47:33"
"12130","11","20110721122139","Shop","AAA02","1","15000","2300","12700","2011-07-21 12:21:39"
"12131","60","20110721100041","Shop","AAA03","1","17000","3000","14000","2011-07-21 10:00:41"
"12132","34","20110721075939","Shop","AAA02","4","60000","9200","50800","2011-07-21 07:59:39"
"12133","65","20110720032852","PC","AAA05","4","240000","80000","160000","2011-07-20 15:28:52"
"12134","87","20110720013617","Mobile","AAA04","2","16000","800","15200","2011-07-20 13:36:17"
"12135","6","20110720110229","PC","AAA01","2","20000","4000","16000","2011-07-20 11:02:29"
"12136","58","20110719041810","PC","AAA04","3","24000","1200","22800","2011-07-19 16:18:10"
"12137","17","20110719031649","Mobile","AAA05","4","240000","80000","160000","2011-07-19 15:16:49"
"12138","37","20110719013545","Mobile","AAA01","4","40000","8000","32000","2011-07-19 13:35:45"
"12139","59","20110719105159","Shop","AAA01","1","10000","2000","8000","2011-07-19 10:51:59"
"12140","5","20110719085132","Shop","AAA01","2","20000","4000","16000","2011-07-19 08:51:32"
"12141","53","20110718124036","PC","AAA04","1","8000","400","7600","2011-07-18 12:40:36"
"12142","60","20110718091350","Mobile","AAA02","1","15000","2300","12700","2011-07-18 09:13:50"
"12143","27","20110714085436","Mobile","AAA05","1","60000","20000","40000","2011-07-14 08:54:36"
"12144","57","20110714072639","Mobile","AAA01","1","10000","2000","8000","2011-07-14 07:26:39"
"12145","3","20110713112055","Shop","AAA01","3","30000","6000","24000","2011-07-13 23:20:55"
"12146","92","20110713015034","PC","AAA03","1","17000","3000","14000","2011-07-13 13:50:34"
"12147","50","20110713095242","Mobile","AAA01","5","50000","10000","40000","2011-07-13 09:52:42"
"12148","16","20110713064944","Shop","AAA02","1","15000","2300","12700","2011-07-13 06:49:44"
"12149","88","20110712010429","Shop","AAA05","1","60000","20000","40000","2011-07-12 13:04:29"
"12150","14","20110712110003","Mobile","AAA01","2","20000","4000","16000","2011-07-12 11:00:03"
"12151","7","20110712091539","PC","AAA03","2","34000","6000","28000","2011-07-12 09:15:39"
"12152","21","20110712071624","PC","AAA04","1","8000","400","7600","2011-07-12 07:16:24"
"12153","77","20110711052530","PC","AAA04","1","8000","400","7600","2011-07-11 17:25:30"
"12154","31","20110711023731","Mobile","AAA03","2","34000","6000","28000","2011-07-11 14:37:31"
"12155","65","20110711012452","PC","AAA04","3","24000","1200","22800","2011-07-11 13:24:52"
"12156","97","20110711120913","PC","AAA02","2","30000","4600","25400","2011-07-11 12:09:13"
"12157","67","20110711104345","Shop","AAA02","1","15000","2300","12700","2011-07-11 10:43:45"
"12158","96","20110711092809","Shop","AAA05","2","120000","40000","80000","2011-07-11 09:28:09"
"12159","23","20110708035154","Mobile","AAA02","4","60000","9200","50800","2011-07-08 03:51:54"
"12160","62","20110707105433","Mobile","AAA05","2","120000","40000","80000","2011-07-07 10:54:33"
"12161","42","20110706115907","PC","AAA04","1","8000","400","7600","2011-07-06 11:59:07"
"12162","22","20110706100646","PC","AAA02","1","15000","2300","12700","2011-07-06 10:06:46"
"12163","16","20110706071734","Mobile","AAA02","5","75000","11500","63500","2011-07-06 07:17:34"
"12164","40","20110705080447","Shop","AAA01","1","10000","2000","8000","2011-07-05 20:04:47"
"12165","25","20110705035312","Shop","AAA04","2","16000","800","15200","2011-07-05 15:53:12"
"12166","94","20110705012748","PC","AAA05","5","300000","100000","200000","2011-07-05 13:27:48"
"12167","51","20110705091413","Shop","AAA05","3","180000","60000","120000","2011-07-05 09:14:13"
"12168","67","20110705072021","Mobile","AAA04","5","40000","2000","38000","2011-07-05 07:20:21"
"12169","8","20110704070125","Shop","AAA05","4","240000","80000","160000","2011-07-04 19:01:25"
"12170","97","20110704020353","Shop","AAA03","1","17000","3000","14000","2011-07-04 14:03:53"
"12171","30","20110704100854","Mobile","AAA03","3","51000","9000","42000","2011-07-04 10:08:54"
"12172","14","20110704080021","PC","AAA02","1","15000","2300","12700","2011-07-04 08:00:21"
"12173","80","20110701010129","PC","AAA05","4","240000","80000","160000","2011-07-01 01:01:29"
"12174","43","20110630062618","Shop","AAA03","5","85000","15000","70000","2011-06-30 06:26:18"
"12175","37","20110629034412","PC","AAA04","1","8000","400","7600","2011-06-29 15:44:12"
"12176","49","20110629012754","Shop","AAA02","5","75000","11500","63500","2011-06-29 13:27:54"
"12177","41","20110629123305","Shop","AAA02","2","30000","4600","25400","2011-06-29 12:33:05"
"12178","75","20110629105938","Shop","AAA01","2","20000","4000","16000","2011-06-29 10:59:38"
"12179","37","20110629073327","PC","AAA05","2","120000","40000","80000","2011-06-29 07:33:27"
"12180","56","20110628054639","Mobile","AAA03","3","51000","9000","42000","2011-06-28 17:46:39"
"12181","58","20110628042751","Shop","AAA01","1","10000","2000","8000","2011-06-28 16:27:51"
"12182","3","20110628024553","Mobile","AAA05","2","120000","40000","80000","2011-06-28 14:45:53"
"12183","30","20110628011634","Mobile","AAA05","3","180000","60000","120000","2011-06-28 13:16:34"
"12184","33","20110628114840","PC","AAA05","3","180000","60000","120000","2011-06-28 11:48:40"
"12185","24","20110628103424","Shop","AAA02","4","60000","9200","50800","2011-06-28 10:34:24"
"12186","65","20110628072856","Shop","AAA01","1","10000","2000","8000","2011-06-28 07:28:56"
"12187","30","20110627013453","Mobile","AAA01","1","10000","2000","8000","2011-06-27 13:34:53"
"12188","50","20110627112328","Shop","AAA02","1","15000","2300","12700","2011-06-27 11:23:28"
"12189","97","20110623042754","PC","AAA02","3","45000","6900","38100","2011-06-23 04:27:54"
"12190","60","20110622051733","PC","AAA01","4","40000","8000","32000","2011-06-22 17:17:33"
"12191","79","20110622034943","Shop","AAA05","3","180000","60000","120000","2011-06-22 15:49:43"
"12192","39","20110622123452","Mobile","AAA05","1","60000","20000","40000","2011-06-22 12:34:52"
"12193","81","20110622110859","PC","AAA02","1","15000","2300","12700","2011-06-22 11:08:59"
"12194","97","20110622084529","Shop","AAA04","1","8000","400","7600","2011-06-22 08:45:29"
"12195","55","20110622063702","Shop","AAA01","2","20000","4000","16000","2011-06-22 06:37:02"
"12196","60","20110621080340","Mobile","AAA05","1","60000","20000","40000","2011-06-21 20:03:40"
"12197","96","20110621020716","Shop","AAA04","1","8000","400","7600","2011-06-21 14:07:16"
"12198","87","20110621120239","Shop","AAA04","1","8000","400","7600","2011-06-21 12:02:39"
"12199","91","20110621101853","Shop","AAA03","1","17000","3000","14000","2011-06-21 10:18:53"
"12200","90","20110621082057","Shop","AAA02","1","15000","2300","12700","2011-06-21 08:20:57"
"12201","43","20110621063228","Mobile","AAA04","6","48000","2400","45600","2011-06-21 06:32:28"
"12202","39","20110620051829","Mobile","AAA03","2","34000","6000","28000","2011-06-20 17:18:29"
"12203","72","20110620035208","PC","AAA04","4","32000","1600","30400","2011-06-20 15:52:08"
"12204","79","20110620020552","PC","AAA03","2","34000","6000","28000","2011-06-20 14:05:52"
"12205","72","20110620120713","PC","AAA03","2","34000","6000","28000","2011-06-20 12:07:13"
"12206","21","20110620103900","Mobile","AAA05","5","300000","100000","200000","2011-06-20 10:39:00"
"12207","46","20110620083329","Mobile","AAA01","3","30000","6000","24000","2011-06-20 08:33:29"
"12208","56","20110615110357","Mobile","AAA04","4","32000","1600","30400","2011-06-15 23:03:57"
"12209","80","20110615070436","Mobile","AAA02","3","45000","6900","38100","2011-06-15 07:04:36"
"12210","68","20110615033026","Shop","AAA02","3","45000","6900","38100","2011-06-15 03:30:26"
"12211","43","20110614050153","Mobile","AAA05","2","120000","40000","80000","2011-06-14 17:01:53"
"12212","67","20110614011824","PC","AAA03","2","34000","6000","28000","2011-06-14 13:18:24"
"12213","18","20110614081017","PC","AAA04","3","24000","1200","22800","2011-06-14 08:10:17"
"12214","28","20110614051643","Mobile","AAA03","3","51000","9000","42000","2011-06-14 05:16:43"
"12215","97","20110613014814","Shop","AAA03","2","34000","6000","28000","2011-06-13 13:48:14"
"12216","90","20110613112233","Shop","AAA04","2","16000","800","15200","2011-06-13 11:22:33"
"12217","2","20110613095841","PC","AAA01","1","10000","2000","8000","2011-06-13 09:58:41"
"12218","10","20110609113519","Mobile","AAA01","2","20000","4000","16000","2011-06-09 23:35:19"
"12219","74","20110609043604","Shop","AAA01","1","10000","2000","8000","2011-06-09 16:36:04"
"12220","43","20110609023912","Shop","AAA03","2","34000","6000","28000","2011-06-09 14:39:12"
"12221","42","20110609113235","PC","AAA05","6","360000","120000","240000","2011-06-09 11:32:35"
"12222","39","20110609055620","PC","AAA01","2","20000","4000","16000","2011-06-09 05:56:20"
"12223","6","20110608095018","Mobile","AAA02","1","15000","2300","12700","2011-06-08 09:50:18"
"12224","29","20110608073304","Mobile","AAA04","1","8000","400","7600","2011-06-08 07:33:04"
"12225","79","20110607080138","PC","AAA05","3","180000","60000","120000","2011-06-07 20:01:38"
"12226","61","20110607035924","PC","AAA04","1","8000","400","7600","2011-06-07 15:59:24"
"12227","31","20110607021612","Shop","AAA04","3","24000","1200","22800","2011-06-07 14:16:12"
"12228","16","20110607095805","Mobile","AAA03","1","17000","3000","14000","2011-06-07 09:58:05"
"12229","47","20110607085954","Mobile","AAA05","3","180000","60000","120000","2011-06-07 08:59:54"
"12230","93","20110607071028","PC","AAA04","1","8000","400","7600","2011-06-07 07:10:28"
"12231","13","20110606061231","PC","AAA01","4","40000","8000","32000","2011-06-06 18:12:31"
"12232","68","20110531070536","Shop","AAA02","1","15000","2300","12700","2011-05-31 19:05:36"
"12233","87","20110531125905","PC","AAA05","3","180000","60000","120000","2011-05-31 12:59:05"
"12234","98","20110531112428","Shop","AAA05","2","120000","40000","80000","2011-05-31 11:24:28"
"12235","78","20110531094733","Shop","AAA01","4","40000","8000","32000","2011-05-31 09:47:33"
"12236","85","20110531074833","Shop","AAA02","2","30000","4600","25400","2011-05-31 07:48:33"
"12237","29","20110530112514","Mobile","AAA03","2","34000","6000","28000","2011-05-30 11:25:14"
"12238","20","20110530074653","PC","AAA05","1","60000","20000","40000","2011-05-30 07:46:53"
"12239","60","20110526012304","PC","AAA04","1","8000","400","7600","2011-05-26 01:23:04"
"12240","70","20110525082008","PC","AAA01","5","50000","10000","40000","2011-05-25 08:20:08"
"12241","17","20110525065830","PC","AAA03","5","85000","15000","70000","2011-05-25 06:58:30"
"12242","46","20110524114438","Mobile","AAA01","5","50000","10000","40000","2011-05-24 11:44:38"
"12243","97","20110524100716","Mobile","AAA02","1","15000","2300","12700","2011-05-24 10:07:16"
"12244","56","20110524081026","Shop","AAA01","3","30000","6000","24000","2011-05-24 08:10:26"
"12245","58","20110524065945","Mobile","AAA05","3","180000","60000","120000","2011-05-24 06:59:45"
"12246","5","20110523085524","Shop","AAA05","4","240000","80000","160000","2011-05-23 20:55:24"
"12247","47","20110523031353","Mobile","AAA03","4","68000","12000","56000","2011-05-23 15:13:53"
"12248","100","20110523024458","Shop","AAA05","2","120000","40000","80000","2011-05-23 14:44:58"
"12249","47","20110523010133","Mobile","AAA03","1","17000","3000","14000","2011-05-23 13:01:33"
"12250","53","20110523114551","Shop","AAA01","1","10000","2000","8000","2011-05-23 11:45:51"
"12251","16","20110517042000","PC","AAA02","3","45000","6900","38100","2011-05-17 16:20:00"
"12252","24","20110517013113","Shop","AAA03","2","34000","6000","28000","2011-05-17 13:31:13"
"12253","39","20110517084727","Shop","AAA03","1","17000","3000","14000","2011-05-17 08:47:27"
"12254","1","20110517070948","Mobile","AAA01","5","50000","10000","40000","2011-05-17 07:09:48"
"12255","94","20110516113249","Shop","AAA02","4","60000","9200","50800","2011-05-16 11:32:49"
"12256","15","20110516082212","PC","AAA01","4","40000","8000","32000","2011-05-16 08:22:12"
"12257","27","20110512032116","PC","AAA04","4","32000","1600","30400","2011-05-12 15:21:16"
"12258","7","20110512010716","PC","AAA05","3","180000","60000","120000","2011-05-12 13:07:16"
"12259","98","20110512104904","Mobile","AAA05","1","60000","20000","40000","2011-05-12 10:49:04"
"12260","67","20110512083854","Shop","AAA01","4","40000","8000","32000","2011-05-12 08:38:54"
"12261","66","20110512065748","Mobile","AAA04","3","24000","1200","22800","2011-05-12 06:57:48"
"12262","97","20110511121225","Mobile","AAA03","3","51000","9000","42000","2011-05-11 12:12:25"
"12263","50","20110511105516","Shop","AAA01","2","20000","4000","16000","2011-05-11 10:55:16"
"12264","30","20110511074525","Shop","AAA01","1","10000","2000","8000","2011-05-11 07:45:25"
"12265","71","20110511024440","Shop","AAA01","5","50000","10000","40000","2011-05-11 02:44:40"
"12266","49","20110509124328","Mobile","AAA04","3","24000","1200","22800","2011-05-09 12:43:28"
"12267","9","20110509105610","PC","AAA01","2","20000","4000","16000","2011-05-09 10:56:10"
"12268","15","20110509093507","PC","AAA03","8","136000","24000","112000","2011-05-09 09:35:07"
"12269","9","20110506032620","PC","AAA04","1","8000","400","7600","2011-05-06 03:26:20"
"12270","10","20110505070527","PC","AAA01","1","10000","2000","8000","2011-05-05 19:05:27"
"12271","62","20110505032839","Mobile","AAA05","3","180000","60000","120000","2011-05-05 15:28:39"
"12272","55","20110505021303","Mobile","AAA03","1","17000","3000","14000","2011-05-05 14:13:03"
"12273","89","20110505010042","Mobile","AAA03","5","85000","15000","70000","2011-05-05 13:00:42"
"12274","9","20110505112650","PC","AAA04","2","16000","800","15200","2011-05-05 11:26:50"
"12275","83","20110505095432","PC","AAA03","2","34000","6000","28000","2011-05-05 09:54:32"
"12276","1","20110505084550","PC","AAA03","2","34000","6000","28000","2011-05-05 08:45:50"
"12277","27","20110504072932","Mobile","AAA01","3","30000","6000","24000","2011-05-04 07:29:32"
"12278","8","20110503124156","Shop","AAA02","4","60000","9200","50800","2011-05-03 12:41:56"
"12279","44","20110503112303","Mobile","AAA03","3","51000","9000","42000","2011-05-03 11:23:03"
"12280","82","20110503093228","Mobile","AAA02","1","15000","2300","12700","2011-05-03 09:32:28"
"12281","15","20110503081600","PC","AAA03","1","17000","3000","14000","2011-05-03 08:16:00"
"12282","30","20110503062020","Mobile","AAA04","5","40000","2000","38000","2011-05-03 06:20:20"
"12283","66","20110502032138","Shop","AAA01","4","40000","8000","32000","2011-05-02 15:21:38"
"12284","9","20110502125638","Mobile","AAA02","1","15000","2300","12700","2011-05-02 12:56:38"
"12285","52","20110502105449","PC","AAA03","1","17000","3000","14000","2011-05-02 10:54:49"
"12286","15","20110502093402","Mobile","AAA04","9","72000","3600","68400","2011-05-02 09:34:02"
"12287","87","20110429110047","PC","AAA04","3","24000","1200","22800","2011-04-29 23:00:47"
"12288","93","20110429070258","Mobile","AAA01","1","10000","2000","8000","2011-04-29 07:02:58"
"12289","21","20110428024858","Shop","AAA03","5","85000","15000","70000","2011-04-28 14:48:58"
"12290","5","20110428012627","Shop","AAA01","3","30000","6000","24000","2011-04-28 13:26:27"
"12291","5","20110428123608","PC","AAA01","4","40000","8000","32000","2011-04-28 12:36:08"
"12292","78","20110428111840","PC","AAA03","1","17000","3000","14000","2011-04-28 11:18:40"
"12293","11","20110428085031","PC","AAA03","5","85000","15000","70000","2011-04-28 08:50:31"
"12294","55","20110428072317","Shop","AAA04","1","8000","400","7600","2011-04-28 07:23:17"
"12295","97","20110427054325","Shop","AAA02","1","15000","2300","12700","2011-04-27 17:43:25"
"12296","96","20110427033223","Shop","AAA02","2","30000","4600","25400","2011-04-27 15:32:23"
"12297","43","20110427013644","PC","AAA05","5","300000","100000","200000","2011-04-27 13:36:44"
"12298","65","20110427112456","Shop","AAA03","6","102000","18000","84000","2011-04-27 11:24:56"
"12299","59","20110427065912","PC","AAA04","1","8000","400","7600","2011-04-27 06:59:12"
"12300","56","20110426070635","PC","AAA01","2","20000","4000","16000","2011-04-26 07:06:35"
"12301","43","20110425054820","Shop","AAA01","1","10000","2000","8000","2011-04-25 17:48:20"
"12302","93","20110425012312","PC","AAA01","3","30000","6000","24000","2011-04-25 13:23:12"
"12303","90","20110425111646","Shop","AAA01","2","20000","4000","16000","2011-04-25 11:16:46"
"12304","63","20110419030859","Shop","AAA04","1","8000","400","7600","2011-04-19 15:08:59"
"12305","37","20110419124747","Mobile","AAA03","4","68000","12000","56000","2011-04-19 12:47:47"
"12306","12","20110419080033","PC","AAA01","2","20000","4000","16000","2011-04-19 08:00:33"
"12307","57","20110419063339","Shop","AAA01","3","30000","6000","24000","2011-04-19 06:33:39"
"12308","37","20110418041122","Shop","AAA03","3","51000","9000","42000","2011-04-18 16:11:22"
"12309","10","20110418023917","PC","AAA05","4","240000","80000","160000","2011-04-18 14:39:17"
"12310","95","20110418103118","Mobile","AAA01","2","20000","4000","16000","2011-04-18 10:31:18"
"12311","8","20110418083525","Shop","AAA01","3","30000","6000","24000","2011-04-18 08:35:25"
"12312","29","20110414123825","Shop","AAA01","6","60000","12000","48000","2011-04-14 00:38:25"
"12313","11","20110413065625","Shop","AAA05","3","180000","60000","120000","2011-04-13 06:56:25"
"12314","22","20110412064531","Mobile","AAA04","3","24000","1200","22800","2011-04-12 06:45:31"
"12315","72","20110411115933","PC","AAA03","1","17000","3000","14000","2011-04-11 11:59:33"
"12316","29","20110411103453","Mobile","AAA02","1","15000","2300","12700","2011-04-11 10:34:53"
"12317","45","20110411085746","Shop","AAA03","1","17000","3000","14000","2011-04-11 08:57:46"
"12318","81","20110406095651","Mobile","AAA03","1","17000","3000","14000","2011-04-06 21:56:51"
"12319","5","20110406113047","Mobile","AAA05","1","60000","20000","40000","2011-04-06 11:30:47"
"12320","72","20110406094718","Mobile","AAA05","2","120000","40000","80000","2011-04-06 09:47:18"
"12321","84","20110406072455","PC","AAA03","1","17000","3000","14000","2011-04-06 07:24:55"
"12322","51","20110405031506","Mobile","AAA01","5","50000","10000","40000","2011-04-05 15:15:06"
"12323","50","20110405021156","Mobile","AAA01","6","60000","12000","48000","2011-04-05 14:11:56"
"12324","94","20110405114846","Mobile","AAA01","5","50000","10000","40000","2011-04-05 11:48:46"
"12325","76","20110405102922","PC","AAA01","1","10000","2000","8000","2011-04-05 10:29:22"
"12326","61","20110405090024","PC","AAA03","2","34000","6000","28000","2011-04-05 09:00:24"
"12327","15","20110405061810","PC","AAA01","4","40000","8000","32000","2011-04-05 06:18:10"
"12328","35","20110404070800","Mobile","AAA05","2","120000","40000","80000","2011-04-04 19:08:00"
"12329","47","20110404020245","PC","AAA02","5","75000","11500","63500","2011-04-04 14:02:45"
"12330","27","20110404110935","Shop","AAA02","4","60000","9200","50800","2011-04-04 11:09:35"
"12331","36","20110404091322","Shop","AAA03","4","68000","12000","56000","2011-04-04 09:13:22"
"12332","56","20110330092953","Shop","AAA05","4","240000","80000","160000","2011-03-30 21:29:53"
"12333","81","20110330014055","Mobile","AAA04","4","32000","1600","30400","2011-03-30 13:40:55"
"12334","63","20110330010651","Shop","AAA03","1","17000","3000","14000","2011-03-30 13:06:51"
"12335","4","20110330104758","Mobile","AAA04","1","8000","400","7600","2011-03-30 10:47:58"
"12336","99","20110329035446","Mobile","AAA02","1","15000","2300","12700","2011-03-29 15:54:46"
"12337","73","20110329024510","Mobile","AAA02","6","90000","13800","76200","2011-03-29 14:45:10"
"12338","39","20110329120426","Shop","AAA04","1","8000","400","7600","2011-03-29 12:04:26"
"12339","21","20110329101813","Shop","AAA04","2","16000","800","15200","2011-03-29 10:18:13"
"12340","60","20110329084632","Shop","AAA02","1","15000","2300","12700","2011-03-29 08:46:32"
"12341","81","20110329071904","PC","AAA04","2","16000","800","15200","2011-03-29 07:19:04"
"12342","63","20110328071625","PC","AAA05","3","180000","60000","120000","2011-03-28 19:16:25"
"12343","2","20110328015541","PC","AAA02","2","30000","4600","25400","2011-03-28 13:55:41"
"12344","82","20110328114201","PC","AAA01","1","10000","2000","8000","2011-03-28 11:42:01"
"12345","72","20110328093711","Shop","AAA03","4","68000","12000","56000","2011-03-28 09:37:11"
"12346","17","20110321020234","PC","AAA03","1","17000","3000","14000","2011-03-21 14:02:34"
"12347","56","20110321124805","Mobile","AAA01","2","20000","4000","16000","2011-03-21 12:48:05"
"12348","90","20110321100314","Shop","AAA03","1","17000","3000","14000","2011-03-21 10:03:14"
"12349","49","20110321070148","Shop","AAA05","1","60000","20000","40000","2011-03-21 07:01:48"
"12350","31","20110316103056","Mobile","AAA02","1","15000","2300","12700","2011-03-16 10:30:56"
"12351","3","20110316084635","Shop","AAA04","7","56000","2800","53200","2011-03-16 08:46:35"
"12352","67","20110316063456","Mobile","AAA03","2","34000","6000","28000","2011-03-16 06:34:56"
"12353","52","20110315120035","Shop","AAA01","1","10000","2000","8000","2011-03-15 12:00:35"
"12354","81","20110315084749","Shop","AAA05","3","180000","60000","120000","2011-03-15 08:47:49"
"12355","47","20110315074921","Shop","AAA04","2","16000","800","15200","2011-03-15 07:49:21"
"12356","13","20110314105128","Mobile","AAA03","1","17000","3000","14000","2011-03-14 10:51:28"
"12357","80","20110314092450","Mobile","AAA05","1","60000","20000","40000","2011-03-14 09:24:50"
"12358","94","20110309075434","PC","AAA05","6","360000","120000","240000","2011-03-09 07:54:34"
"12359","88","20110308121528","Shop","AAA02","1","15000","2300","12700","2011-03-08 12:15:28"
"12360","65","20110308103414","PC","AAA03","2","34000","6000","28000","2011-03-08 10:34:14"
"12361","15","20110308085255","Shop","AAA03","6","102000","18000","84000","2011-03-08 08:52:55"
"12362","90","20110308064032","PC","AAA03","2","34000","6000","28000","2011-03-08 06:40:32"
"12363","4","20110307022612","Shop","AAA03","3","51000","9000","42000","2011-03-07 02:26:12"
"12364","13","20110305042347","Shop","AAA02","3","45000","6900","38100","2011-03-05 16:23:47"
"12365","68","20110304122743","PC","AAA01","3","30000","6000","24000","2011-03-04 00:27:43"
"12366","27","20110301062306","Mobile","AAA04","3","24000","1200","22800","2011-03-01 06:23:06"
"12367","29","20110228122516","Mobile","AAA01","4","40000","8000","32000","2011-02-28 12:25:16"
"12368","11","20110228092756","Mobile","AAA04","3","24000","1200","22800","2011-02-28 09:27:56"
"12369","42","20110226101112","Shop","AAA01","4","40000","8000","32000","2011-02-26 10:11:12"
"12370","79","20110225112549","PC","AAA01","1","10000","2000","8000","2011-02-25 11:25:49"
"12371","21","20110225101535","Shop","AAA01","2","20000","4000","16000","2011-02-25 10:15:35"
"12372","10","20110225084704","PC","AAA04","2","16000","800","15200","2011-02-25 08:47:04"
"12373","90","20110225072134","PC","AAA02","1","15000","2300","12700","2011-02-25 07:21:34"
"12374","60","20110224081830","Shop","AAA03","1","17000","3000","14000","2011-02-24 08:18:30"
"12375","14","20110224071428","Shop","AAA01","3","30000","6000","24000","2011-02-24 07:14:28"
"12376","54","20110223063452","Mobile","AAA02","1","15000","2300","12700","2011-02-23 18:34:52"
"12377","33","20110223022119","PC","AAA05","1","60000","20000","40000","2011-02-23 14:21:19"
"12378","83","20110223125350","PC","AAA03","3","51000","9000","42000","2011-02-23 12:53:50"
"12379","70","20110223111624","PC","AAA05","5","300000","100000","200000","2011-02-23 11:16:24"
"12380","2","20110223100621","Shop","AAA04","2","16000","800","15200","2011-02-23 10:06:21"
"12381","49","20110222014116","Mobile","AAA02","1","15000","2300","12700","2011-02-22 13:41:16"
"12382","97","20110222113112","PC","AAA03","1","17000","3000","14000","2011-02-22 11:31:12"
"12383","64","20110222100001","PC","AAA02","2","30000","4600","25400","2011-02-22 10:00:01"
"12384","2","20110222072927","Shop","AAA04","1","8000","400","7600","2011-02-22 07:29:27"
"12385","23","20110221011259","Shop","AAA04","2","16000","800","15200","2011-02-21 13:12:59"
"12386","36","20110221100917","Mobile","AAA03","3","51000","9000","42000","2011-02-21 10:09:17"
"12387","48","20110216012441","Shop","AAA03","3","51000","9000","42000","2011-02-16 01:24:41"
"12388","66","20110215085213","PC","AAA04","1","8000","400","7600","2011-02-15 08:52:13"
"12389","18","20110215062822","Shop","AAA02","2","30000","4600","25400","2011-02-15 06:28:22"
"12390","99","20110214081546","Shop","AAA05","2","120000","40000","80000","2011-02-14 20:15:46"
"12391","8","20110214024056","Mobile","AAA03","1","17000","3000","14000","2011-02-14 14:40:56"
"12392","94","20110214125529","PC","AAA01","7","70000","14000","56000","2011-02-14 12:55:29"
"12393","21","20110214121722","Shop","AAA01","4","40000","8000","32000","2011-02-14 12:17:22"
"12394","71","20110210024915","Mobile","AAA05","2","120000","40000","80000","2011-02-10 14:49:15"
"12395","46","20110210103411","Mobile","AAA05","3","180000","60000","120000","2011-02-10 10:34:11"
"12396","98","20110210073805","Shop","AAA04","1","8000","400","7600","2011-02-10 07:38:05"
"12397","45","20110209035210","PC","AAA05","2","120000","40000","80000","2011-02-09 03:52:10"
"12398","93","20110208115834","Mobile","AAA03","2","34000","6000","28000","2011-02-08 11:58:34"
"12399","80","20110208102537","PC","AAA04","1","8000","400","7600","2011-02-08 10:25:37"
"12400","40","20110208081722","Shop","AAA02","1","15000","2300","12700","2011-02-08 08:17:22"
"12401","86","20110207123217","Mobile","AAA02","2","30000","4600","25400","2011-02-07 12:32:17"
"12402","50","20110207101126","Shop","AAA04","5","40000","2000","38000","2011-02-07 10:11:26"
"12403","20","20110207092215","Mobile","AAA01","2","20000","4000","16000","2011-02-07 09:22:15"
"12404","22","20110202112755","PC","AAA04","1","8000","400","7600","2011-02-02 11:27:55"
"12405","99","20110202091729","Mobile","AAA03","1","17000","3000","14000","2011-02-02 09:17:29"
"12406","55","20110201104111","PC","AAA05","2","120000","40000","80000","2011-02-01 10:41:11"
"12407","67","20110201092902","PC","AAA04","5","40000","2000","38000","2011-02-01 09:29:02"
"12408","15","20110201080931","Shop","AAA01","3","30000","6000","24000","2011-02-01 08:09:31"
"12409","32","20110131090818","Shop","AAA05","4","240000","80000","160000","2011-01-31 09:08:18"
"12410","36","20110126074110","PC","AAA02","3","45000","6900","38100","2011-01-26 07:41:10"
"12411","47","20110125014859","Shop","AAA02","4","60000","9200","50800","2011-01-25 13:48:59"
"12412","12","20110125095631","PC","AAA03","2","34000","6000","28000","2011-01-25 09:56:31"
"12413","54","20110125083308","PC","AAA04","2","16000","800","15200","2011-01-25 08:33:08"
"12414","18","20110125073829","PC","AAA03","2","34000","6000","28000","2011-01-25 07:38:29"
"12415","45","20110124082555","PC","AAA03","3","51000","9000","42000","2011-01-24 20:25:55"
"12416","16","20110124021837","Mobile","AAA04","4","32000","1600","30400","2011-01-24 14:18:37"
"12417","93","20110124114012","PC","AAA01","1","10000","2000","8000","2011-01-24 11:40:12"
"12418","54","20110124111046","Mobile","AAA02","2","30000","4600","25400","2011-01-24 11:10:46"
"12419","27","20110124101222","Mobile","AAA04","1","8000","400","7600","2011-01-24 10:12:22"
"12420","100","20110124091648","Shop","AAA01","1","10000","2000","8000","2011-01-24 09:16:48"
"12421","65","20110122114630","PC","AAA01","3","30000","6000","24000","2011-01-22 11:46:30"
"12422","90","20110121123150","PC","AAA01","1","10000","2000","8000","2011-01-21 12:31:50"
"12423","95","20110121105400","Mobile","AAA02","1","15000","2300","12700","2011-01-21 10:54:00"
"12424","15","20110121091203","Mobile","AAA02","7","105000","16100","88900","2011-01-21 09:12:03"
"12425","61","20110121071034","PC","AAA04","1","8000","400","7600","2011-01-21 07:10:34"
"12426","79","20110120045317","Shop","AAA01","2","20000","4000","16000","2011-01-20 16:53:17"
"12427","91","20110120035342","Shop","AAA01","1","10000","2000","8000","2011-01-20 15:53:42"
"12428","43","20110120012329","Shop","AAA02","1","15000","2300","12700","2011-01-20 13:23:29"
"12429","86","20110120105414","Shop","AAA01","1","10000","2000","8000","2011-01-20 10:54:14"
"12430","51","20110120093924","PC","AAA05","2","120000","40000","80000","2011-01-20 09:39:24"
"12431","31","20110120071958","Mobile","AAA05","1","60000","20000","40000","2011-01-20 07:19:58"
"12432","48","20110119023655","Mobile","AAA02","3","45000","6900","38100","2011-01-19 14:36:55"
"12433","71","20110119020105","PC","AAA01","1","10000","2000","8000","2011-01-19 14:01:05"
"12434","68","20110119124808","Shop","AAA05","1","60000","20000","40000","2011-01-19 12:48:08"
"12435","10","20110119112015","Mobile","AAA03","3","51000","9000","42000","2011-01-19 11:20:15"
"12436","12","20110119073417","Shop","AAA02","2","30000","4600","25400","2011-01-19 07:34:17"
"12437","85","20110118024934","PC","AAA01","6","60000","12000","48000","2011-01-18 14:49:34"
"12438","50","20110118013843","Mobile","AAA04","4","32000","1600","30400","2011-01-18 13:38:43"
"12439","55","20110118112332","Shop","AAA02","1","15000","2300","12700","2011-01-18 11:23:32"
"12440","36","20110118090958","Mobile","AAA05","9","540000","180000","360000","2011-01-18 09:09:58"
"12441","68","20110118080432","Mobile","AAA05","1","60000","20000","40000","2011-01-18 08:04:32"
"12442","40","20110117033608","Mobile","AAA02","3","45000","6900","38100","2011-01-17 15:36:08"
"12443","57","20110117012557","PC","AAA01","3","30000","6000","24000","2011-01-17 13:25:57"
"12444","3","20110117124856","Mobile","AAA04","4","32000","1600","30400","2011-01-17 12:48:56"
"12445","33","20110117091448","Shop","AAA05","2","120000","40000","80000","2011-01-17 09:14:48"
"12446","87","20110113045424","PC","AAA02","4","60000","9200","50800","2011-01-13 04:54:24"
"12447","45","20110112070555","Mobile","AAA01","1","10000","2000","8000","2011-01-12 07:05:55"
"12448","94","20110111095559","PC","AAA02","3","45000","6900","38100","2011-01-11 09:55:59"
"12449","23","20110111083337","Shop","AAA02","3","45000","6900","38100","2011-01-11 08:33:37"
"12450","37","20110111063959","PC","AAA01","1","10000","2000","8000","2011-01-11 06:39:59"
"12451","93","20110106065330","Shop","AAA02","3","45000","6900","38100","2011-01-06 06:53:30"
"12452","28","20110105031957","Mobile","AAA04","1","8000","400","7600","2011-01-05 15:19:57"
"12453","8","20110105013236","Mobile","AAA01","4","40000","8000","32000","2011-01-05 13:32:36"
"12454","8","20110105122611","Mobile","AAA04","6","48000","2400","45600","2011-01-05 12:26:11"
"12455","74","20110105110114","Mobile","AAA01","1","10000","2000","8000","2011-01-05 11:01:14"
"12456","78","20110105055305","Shop","AAA01","1","10000","2000","8000","2011-01-05 05:53:05"
"12457","63","20110104015236","Shop","AAA05","1","60000","20000","40000","2011-01-04 13:52:36"
"12458","73","20110104010130","PC","AAA04","4","32000","1600","30400","2011-01-04 13:01:30"
"12459","51","20110104103522","Mobile","AAA02","3","45000","6900","38100","2011-01-04 10:35:22"
"12460","15","20110104083446","Mobile","AAA05","6","360000","120000","240000","2011-01-04 08:34:46"
"12461","46","20110103084831","Shop","AAA02","1","15000","2300","12700","2011-01-03 08:48:31"
"12462","70","20101228065653","Shop","AAA02","2","30000","4600","25400","2010-12-28 18:56:53"
"12463","18","20101228065442","Shop","AAA04","1","8000","400","7600","2010-12-28 18:54:42"
"12464","58","20101228030710","PC","AAA03","1","17000","3000","14000","2010-12-28 15:07:10"
"12465","13","20101228114027","Shop","AAA02","1","15000","2300","12700","2010-12-28 11:40:27"
"12466","44","20101228094536","Shop","AAA01","1","10000","2000","8000","2010-12-28 09:45:36"
"12467","97","20101228074031","Mobile","AAA03","2","34000","6000","28000","2010-12-28 07:40:31"
"12468","10","20101227064814","Shop","AAA03","1","17000","3000","14000","2010-12-27 18:48:14"
"12469","39","20101227105608","Shop","AAA03","1","17000","3000","14000","2010-12-27 10:56:08"
"12470","7","20101227100533","Mobile","AAA01","2","20000","4000","16000","2010-12-27 10:05:33"
"12471","74","20101227073826","Mobile","AAA01","2","20000","4000","16000","2010-12-27 07:38:26"
"12472","57","20101220085639","Shop","AAA01","1","10000","2000","8000","2010-12-20 20:56:39"
"12473","33","20101220050721","Shop","AAA01","2","20000","4000","16000","2010-12-20 17:07:21"
"12474","76","20101220025633","PC","AAA04","1","8000","400","7600","2010-12-20 14:56:33"
"12475","74","20101220015550","PC","AAA05","3","180000","60000","120000","2010-12-20 13:55:50"
"12476","58","20101220123209","PC","AAA04","1","8000","400","7600","2010-12-20 12:32:09"
"12477","5","20101220105222","Mobile","AAA04","1","8000","400","7600","2010-12-20 10:52:22"
"12478","16","20101220092829","Shop","AAA04","1","8000","400","7600","2010-12-20 09:28:29"
"12479","50","20101217021226","Shop","AAA05","1","60000","20000","40000","2010-12-17 14:12:26"
"12480","45","20101217102443","Shop","AAA05","1","60000","20000","40000","2010-12-17 10:24:43"
"12481","10","20101217071208","Shop","AAA02","2","30000","4600","25400","2010-12-17 07:12:08"
"12482","34","20101216075125","Mobile","AAA03","1","17000","3000","14000","2010-12-16 19:51:25"
"12483","97","20101216010702","Mobile","AAA05","2","120000","40000","80000","2010-12-16 13:07:02"
"12484","47","20101216120636","Mobile","AAA02","1","15000","2300","12700","2010-12-16 12:06:36"
"12485","32","20101216080139","PC","AAA01","4","40000","8000","32000","2010-12-16 08:01:39"
"12486","87","20101215090942","PC","AAA01","2","20000","4000","16000","2010-12-15 09:09:42"
"12487","81","20101214010600","Shop","AAA03","3","51000","9000","42000","2010-12-14 13:06:00"
"12488","56","20101214120829","Shop","AAA05","1","60000","20000","40000","2010-12-14 12:08:29"
"12489","5","20101214105308","Mobile","AAA01","2","20000","4000","16000","2010-12-14 10:53:08"
"12490","39","20101214074136","PC","AAA04","2","16000","800","15200","2010-12-14 07:41:36"
"12491","70","20101214033249","Mobile","AAA04","1","8000","400","7600","2010-12-14 03:32:49"
"12492","20","20101213102642","Mobile","AAA04","1","8000","400","7600","2010-12-13 10:26:42"
"12493","33","20101213083811","PC","AAA02","1","15000","2300","12700","2010-12-13 08:38:11"
"12494","59","20101208084419","PC","AAA05","2","120000","40000","80000","2010-12-08 08:44:19"
"12495","79","20101208061202","PC","AAA02","2","30000","4600","25400","2010-12-08 06:12:02"
"12496","93","20101207013758","Shop","AAA01","2","20000","4000","16000","2010-12-07 13:37:58"
"12497","97","20101207111112","PC","AAA05","1","60000","20000","40000","2010-12-07 11:11:12"
"12498","27","20101207093733","Mobile","AAA03","3","51000","9000","42000","2010-12-07 09:37:33"
"12499","78","20101206044836","Shop","AAA05","1","60000","20000","40000","2010-12-06 16:48:36"
"12500","63","20101206032233","Mobile","AAA02","1","15000","2300","12700","2010-12-06 15:22:33"
"12501","25","20101206121108","Shop","AAA01","1","10000","2000","8000","2010-12-06 12:11:08"
"12502","7","20101206084948","PC","AAA05","1","60000","20000","40000","2010-12-06 08:49:48"
"12503","85","20101130102717","PC","AAA04","1","8000","400","7600","2010-11-30 10:27:17"
"12504","54","20101130092830","Mobile","AAA02","1","15000","2300","12700","2010-11-30 09:28:30"
"12505","27","20101130064112","PC","AAA04","1","8000","400","7600","2010-11-30 06:41:12"
"12506","27","20101129105250","Shop","AAA01","4","40000","8000","32000","2010-11-29 10:52:50"
"12507","89","20101129090509","Shop","AAA05","2","120000","40000","80000","2010-11-29 09:05:09"
"12508","94","20101124044548","Shop","AAA05","3","180000","60000","120000","2010-11-24 04:45:48"
"12509","86","20101123062750","Mobile","AAA04","2","16000","800","15200","2010-11-23 18:27:50"
"12510","95","20101123021216","PC","AAA03","1","17000","3000","14000","2010-11-23 14:12:16"
"12511","21","20101123125821","PC","AAA04","2","16000","800","15200","2010-11-23 12:58:21"
"12512","36","20101123112044","Mobile","AAA05","3","180000","60000","120000","2010-11-23 11:20:44"
"12513","36","20101123091558","Shop","AAA05","4","240000","80000","160000","2010-11-23 09:15:58"
"12514","18","20101122031339","PC","AAA05","4","240000","80000","160000","2010-11-22 15:13:39"
"12515","55","20101122014026","Shop","AAA03","6","102000","18000","84000","2010-11-22 13:40:26"
"12516","2","20101122114252","PC","AAA01","2","20000","4000","16000","2010-11-22 11:42:52"
"12517","17","20101122102339","Mobile","AAA04","1","8000","400","7600","2010-11-22 10:23:39"
"12518","14","20101122101300","Mobile","AAA03","1","17000","3000","14000","2010-11-22 10:13:00"
"12519","27","20101122080428","PC","AAA03","4","68000","12000","56000","2010-11-22 08:04:28"
"12520","78","20101118074336","Mobile","AAA05","2","120000","40000","80000","2010-11-18 19:43:36"
"12521","12","20101118122916","Mobile","AAA03","1","17000","3000","14000","2010-11-18 12:29:16"
"12522","17","20101118092916","Mobile","AAA02","1","15000","2300","12700","2010-11-18 09:29:16"
"12523","4","20101118081356","Mobile","AAA05","1","60000","20000","40000","2010-11-18 08:13:56"
"12524","87","20101117061436","Shop","AAA04","2","16000","800","15200","2010-11-17 18:14:36"
"12525","39","20101117122234","Mobile","AAA04","1","8000","400","7600","2010-11-17 12:22:34"
"12526","62","20101117105431","Shop","AAA03","1","17000","3000","14000","2010-11-17 10:54:31"
"12527","55","20101117083250","Mobile","AAA02","2","30000","4600","25400","2010-11-17 08:32:50"
"12528","10","20101116063259","Shop","AAA05","2","120000","40000","80000","2010-11-16 06:32:59"
"12529","83","20101115014254","Shop","AAA05","2","120000","40000","80000","2010-11-15 13:42:54"
"12530","6","20101115102752","Mobile","AAA02","1","15000","2300","12700","2010-11-15 10:27:52"
"12531","95","20101115080515","PC","AAA05","4","240000","80000","160000","2010-11-15 08:05:15"
"12532","51","20101109054232","Shop","AAA04","2","16000","800","15200","2010-11-09 17:42:32"
"12533","62","20101109022731","Shop","AAA05","1","60000","20000","40000","2010-11-09 14:27:31"
"12534","88","20101109103645","PC","AAA02","2","30000","4600","25400","2010-11-09 10:36:45"
"12535","37","20101109093104","Shop","AAA05","2","120000","40000","80000","2010-11-09 09:31:04"
"12536","14","20101109081705","Shop","AAA04","2","16000","800","15200","2010-11-09 08:17:05"
"12537","13","20101109065024","PC","AAA01","1","10000","2000","8000","2010-11-09 06:50:24"
"12538","99","20101108010203","Shop","AAA01","1","10000","2000","8000","2010-11-08 13:02:03"
"12539","25","20101108103539","Mobile","AAA05","4","240000","80000","160000","2010-11-08 10:35:39"
"12540","48","20101108085848","PC","AAA02","2","30000","4600","25400","2010-11-08 08:58:48"
"12541","44","20101103042010","Shop","AAA04","1","8000","400","7600","2010-11-03 16:20:10"
"12542","94","20101103123126","PC","AAA01","1","10000","2000","8000","2010-11-03 12:31:26"
"12543","22","20101103104458","Mobile","AAA03","1","17000","3000","14000","2010-11-03 10:44:58"
"12544","70","20101103071920","Mobile","AAA05","1","60000","20000","40000","2010-11-03 07:19:20"
"12545","13","20101102012957","Shop","AAA02","1","15000","2300","12700","2010-11-02 13:29:57"
"12546","99","20101102110210","PC","AAA02","1","15000","2300","12700","2010-11-02 11:02:10"
"12547","52","20101102084617","PC","AAA01","1","10000","2000","8000","2010-11-02 08:46:17"
"12548","38","20101102075544","Mobile","AAA04","2","16000","800","15200","2010-11-02 07:55:44"
"12549","83","20101101065359","PC","AAA03","4","68000","12000","56000","2010-11-01 18:53:59"
"12550","75","20101101023159","Shop","AAA05","2","120000","40000","80000","2010-11-01 14:31:59"
"12551","38","20101101120235","Shop","AAA01","1","10000","2000","8000","2010-11-01 12:02:35"
"12552","6","20101101092612","Shop","AAA02","1","15000","2300","12700","2010-11-01 09:26:12"
"12553","80","20101027062223","PC","AAA03","1","17000","3000","14000","2010-10-27 06:22:23"
"12554","12","20101025065422","PC","AAA01","1","10000","2000","8000","2010-10-25 18:54:22"
"12555","42","20101025030946","PC","AAA04","1","8000","400","7600","2010-10-25 15:09:46"
"12556","68","20101025015749","Shop","AAA04","1","8000","400","7600","2010-10-25 13:57:49"
"12557","37","20101025124451","Mobile","AAA02","4","60000","9200","50800","2010-10-25 12:44:51"
"12558","84","20101025110923","Shop","AAA04","1","8000","400","7600","2010-10-25 11:09:23"
"12559","27","20101025083619","PC","AAA02","5","75000","11500","63500","2010-10-25 08:36:19"
"12560","91","20101022011120","Shop","AAA05","2","120000","40000","80000","2010-10-22 13:11:20"
"12561","45","20101022091916","Shop","AAA01","1","10000","2000","8000","2010-10-22 09:19:16"
"12562","10","20101022063823","Mobile","AAA03","1","17000","3000","14000","2010-10-22 06:38:23"
"12563","95","20101021074425","Mobile","AAA04","1","8000","400","7600","2010-10-21 07:44:25"
"12564","74","20101020072002","Shop","AAA02","1","15000","2300","12700","2010-10-20 19:20:02"
"12565","16","20101020124825","Shop","AAA04","4","32000","1600","30400","2010-10-20 12:48:25"
"12566","32","20101020110728","PC","AAA02","1","15000","2300","12700","2010-10-20 11:07:28"
"12567","44","20101020090028","Shop","AAA02","2","30000","4600","25400","2010-10-20 09:00:28"
"12568","9","20101020071539","Mobile","AAA03","1","17000","3000","14000","2010-10-20 07:15:39"
"12569","80","20101019015009","PC","AAA04","1","8000","400","7600","2010-10-19 13:50:09"
"12570","83","20101019113219","Shop","AAA05","1","60000","20000","40000","2010-10-19 11:32:19"
"12571","80","20101019093536","Mobile","AAA01","1","10000","2000","8000","2010-10-19 09:35:36"
"12572","53","20101019075209","PC","AAA01","1","10000","2000","8000","2010-10-19 07:52:09"
"12573","25","20101018104506","PC","AAA05","1","60000","20000","40000","2010-10-18 22:45:06"
"12574","51","20101018101639","PC","AAA04","1","8000","400","7600","2010-10-18 22:16:39"
"12575","95","20101018055727","PC","AAA04","2","16000","800","15200","2010-10-18 17:57:27"
"12576","3","20101018120444","Shop","AAA02","2","30000","4600","25400","2010-10-18 12:04:44"
"12577","30","20101018101950","Shop","AAA03","3","51000","9000","42000","2010-10-18 10:19:50"
"12578","61","20101018091420","PC","AAA02","1","15000","2300","12700","2010-10-18 09:14:20"
"12579","97","20101012090642","Shop","AAA02","1","15000","2300","12700","2010-10-12 09:06:42"
"12580","95","20101012074650","PC","AAA04","1","8000","400","7600","2010-10-12 07:46:50"
"12581","94","20101011030514","Mobile","AAA02","7","105000","16100","88900","2010-10-11 15:05:14"
"12582","64","20101011021239","Mobile","AAA01","4","40000","8000","32000","2010-10-11 14:12:39"
"12583","38","20101011124615","Shop","AAA02","1","15000","2300","12700","2010-10-11 12:46:15"
"12584","46","20101011081847","Shop","AAA02","4","60000","9200","50800","2010-10-11 08:18:47"
"12585","66","20101008070651","Shop","AAA04","3","24000","1200","22800","2010-10-08 07:06:51"
"12586","23","20101007125420","Mobile","AAA01","1","10000","2000","8000","2010-10-07 12:54:20"
"12587","83","20101007092109","Mobile","AAA04","1","8000","400","7600","2010-10-07 09:21:09"
"12588","92","20101006112855","Mobile","AAA05","2","120000","40000","80000","2010-10-06 11:28:55"
"12589","96","20101006094541","PC","AAA05","1","60000","20000","40000","2010-10-06 09:45:41"
"12590","61","20101006092910","Mobile","AAA05","1","60000","20000","40000","2010-10-06 09:29:10"
"12591","34","20101006081553","Mobile","AAA05","1","60000","20000","40000","2010-10-06 08:15:53"
"12592","72","20101006064154","Shop","AAA05","1","60000","20000","40000","2010-10-06 06:41:54"
"12593","98","20101005062642","Mobile","AAA02","1","15000","2300","12700","2010-10-05 18:26:42"
"12594","3","20101005043646","Shop","AAA02","2","30000","4600","25400","2010-10-05 16:36:46"
"12595","45","20101005025358","Shop","AAA03","1","17000","3000","14000","2010-10-05 14:53:58"
"12596","79","20101005125330","PC","AAA03","2","34000","6000","28000","2010-10-05 12:53:30"
"12597","53","20101005104832","PC","AAA03","1","17000","3000","14000","2010-10-05 10:48:32"
"12598","37","20101005092027","Mobile","AAA04","1","8000","400","7600","2010-10-05 09:20:27"
"12599","79","20101005072736","Shop","AAA02","1","15000","2300","12700","2010-10-05 07:27:36"
"12600","62","20101004042417","Mobile","AAA05","1","60000","20000","40000","2010-10-04 16:24:17"
"12601","28","20101004025246","Mobile","AAA05","4","240000","80000","160000","2010-10-04 14:52:46"
"12602","15","20101004010216","PC","AAA05","4","240000","80000","160000","2010-10-04 13:02:16"
"12603","26","20101004111052","Mobile","AAA03","1","17000","3000","14000","2010-10-04 11:10:52"
"12604","64","20101004094521","PC","AAA04","2","16000","800","15200","2010-10-04 09:45:21"
"12605","15","20100929014602","Mobile","AAA02","6","90000","13800","76200","2010-09-29 13:46:02"
"12606","66","20100929115054","Mobile","AAA02","4","60000","9200","50800","2010-09-29 11:50:54"
"12607","94","20100929103938","PC","AAA01","1","10000","2000","8000","2010-09-29 10:39:38"
"12608","53","20100929092725","Shop","AAA05","1","60000","20000","40000","2010-09-29 09:27:25"
"12609","85","20100929061325","Mobile","AAA05","2","120000","40000","80000","2010-09-29 06:13:25"
"12610","54","20100928053551","Shop","AAA01","2","20000","4000","16000","2010-09-28 17:35:51"
"12611","55","20100928035054","PC","AAA02","2","30000","4600","25400","2010-09-28 15:50:54"
"12612","15","20100928022526","PC","AAA02","5","75000","11500","63500","2010-09-28 14:25:26"
"12613","12","20100928010820","PC","AAA04","2","16000","800","15200","2010-09-28 13:08:20"
"12614","57","20100928085303","Shop","AAA02","1","15000","2300","12700","2010-09-28 08:53:03"
"12615","2","20100928062347","Shop","AAA03","2","34000","6000","28000","2010-09-28 06:23:47"
"12616","18","20100927125212","PC","AAA01","1","10000","2000","8000","2010-09-27 12:52:12"
"12617","71","20100927104849","PC","AAA02","1","15000","2300","12700","2010-09-27 10:48:49"
"12618","65","20100922051803","Mobile","AAA05","2","120000","40000","80000","2010-09-22 05:18:03"
"12619","40","20100921050430","PC","AAA03","1","17000","3000","14000","2010-09-21 17:04:30"
"12620","84","20100921015927","Mobile","AAA03","1","17000","3000","14000","2010-09-21 13:59:27"
"12621","28","20100921102153","Shop","AAA04","1","8000","400","7600","2010-09-21 10:21:53"
"12622","89","20100921092121","Shop","AAA05","3","180000","60000","120000","2010-09-21 09:21:21"
"12623","42","20100921074947","PC","AAA03","3","51000","9000","42000","2010-09-21 07:49:47"
"12624","70","20100921123126","Mobile","AAA05","5","300000","100000","200000","2010-09-21 00:31:26"
"12625","69","20100920105000","Mobile","AAA04","1","8000","400","7600","2010-09-20 10:50:00"
"12626","67","20100920084256","PC","AAA05","4","240000","80000","160000","2010-09-20 08:42:56"
"12627","41","20100916091936","Shop","AAA02","3","45000","6900","38100","2010-09-16 09:19:36"
"12628","68","20100916081612","PC","AAA05","1","60000","20000","40000","2010-09-16 08:16:12"
"12629","93","20100915040855","Mobile","AAA04","2","16000","800","15200","2010-09-15 16:08:55"
"12630","67","20100915022835","Mobile","AAA01","2","20000","4000","16000","2010-09-15 14:28:35"
"12631","82","20100915124153","Mobile","AAA02","1","15000","2300","12700","2010-09-15 12:41:53"
"12632","6","20100915085342","Mobile","AAA05","1","60000","20000","40000","2010-09-15 08:53:42"
"12633","52","20100915055208","PC","AAA02","2","30000","4600","25400","2010-09-15 05:52:08"
"12634","57","20100914105339","PC","AAA01","2","20000","4000","16000","2010-09-14 10:53:39"
"12635","73","20100914091951","Mobile","AAA05","4","240000","80000","160000","2010-09-14 09:19:51"
"12636","57","20100914065211","PC","AAA05","2","120000","40000","80000","2010-09-14 06:52:11"
"12637","85","20100910031922","Shop","AAA01","1","10000","2000","8000","2010-09-10 03:19:22"
"12638","84","20100909025009","Shop","AAA05","1","60000","20000","40000","2010-09-09 02:50:09"
"12639","23","20100908011057","Shop","AAA01","1","10000","2000","8000","2010-09-08 13:10:57"
"12640","13","20100908114922","Mobile","AAA01","2","20000","4000","16000","2010-09-08 11:49:22"
"12641","62","20100908083754","PC","AAA05","2","120000","40000","80000","2010-09-08 08:37:54"
"12642","20","20100908071026","Mobile","AAA01","1","10000","2000","8000","2010-09-08 07:10:26"
"12643","54","20100907040037","Mobile","AAA02","2","30000","4600","25400","2010-09-07 16:00:37"
"12644","35","20100907012940","Mobile","AAA03","1","17000","3000","14000","2010-09-07 13:29:40"
"12645","5","20100907120435","PC","AAA04","1","8000","400","7600","2010-09-07 12:04:35"
"12646","38","20100907103223","PC","AAA01","1","10000","2000","8000","2010-09-07 10:32:23"
"12647","59","20100906091337","PC","AAA03","2","34000","6000","28000","2010-09-06 09:13:37"
"12648","53","20100902092427","Mobile","AAA05","1","60000","20000","40000","2010-09-02 09:24:27"
"12649","4","20100831062302","Shop","AAA01","1","10000","2000","8000","2010-08-31 18:23:02"
"12650","51","20100831024040","Shop","AAA02","4","60000","9200","50800","2010-08-31 14:40:40"
"12651","15","20100831011157","PC","AAA02","4","60000","9200","50800","2010-08-31 13:11:57"
"12652","64","20100831110451","Mobile","AAA01","2","20000","4000","16000","2010-08-31 11:04:51"
"12653","20","20100831093803","PC","AAA02","1","15000","2300","12700","2010-08-31 09:38:03"
"12654","95","20100830040706","PC","AAA01","3","30000","6000","24000","2010-08-30 16:07:06"
"12655","85","20100830115043","Shop","AAA04","1","8000","400","7600","2010-08-30 11:50:43"
"12656","34","20100830075922","Shop","AAA02","2","30000","4600","25400","2010-08-30 07:59:22"
"12657","35","20100825031401","Mobile","AAA04","1","8000","400","7600","2010-08-25 03:14:01"
"12658","8","20100824114529","PC","AAA03","4","68000","12000","56000","2010-08-24 11:45:29"
"12659","57","20100824100639","PC","AAA01","1","10000","2000","8000","2010-08-24 10:06:39"
"12660","21","20100823113857","Mobile","AAA02","4","60000","9200","50800","2010-08-23 11:38:57"
"12661","87","20100823095148","PC","AAA05","1","60000","20000","40000","2010-08-23 09:51:48"
"12662","83","20100819074202","Mobile","AAA03","1","17000","3000","14000","2010-08-19 07:42:02"
"12663","12","20100818055845","PC","AAA01","1","10000","2000","8000","2010-08-18 17:58:45"
"12664","9","20100818041446","PC","AAA05","1","60000","20000","40000","2010-08-18 16:14:46"
"12665","46","20100818031318","Mobile","AAA05","1","60000","20000","40000","2010-08-18 15:13:18"
"12666","11","20100818021142","Shop","AAA03","3","51000","9000","42000","2010-08-18 14:11:42"
"12667","44","20100818125031","PC","AAA05","1","60000","20000","40000","2010-08-18 12:50:31"
"12668","45","20100818091004","PC","AAA05","1","60000","20000","40000","2010-08-18 09:10:04"
"12669","55","20100818070241","PC","AAA02","1","15000","2300","12700","2010-08-18 07:02:41"
"12670","15","20100817094431","Shop","AAA05","4","240000","80000","160000","2010-08-17 09:44:31"
"12671","62","20100817060309","PC","AAA04","3","24000","1200","22800","2010-08-17 06:03:09"
"12672","57","20100816063650","Shop","AAA03","1","17000","3000","14000","2010-08-16 18:36:50"
"12673","86","20100816024252","Mobile","AAA01","1","10000","2000","8000","2010-08-16 14:42:52"
"12674","18","20100816125756","PC","AAA05","2","120000","40000","80000","2010-08-16 12:57:56"
"12675","94","20100816094424","PC","AAA01","1","10000","2000","8000","2010-08-16 09:44:24"
"12676","59","20100813025033","PC","AAA03","3","51000","9000","42000","2010-08-13 02:50:33"
"12677","78","20100812121317","PC","AAA05","1","60000","20000","40000","2010-08-12 12:13:17"
"12678","58","20100812103718","Mobile","AAA04","1","8000","400","7600","2010-08-12 10:37:18"
"12679","87","20100812090437","Shop","AAA04","1","8000","400","7600","2010-08-12 09:04:37"
"12680","17","20100811043936","Shop","AAA03","1","17000","3000","14000","2010-08-11 16:39:36"
"12681","21","20100811022433","Mobile","AAA02","4","60000","9200","50800","2010-08-11 14:24:33"
"12682","29","20100811013304","PC","AAA04","1","8000","400","7600","2010-08-11 13:33:04"
"12683","19","20100811113845","Shop","AAA02","1","15000","2300","12700","2010-08-11 11:38:45"
"12684","96","20100811093421","PC","AAA01","4","40000","8000","32000","2010-08-11 09:34:21"
"12685","37","20100810040523","Shop","AAA05","1","60000","20000","40000","2010-08-10 16:05:23"
"12686","4","20100810015736","PC","AAA04","1","8000","400","7600","2010-08-10 13:57:36"
"12687","16","20100810112543","PC","AAA01","4","40000","8000","32000","2010-08-10 11:25:43"
"12688","26","20100810082338","Mobile","AAA01","1","10000","2000","8000","2010-08-10 08:23:38"
"12689","62","20100810055633","PC","AAA04","1","8000","400","7600","2010-08-10 05:56:33"
"12690","47","20100809020306","PC","AAA03","5","85000","15000","70000","2010-08-09 14:03:06"
"12691","28","20100809111955","PC","AAA01","2","20000","4000","16000","2010-08-09 11:19:55"
"12692","1","20100809090331","Mobile","AAA01","1","10000","2000","8000","2010-08-09 09:03:31"
"12693","94","20100803021231","Mobile","AAA03","1","17000","3000","14000","2010-08-03 14:12:31"
"12694","47","20100803124247","PC","AAA02","1","15000","2300","12700","2010-08-03 12:42:47"
"12695","71","20100803111650","Mobile","AAA03","1","17000","3000","14000","2010-08-03 11:16:50"
"12696","54","20100803102737","Mobile","AAA03","3","51000","9000","42000","2010-08-03 10:27:37"
"12697","28","20100803075031","Mobile","AAA01","1","10000","2000","8000","2010-08-03 07:50:31"
"12698","78","20100802050041","Mobile","AAA01","1","10000","2000","8000","2010-08-02 17:00:41"
"12699","71","20100802025712","PC","AAA04","2","16000","800","15200","2010-08-02 14:57:12"
"12700","77","20100802012936","PC","AAA02","1","15000","2300","12700","2010-08-02 13:29:36"
"12701","34","20100802110257","Shop","AAA05","2","120000","40000","80000","2010-08-02 11:02:57"
"12702","30","20100727084511","Mobile","AAA02","1","15000","2300","12700","2010-07-27 08:45:11"
"12703","21","20100726030527","Shop","AAA02","1","15000","2300","12700","2010-07-26 15:05:27"
"12704","72","20100726013740","Mobile","AAA05","2","120000","40000","80000","2010-07-26 13:37:40"
"12705","74","20100726115143","Mobile","AAA03","4","68000","12000","56000","2010-07-26 11:51:43"
"12706","12","20100726093934","Shop","AAA01","2","20000","4000","16000","2010-07-26 09:39:34"
"12707","68","20100720082936","Shop","AAA05","3","180000","60000","120000","2010-07-20 08:29:36"
"12708","55","20100720070715","Shop","AAA01","3","30000","6000","24000","2010-07-20 07:07:15"
"12709","95","20100719014613","PC","AAA05","2","120000","40000","80000","2010-07-19 13:46:13"
"12710","24","20100719073435","PC","AAA03","2","34000","6000","28000","2010-07-19 07:34:35"
"12711","13","20100715113303","PC","AAA05","1","60000","20000","40000","2010-07-15 11:33:03"
"12712","96","20100715094720","Shop","AAA03","1","17000","3000","14000","2010-07-15 09:47:20"
"12713","88","20100715081018","Mobile","AAA05","1","60000","20000","40000","2010-07-15 08:10:18"
"12714","16","20100714104306","Mobile","AAA04","4","32000","1600","30400","2010-07-14 10:43:06"
"12715","68","20100713074906","PC","AAA01","1","10000","2000","8000","2010-07-13 19:49:06"
"12716","88","20100713045810","Mobile","AAA04","2","16000","800","15200","2010-07-13 16:58:10"
"12717","58","20100713024725","PC","AAA01","1","10000","2000","8000","2010-07-13 14:47:25"
"12718","52","20100713121626","PC","AAA02","1","15000","2300","12700","2010-07-13 12:16:26"
"12719","61","20100713102156","Shop","AAA05","1","60000","20000","40000","2010-07-13 10:21:56"
"12720","92","20100713080449","Mobile","AAA02","4","60000","9200","50800","2010-07-13 08:04:49"
"12721","74","20100713060955","PC","AAA03","1","17000","3000","14000","2010-07-13 06:09:55"
"12722","21","20100712010813","PC","AAA01","3","30000","6000","24000","2010-07-12 13:08:13"
"12723","93","20100712123705","PC","AAA03","1","17000","3000","14000","2010-07-12 12:37:05"
"12724","91","20100712105555","PC","AAA03","1","17000","3000","14000","2010-07-12 10:55:55"
"12725","73","20100712084555","PC","AAA03","4","68000","12000","56000","2010-07-12 08:45:55"
"12726","13","20100707055040","Shop","AAA02","1","15000","2300","12700","2010-07-07 17:50:40"
"12727","99","20100707032837","Mobile","AAA05","1","60000","20000","40000","2010-07-07 15:28:37"
"12728","48","20100707021036","PC","AAA02","1","15000","2300","12700","2010-07-07 14:10:36"
"12729","1","20100707122433","Shop","AAA05","3","180000","60000","120000","2010-07-07 12:24:33"
"12730","6","20100707094039","Shop","AAA05","1","60000","20000","40000","2010-07-07 09:40:39"
"12731","7","20100707084933","Shop","AAA03","1","17000","3000","14000","2010-07-07 08:49:33"
"12732","81","20100707071025","PC","AAA01","1","10000","2000","8000","2010-07-07 07:10:25"
"12733","69","20100706012351","Shop","AAA01","1","10000","2000","8000","2010-07-06 13:23:51"
"12734","9","20100706111211","Shop","AAA02","1","15000","2300","12700","2010-07-06 11:12:11"
"12735","87","20100706092728","PC","AAA05","2","120000","40000","80000","2010-07-06 09:27:28"
"12736","57","20100706084153","Mobile","AAA03","2","34000","6000","28000","2010-07-06 08:41:53"
"12737","34","20100706063139","Mobile","AAA05","3","180000","60000","120000","2010-07-06 06:31:39"
"12738","6","20100706010101","PC","AAA03","2","34000","6000","28000","2010-07-06 01:01:01"
"12739","17","20100705051821","Shop","AAA03","1","17000","3000","14000","2010-07-05 05:18:21"
"12740","84","20100629095025","PC","AAA03","1","17000","3000","14000","2010-06-29 21:50:25"
"12741","61","20100629034336","Shop","AAA02","2","30000","4600","25400","2010-06-29 15:43:36"
"12742","93","20100629023747","Mobile","AAA04","1","8000","400","7600","2010-06-29 14:37:47"
"12743","1","20100629011023","Mobile","AAA01","1","10000","2000","8000","2010-06-29 13:10:23"
"12744","53","20100629120053","PC","AAA05","1","60000","20000","40000","2010-06-29 12:00:53"
"12745","41","20100629110512","PC","AAA05","2","120000","40000","80000","2010-06-29 11:05:12"
"12746","10","20100629092252","Mobile","AAA02","5","75000","11500","63500","2010-06-29 09:22:52"
"12747","2","20100628031324","PC","AAA05","1","60000","20000","40000","2010-06-28 15:13:24"
"12748","17","20100628120808","PC","AAA02","1","15000","2300","12700","2010-06-28 12:08:08"
"12749","29","20100628090717","Shop","AAA03","1","17000","3000","14000","2010-06-28 09:07:17"
"12750","28","20100621053430","PC","AAA05","1","60000","20000","40000","2010-06-21 17:34:30"
"12751","72","20100621035747","Mobile","AAA03","1","17000","3000","14000","2010-06-21 15:57:47"
"12752","75","20100621020206","Mobile","AAA03","2","34000","6000","28000","2010-06-21 14:02:06"
"12753","95","20100621102933","Shop","AAA01","1","10000","2000","8000","2010-06-21 10:29:33"
"12754","98","20100621082437","Shop","AAA01","1","10000","2000","8000","2010-06-21 08:24:37"
"12755","2","20100616122823","Shop","AAA04","1","8000","400","7600","2010-06-16 00:28:23"
"12756","67","20100615032356","Shop","AAA05","4","240000","80000","160000","2010-06-15 15:23:56"
"12757","28","20100615023336","PC","AAA02","3","45000","6900","38100","2010-06-15 14:33:36"
"12758","3","20100615122744","PC","AAA03","4","68000","12000","56000","2010-06-15 12:27:44"
"12759","44","20100615104131","Mobile","AAA02","1","15000","2300","12700","2010-06-15 10:41:31"
"12760","83","20100615122756","Shop","AAA03","3","51000","9000","42000","2010-06-15 00:27:56"
"12761","57","20100614043626","Shop","AAA05","1","60000","20000","40000","2010-06-14 04:36:26"
"12762","22","20100610092757","Mobile","AAA01","3","30000","6000","24000","2010-06-10 09:27:57"
"12763","52","20100610071342","Mobile","AAA03","1","17000","3000","14000","2010-06-10 07:13:42"
"12764","35","20100609054716","Mobile","AAA02","1","15000","2300","12700","2010-06-09 17:47:16"
"12765","70","20100609043558","Shop","AAA03","1","17000","3000","14000","2010-06-09 16:35:58"
"12766","93","20100609020031","PC","AAA03","2","34000","6000","28000","2010-06-09 14:00:31"
"12767","83","20100609113446","PC","AAA05","3","180000","60000","120000","2010-06-09 11:34:46"
"12768","6","20100609100008","PC","AAA05","1","60000","20000","40000","2010-06-09 10:00:08"
"12769","36","20100609074218","PC","AAA02","4","60000","9200","50800","2010-06-09 07:42:18"
"12770","88","20100608055121","PC","AAA04","2","16000","800","15200","2010-06-08 05:51:21"
"12771","81","20100607014642","PC","AAA02","2","30000","4600","25400","2010-06-07 13:46:42"
"12772","42","20100607113035","Mobile","AAA05","2","120000","40000","80000","2010-06-07 11:30:35"
"12773","94","20100607082404","PC","AAA02","1","15000","2300","12700","2010-06-07 08:24:04"
"12774","85","20100604101141","PC","AAA03","1","17000","3000","14000","2010-06-04 10:11:41"
"12775","29","20100604080824","PC","AAA02","2","30000","4600","25400","2010-06-04 08:08:24"
"12776","29","20100604070903","Shop","AAA03","2","34000","6000","28000","2010-06-04 07:09:03"
"12777","95","20100603090313","Shop","AAA02","1","15000","2300","12700","2010-06-03 21:03:13"
"12778","30","20100603011723","Shop","AAA02","2","30000","4600","25400","2010-06-03 13:17:23"
"12779","85","20100603111027","PC","AAA04","2","16000","800","15200","2010-06-03 11:10:27"
"12780","82","20100603075439","Mobile","AAA03","1","17000","3000","14000","2010-06-03 07:54:39"
"12781","63","20100603125022","PC","AAA01","1","10000","2000","8000","2010-06-03 00:50:22"
"12782","37","20100602042352","Shop","AAA05","1","60000","20000","40000","2010-06-02 16:23:52"
"12783","5","20100602023127","Mobile","AAA05","2","120000","40000","80000","2010-06-02 14:31:27"
"12784","69","20100602122128","PC","AAA03","1","17000","3000","14000","2010-06-02 12:21:28"
"12785","92","20100602093219","Mobile","AAA02","2","30000","4600","25400","2010-06-02 09:32:19"
"12786","43","20100602082700","Shop","AAA01","2","20000","4000","16000","2010-06-02 08:27:00"
"12787","27","20100601015450","Mobile","AAA03","3","51000","9000","42000","2010-06-01 01:54:50"
"12788","49","20100531115022","PC","AAA04","1","8000","400","7600","2010-05-31 11:50:22"
"12789","49","20100526082522","Shop","AAA03","2","34000","6000","28000","2010-05-26 08:25:22"
"12790","42","20100525043037","Shop","AAA05","1","60000","20000","40000","2010-05-25 16:30:37"
"12791","49","20100525020735","Mobile","AAA04","1","8000","400","7600","2010-05-25 14:07:35"
"12792","62","20100525122528","Shop","AAA03","2","34000","6000","28000","2010-05-25 12:25:28"
"12793","79","20100525072555","Mobile","AAA02","1","15000","2300","12700","2010-05-25 07:25:55"
"12794","74","20100524013619","Mobile","AAA05","1","60000","20000","40000","2010-05-24 13:36:19"
"12795","66","20100524110725","Mobile","AAA03","1","17000","3000","14000","2010-05-24 11:07:25"
"12796","62","20100524104537","Mobile","AAA04","1","8000","400","7600","2010-05-24 10:45:37"
"12797","89","20100524084721","PC","AAA03","2","34000","6000","28000","2010-05-24 08:47:21"
"12798","89","20100521111650","PC","AAA01","2","20000","4000","16000","2010-05-21 11:16:50"
"12799","52","20100521074854","Shop","AAA01","1","10000","2000","8000","2010-05-21 07:48:54"
"12800","73","20100520072305","PC","AAA05","1","60000","20000","40000","2010-05-20 19:23:05"
"12801","11","20100520021259","PC","AAA02","3","45000","6900","38100","2010-05-20 14:12:59"
"12802","69","20100520125034","Shop","AAA04","1","8000","400","7600","2010-05-20 12:50:34"
"12803","81","20100520122619","Mobile","AAA04","1","8000","400","7600","2010-05-20 12:26:19"
"12804","70","20100520104432","Shop","AAA05","3","180000","60000","120000","2010-05-20 10:44:32"
"12805","76","20100520090314","Mobile","AAA03","1","17000","3000","14000","2010-05-20 09:03:14"
"12806","55","20100519043243","PC","AAA04","3","24000","1200","22800","2010-05-19 16:32:43"
"12807","52","20100519030030","Mobile","AAA05","1","60000","20000","40000","2010-05-19 15:00:30"
"12808","21","20100519110324","PC","AAA05","3","180000","60000","120000","2010-05-19 11:03:24"
"12809","92","20100519105722","Mobile","AAA04","1","8000","400","7600","2010-05-19 10:57:22"
"12810","8","20100519092920","PC","AAA05","2","120000","40000","80000","2010-05-19 09:29:20"
"12811","82","20100519071745","Shop","AAA05","3","180000","60000","120000","2010-05-19 07:17:45"
"12812","30","20100518094630","Shop","AAA05","1","60000","20000","40000","2010-05-18 09:46:30"
"12813","16","20100518075632","Mobile","AAA04","6","48000","2400","45600","2010-05-18 07:56:32"
"12814","26","20100518012332","Mobile","AAA02","1","15000","2300","12700","2010-05-18 01:23:32"
"12815","79","20100517015038","Mobile","AAA02","1","15000","2300","12700","2010-05-17 13:50:38"
"12816","12","20100517121532","PC","AAA02","1","15000","2300","12700","2010-05-17 12:15:32"
"12817","78","20100517100918","PC","AAA02","2","30000","4600","25400","2010-05-17 10:09:18"
"12818","63","20100517075000","Shop","AAA01","1","10000","2000","8000","2010-05-17 07:50:00"
"12819","7","20100512093958","Mobile","AAA02","1","15000","2300","12700","2010-05-12 09:39:58"
"12820","3","20100512080824","Mobile","AAA01","7","70000","14000","56000","2010-05-12 08:08:24"
"12821","87","20100512062707","Mobile","AAA01","2","20000","4000","16000","2010-05-12 06:27:07"
"12822","99","20100511055350","Shop","AAA04","1","8000","400","7600","2010-05-11 17:53:50"
"12823","5","20100511022357","Mobile","AAA03","2","34000","6000","28000","2010-05-11 14:23:57"
"12824","23","20100511011320","Shop","AAA05","1","60000","20000","40000","2010-05-11 13:13:20"
"12825","40","20100511114915","Shop","AAA01","1","10000","2000","8000","2010-05-11 11:49:15"
"12826","75","20100511100100","PC","AAA05","1","60000","20000","40000","2010-05-11 10:01:00"
"12827","58","20100511081732","PC","AAA02","1","15000","2300","12700","2010-05-11 08:17:32"
"12828","97","20100511074519","Mobile","AAA02","1","15000","2300","12700","2010-05-11 07:45:19"
"12829","71","20100510030303","Shop","AAA05","2","120000","40000","80000","2010-05-10 15:03:03"
"12830","80","20100510013130","PC","AAA04","1","8000","400","7600","2010-05-10 13:31:30"
"12831","7","20100510120537","Shop","AAA03","1","17000","3000","14000","2010-05-10 12:05:37"
"12832","17","20100510093159","PC","AAA03","3","51000","9000","42000","2010-05-10 09:31:59"
"12833","87","20100505050503","PC","AAA01","1","10000","2000","8000","2010-05-05 05:05:03"
"12834","19","20100504044051","PC","AAA03","1","17000","3000","14000","2010-05-04 16:40:51"
"12835","60","20100504033507","Shop","AAA01","2","20000","4000","16000","2010-05-04 15:35:07"
"12836","64","20100504013554","Shop","AAA05","4","240000","80000","160000","2010-05-04 13:35:54"
"12837","64","20100504115717","PC","AAA04","2","16000","800","15200","2010-05-04 11:57:17"
"12838","91","20100504100244","PC","AAA02","1","15000","2300","12700","2010-05-04 10:02:44"
"12839","72","20100504083857","PC","AAA02","1","15000","2300","12700","2010-05-04 08:38:57"
"12840","9","20100504070216","Shop","AAA05","1","60000","20000","40000","2010-05-04 07:02:16"
"12841","47","20100503041550","Shop","AAA04","2","16000","800","15200","2010-05-03 16:15:50"
"12842","36","20100503033216","Shop","AAA04","4","32000","1600","30400","2010-05-03 15:32:16"
"12843","48","20100503014048","PC","AAA05","3","180000","60000","120000","2010-05-03 13:40:48"
"12844","15","20100503110535","Shop","AAA02","3","45000","6900","38100","2010-05-03 11:05:35"
"12845","56","20100426015008","Mobile","AAA03","3","51000","9000","42000","2010-04-26 13:50:08"
"12846","15","20100426095535","PC","AAA02","8","120000","18400","101600","2010-04-26 09:55:35"
"12847","36","20100421113946","Shop","AAA03","5","85000","15000","70000","2010-04-21 23:39:46"
"12848","45","20100421063604","Shop","AAA02","1","15000","2300","12700","2010-04-21 06:36:04"
"12849","28","20100420083643","Shop","AAA02","3","45000","6900","38100","2010-04-20 08:36:43"
"12850","55","20100420073222","PC","AAA03","1","17000","3000","14000","2010-04-20 07:32:22"
"12851","32","20100419065608","Shop","AAA02","1","15000","2300","12700","2010-04-19 18:56:08"
"12852","67","20100419120823","PC","AAA05","1","60000","20000","40000","2010-04-19 12:08:23"
"12853","49","20100418113226","Mobile","AAA02","3","45000","6900","38100","2010-04-18 11:32:26"
"12854","70","20100414022904","Shop","AAA01","3","30000","6000","24000","2010-04-14 02:29:04"
"12855","94","20100413013757","Shop","AAA01","3","30000","6000","24000","2010-04-13 13:37:57"
"12856","86","20100413122202","Mobile","AAA02","1","15000","2300","12700","2010-04-13 12:22:02"
"12857","93","20100413115035","Mobile","AAA03","2","34000","6000","28000","2010-04-13 11:50:35"
"12858","72","20100413104138","Mobile","AAA01","1","10000","2000","8000","2010-04-13 10:41:38"
"12859","97","20100413091058","PC","AAA05","2","120000","40000","80000","2010-04-13 09:10:58"
"12860","38","20100413072945","Mobile","AAA01","1","10000","2000","8000","2010-04-13 07:29:45"
"12861","62","20100412114701","Shop","AAA01","5","50000","10000","40000","2010-04-12 11:47:01"
"12862","12","20100406070301","PC","AAA04","1","8000","400","7600","2010-04-06 19:03:01"
"12863","68","20100406041819","Shop","AAA02","1","15000","2300","12700","2010-04-06 16:18:19"
"12864","18","20100406023751","Shop","AAA05","1","60000","20000","40000","2010-04-06 14:37:51"
"12865","25","20100406121613","PC","AAA01","1","10000","2000","8000","2010-04-06 12:16:13"
"12866","69","20100406094951","Mobile","AAA01","1","10000","2000","8000","2010-04-06 09:49:51"
"12867","27","20100405052404","Shop","AAA01","2","20000","4000","16000","2010-04-05 17:24:04"
"12868","94","20100405033203","PC","AAA05","5","300000","100000","200000","2010-04-05 15:32:03"
"12869","73","20100405110557","PC","AAA03","1","17000","3000","14000","2010-04-05 11:05:57"
"12870","52","20100405094148","PC","AAA04","2","16000","800","15200","2010-04-05 09:41:48"
"12871","2","20100329034258","PC","AAA05","2","120000","40000","80000","2010-03-29 15:42:58"
"12872","43","20100329011839","Mobile","AAA05","6","360000","120000","240000","2010-03-29 13:18:39"
"12873","31","20100329114003","Shop","AAA02","2","30000","4600","25400","2010-03-29 11:40:03"
"12874","22","20100329091519","Shop","AAA05","3","180000","60000","120000","2010-03-29 09:15:19"
"12875","32","20100323101634","Shop","AAA05","2","120000","40000","80000","2010-03-23 10:16:34"
"12876","28","20100323063810","Mobile","AAA01","3","30000","6000","24000","2010-03-23 06:38:10"
"12877","57","20100322070902","Mobile","AAA04","1","8000","400","7600","2010-03-22 19:09:02"
"12878","56","20100322114829","Shop","AAA05","3","180000","60000","120000","2010-03-22 11:48:29"
"12879","62","20100322100658","Shop","AAA04","1","8000","400","7600","2010-03-22 10:06:58"
"12880","47","20100322081921","Shop","AAA02","2","30000","4600","25400","2010-03-22 08:19:21"
"12881","87","20100316011337","Shop","AAA05","2","120000","40000","80000","2010-03-16 01:13:37"
"12882","21","20100315100749","Shop","AAA04","1","8000","400","7600","2010-03-15 10:07:49"
"12883","1","20100311032437","Shop","AAA04","4","32000","1600","30400","2010-03-11 03:24:37"
"12884","67","20100309061316","Shop","AAA05","2","120000","40000","80000","2010-03-09 18:13:16"
"12885","2","20100309123411","Mobile","AAA01","1","10000","2000","8000","2010-03-09 12:34:11"
"12886","61","20100309100006","Mobile","AAA01","1","10000","2000","8000","2010-03-09 10:00:06"
"12887","59","20100309070800","Mobile","AAA02","1","15000","2300","12700","2010-03-09 07:08:00"
"12888","22","20100303095807","Mobile","AAA03","1","17000","3000","14000","2010-03-03 09:58:07"
"12889","20","20100302075914","Mobile","AAA01","1","10000","2000","8000","2010-03-02 19:59:14"
"12890","93","20100302020628","PC","AAA03","3","51000","9000","42000","2010-03-02 14:06:28"
"12891","99","20100302010538","Shop","AAA03","1","17000","3000","14000","2010-03-02 13:05:38"
"12892","16","20100302113658","Mobile","AAA04","1","8000","400","7600","2010-03-02 11:36:58"
"12893","90","20100302101304","Shop","AAA03","1","17000","3000","14000","2010-03-02 10:13:04"
"12894","37","20100302081213","Mobile","AAA02","1","15000","2300","12700","2010-03-02 08:12:13"
"12895","38","20100301075810","Mobile","AAA03","1","17000","3000","14000","2010-03-01 07:58:10"
"12896","65","20100226053047","PC","AAA04","2","16000","800","15200","2010-02-26 05:30:47"
"12897","49","20100225075803","PC","AAA01","1","10000","2000","8000","2010-02-25 07:58:03"
"12898","20","20100224124158","Mobile","AAA05","2","120000","40000","80000","2010-02-24 12:41:58"
"12899","79","20100224111305","Mobile","AAA05","1","60000","20000","40000","2010-02-24 11:13:05"
"12900","80","20100224090101","Shop","AAA02","1","15000","2300","12700","2010-02-24 09:01:01"
"12901","7","20100223012734","Shop","AAA05","1","60000","20000","40000","2010-02-23 13:27:34"
"12902","99","20100223114534","Shop","AAA04","1","8000","400","7600","2010-02-23 11:45:34"
"12903","7","20100223095728","PC","AAA05","3","180000","60000","120000","2010-02-23 09:57:28"
"12904","47","20100223080427","Shop","AAA04","2","16000","800","15200","2010-02-23 08:04:27"
"12905","7","20100223050417","Shop","AAA02","1","15000","2300","12700","2010-02-23 05:04:17"
"12906","98","20100222045421","Mobile","AAA05","1","60000","20000","40000","2010-02-22 04:54:21"
"12907","74","20100217081249","Mobile","AAA01","1","10000","2000","8000","2010-02-17 20:12:49"
"12908","47","20100217053901","Shop","AAA04","3","24000","1200","22800","2010-02-17 17:39:01"
"12909","80","20100217032332","PC","AAA05","3","180000","60000","120000","2010-02-17 15:23:32"
"12910","5","20100217010046","PC","AAA02","4","60000","9200","50800","2010-02-17 13:00:46"
"12911","53","20100217103927","PC","AAA03","2","34000","6000","28000","2010-02-17 10:39:27"
"12912","54","20100217082555","Mobile","AAA05","3","180000","60000","120000","2010-02-17 08:25:55"
"12913","33","20100217071407","Shop","AAA03","1","17000","3000","14000","2010-02-17 07:14:07"
"12914","91","20100216110628","Mobile","AAA05","1","60000","20000","40000","2010-02-16 11:06:28"
"12915","50","20100215033417","PC","AAA03","1","17000","3000","14000","2010-02-15 15:34:17"
"12916","49","20100215014732","Mobile","AAA01","4","40000","8000","32000","2010-02-15 13:47:32"
"12917","55","20100215123450","PC","AAA02","1","15000","2300","12700","2010-02-15 12:34:50"
"12918","21","20100215104216","PC","AAA04","3","24000","1200","22800","2010-02-15 10:42:16"
"12919","6","20100215093323","PC","AAA01","1","10000","2000","8000","2010-02-15 09:33:23"
"12920","37","20100211050218","Shop","AAA04","3","24000","1200","22800","2010-02-11 05:02:18"
"12921","9","20100210080628","PC","AAA04","1","8000","400","7600","2010-02-10 08:06:28"
"12922","76","20100210062815","Mobile","AAA02","3","45000","6900","38100","2010-02-10 06:28:15"
"12923","83","20100209010954","PC","AAA02","4","60000","9200","50800","2010-02-09 13:09:54"
"12924","83","20100209105212","PC","AAA01","1","10000","2000","8000","2010-02-09 10:52:12"
"12925","18","20100209083040","PC","AAA01","3","30000","6000","24000","2010-02-09 08:30:40"
"12926","67","20100209065641","PC","AAA02","1","15000","2300","12700","2010-02-09 06:56:41"
"12927","54","20100208111426","Mobile","AAA04","3","24000","1200","22800","2010-02-08 11:14:26"
"12928","56","20100208094155","Shop","AAA02","1","15000","2300","12700","2010-02-08 09:41:55"
"12929","100","20100202092205","PC","AAA02","1","15000","2300","12700","2010-02-02 09:22:05"
"12930","52","20100201114023","Shop","AAA01","1","10000","2000","8000","2010-02-01 11:40:23"
"12931","79","20100201102148","PC","AAA01","2","20000","4000","16000","2010-02-01 10:21:48"
"12932","76","20100201090051","Mobile","AAA02","1","15000","2300","12700","2010-02-01 09:00:51"
"12933","60","20100125014909","Shop","AAA03","1","17000","3000","14000","2010-01-25 01:49:09"
"12934","25","20100120122001","Mobile","AAA03","1","17000","3000","14000","2010-01-20 00:20:01"
"12935","35","20100119111927","Shop","AAA02","1","15000","2300","12700","2010-01-19 11:19:27"
"12936","56","20100119091743","PC","AAA04","1","8000","400","7600","2010-01-19 09:17:43"
"12937","94","20100119080619","PC","AAA04","6","48000","2400","45600","2010-01-19 08:06:19"
"12938","23","20100119061118","Shop","AAA02","2","30000","4600","25400","2010-01-19 06:11:18"
"12939","3","20100118061012","PC","AAA02","7","105000","16100","88900","2010-01-18 18:10:12"
"12940","39","20100118121115","Mobile","AAA05","1","60000","20000","40000","2010-01-18 12:11:15"
"12941","16","20100118104248","PC","AAA02","3","45000","6900","38100","2010-01-18 10:42:48"
"12942","50","20100118074403","Shop","AAA01","4","40000","8000","32000","2010-01-18 07:44:03"
"12943","96","20100115045355","Shop","AAA03","5","85000","15000","70000","2010-01-15 16:53:55"
"12944","76","20100115024917","Mobile","AAA02","1","15000","2300","12700","2010-01-15 14:49:17"
"12945","76","20100115092710","Mobile","AAA04","4","32000","1600","30400","2010-01-15 09:27:10"
"12946","75","20100115065004","Mobile","AAA04","1","8000","400","7600","2010-01-15 06:50:04"
"12947","89","20100114113058","Mobile","AAA02","3","45000","6900","38100","2010-01-14 11:30:58"
"12948","11","20100114102904","PC","AAA04","2","16000","800","15200","2010-01-14 10:29:04"
"12949","54","20100114080015","Mobile","AAA05","1","60000","20000","40000","2010-01-14 08:00:15"
"12950","70","20100114062548","Mobile","AAA04","7","56000","2800","53200","2010-01-14 06:25:48"
"12951","24","20100113064212","Mobile","AAA02","1","15000","2300","12700","2010-01-13 06:42:12"
"12952","70","20100112041409","Shop","AAA04","4","32000","1600","30400","2010-01-12 16:14:09"
"12953","99","20100112013818","Shop","AAA02","1","15000","2300","12700","2010-01-12 13:38:18"
"12954","84","20100112085242","PC","AAA01","1","10000","2000","8000","2010-01-12 08:52:42"
"12955","63","20100112063918","PC","AAA05","1","60000","20000","40000","2010-01-12 06:39:18"
"12956","25","20100111055415","PC","AAA01","4","40000","8000","32000","2010-01-11 17:54:15"
"12957","64","20100111032234","Mobile","AAA04","2","16000","800","15200","2010-01-11 15:22:34"
"12958","39","20100111012032","Shop","AAA01","1","10000","2000","8000","2010-01-11 13:20:32"
"12959","10","20100111110154","Shop","AAA04","1","8000","400","7600","2010-01-11 11:01:54"
"12960","21","20100111085155","PC","AAA05","4","240000","80000","160000","2010-01-11 08:51:55"
"12961","94","20100106042856","Mobile","AAA03","2","34000","6000","28000","2010-01-06 16:28:56"
"12962","51","20100106025111","Mobile","AAA03","2","34000","6000","28000","2010-01-06 14:51:11"
"12963","15","20100106122931","Mobile","AAA04","4","32000","1600","30400","2010-01-06 12:29:31"
"12964","93","20100106094134","PC","AAA03","2","34000","6000","28000","2010-01-06 09:41:34"
"12965","26","20100106075020","Shop","AAA03","2","34000","6000","28000","2010-01-06 07:50:20"
"12966","92","20100105081658","PC","AAA04","1","8000","400","7600","2010-01-05 20:16:58"
"12967","42","20100105021010","PC","AAA03","2","34000","6000","28000","2010-01-05 14:10:10"
"12968","23","20100105123123","Mobile","AAA03","2","34000","6000","28000","2010-01-05 12:31:23"
"12969","54","20100105104221","PC","AAA03","1","17000","3000","14000","2010-01-05 10:42:21"
"12970","63","20100104104043","Mobile","AAA04","2","16000","800","15200","2010-01-04 10:40:43"
"12971","89","20100104091355","Mobile","AAA01","8","80000","16000","64000","2010-01-04 09:13:55"
"12972","2","20091230063835","PC","AAA05","2","120000","40000","80000","2009-12-30 06:38:35"
"12973","74","20091228094417","Mobile","AAA04","2","16000","800","15200","2009-12-28 09:44:17"
"12974","83","20091220115725","Shop","AAA05","1","60000","20000","40000","2009-12-20 11:57:25"
"12975","48","20091219070644","PC","AAA04","2","16000","800","15200","2009-12-19 07:06:44"
"12976","65","20091218092105","PC","AAA03","1","17000","3000","14000","2009-12-18 09:21:05"
"12977","72","20091218071624","PC","AAA04","1","8000","400","7600","2009-12-18 07:16:24"
"12978","54","20091217103250","Shop","AAA03","2","34000","6000","28000","2009-12-17 22:32:50"
"12979","28","20091217033018","Mobile","AAA04","1","8000","400","7600","2009-12-17 15:30:18"
"12980","79","20091217021717","Mobile","AAA01","2","20000","4000","16000","2009-12-17 14:17:17"
"12981","76","20091217122215","Shop","AAA05","1","60000","20000","40000","2009-12-17 12:22:15"
"12982","27","20091217104351","Shop","AAA05","3","180000","60000","120000","2009-12-17 10:43:51"
"12983","45","20091217081226","Mobile","AAA04","1","8000","400","7600","2009-12-17 08:12:26"
"12984","31","20091216062347","PC","AAA05","2","120000","40000","80000","2009-12-16 06:23:47"
"12985","92","20091215090639","Mobile","AAA04","1","8000","400","7600","2009-12-15 09:06:39"
"12986","36","20091215081118","Mobile","AAA04","2","16000","800","15200","2009-12-15 08:11:18"
"12987","49","20091215045350","PC","AAA04","2","16000","800","15200","2009-12-15 04:53:50"
"12988","74","20091214075544","Mobile","AAA05","2","120000","40000","80000","2009-12-14 07:55:44"
"12989","28","20091210053445","Mobile","AAA04","1","8000","400","7600","2009-12-10 17:34:45"
"12990","48","20091210032510","PC","AAA01","1","10000","2000","8000","2009-12-10 15:25:10"
"12991","27","20091210014547","Shop","AAA02","1","15000","2300","12700","2009-12-10 13:45:47"
"12992","36","20091210123724","PC","AAA03","1","17000","3000","14000","2009-12-10 12:37:24"
"12993","56","20091210072234","Mobile","AAA03","2","34000","6000","28000","2009-12-10 07:22:34"
"12994","11","20091209084157","Mobile","AAA03","1","17000","3000","14000","2009-12-09 20:41:57"
"12995","72","20091209052611","Mobile","AAA02","2","30000","4600","25400","2009-12-09 17:26:11"
"12996","40","20091209031857","Shop","AAA01","1","10000","2000","8000","2009-12-09 15:18:57"
"12997","10","20091209124720","Shop","AAA05","4","240000","80000","160000","2009-12-09 12:47:20"
"12998","67","20091209112918","PC","AAA02","2","30000","4600","25400","2009-12-09 11:29:18"
"12999","30","20091209114432","Mobile","AAA02","1","15000","2300","12700","2009-12-09 11:44:32"
"13000","6","20091209072131","Mobile","AAA05","1","60000","20000","40000","2009-12-09 07:21:31"
"13001","96","20091208023829","Shop","AAA02","1","15000","2300","12700","2009-12-08 14:38:29"
"13002","93","20091208125419","Mobile","AAA03","1","17000","3000","14000","2009-12-08 12:54:19"
"13003","44","20091208104645","PC","AAA02","2","30000","4600","25400","2009-12-08 10:46:45"
"13004","51","20091208081730","PC","AAA02","1","15000","2300","12700","2009-12-08 08:17:30"
"13005","40","20091208065536","Shop","AAA03","1","17000","3000","14000","2009-12-08 06:55:36"
"13006","72","20091207072412","Mobile","AAA01","2","20000","4000","16000","2009-12-07 07:24:12"
"13007","59","20091201083507","PC","AAA03","2","34000","6000","28000","2009-12-01 08:35:07"
"13008","85","20091201053918","Mobile","AAA05","1","60000","20000","40000","2009-12-01 05:39:18"
"13009","5","20091201012055","Shop","AAA05","1","60000","20000","40000","2009-12-01 01:20:55"
"13010","77","20091130103611","Mobile","AAA03","1","17000","3000","14000","2009-11-30 10:36:11"
"13011","34","20091130082156","PC","AAA03","1","17000","3000","14000","2009-11-30 08:21:56"
"13012","9","20091124122939","PC","AAA04","1","8000","400","7600","2009-11-24 12:29:39"
"13013","93","20091123025724","Mobile","AAA01","1","10000","2000","8000","2009-11-23 14:57:24"
"13014","87","20091123125946","Mobile","AAA05","1","60000","20000","40000","2009-11-23 12:59:46"
"13015","98","20091123114226","Shop","AAA02","1","15000","2300","12700","2009-11-23 11:42:26"
"13016","41","20091123091739","Shop","AAA01","1","10000","2000","8000","2009-11-23 09:17:39"
"13017","39","20091118124840","PC","AAA03","1","17000","3000","14000","2009-11-18 00:48:40"
"13018","36","20091117074728","PC","AAA04","2","16000","800","15200","2009-11-17 07:47:28"
"13019","79","20091116101342","PC","AAA05","2","120000","40000","80000","2009-11-16 10:13:42"
"13020","48","20091113025726","PC","AAA04","2","16000","800","15200","2009-11-13 02:57:26"
"13021","66","20091112013345","Shop","AAA03","1","17000","3000","14000","2009-11-12 13:33:45"
"13022","37","20091112095958","Mobile","AAA03","3","51000","9000","42000","2009-11-12 09:59:58"
"13023","40","20091112084650","Shop","AAA03","1","17000","3000","14000","2009-11-12 08:46:50"
"13024","32","20091112062258","PC","AAA03","2","34000","6000","28000","2009-11-12 06:22:58"
"13025","17","20091111020935","Shop","AAA05","1","60000","20000","40000","2009-11-11 14:09:35"
"13026","9","20091111121624","PC","AAA05","2","120000","40000","80000","2009-11-11 12:16:24"
"13027","28","20091111094833","Shop","AAA05","2","120000","40000","80000","2009-11-11 09:48:33"
"13028","88","20091111075003","Mobile","AAA05","1","60000","20000","40000","2009-11-11 07:50:03"
"13029","32","20091110081736","Shop","AAA02","1","15000","2300","12700","2009-11-10 08:17:36"
"13030","13","20091110065442","PC","AAA05","1","60000","20000","40000","2009-11-10 06:54:42"
"13031","38","20091105033631","Mobile","AAA04","1","8000","400","7600","2009-11-05 15:36:31"
"13032","73","20091105122335","Shop","AAA01","1","10000","2000","8000","2009-11-05 12:23:35"
"13033","45","20091105102808","Mobile","AAA01","1","10000","2000","8000","2009-11-05 10:28:08"
"13034","16","20091105083930","Mobile","AAA02","2","30000","4600","25400","2009-11-05 08:39:30"
"13035","65","20091104045405","PC","AAA02","1","15000","2300","12700","2009-11-04 16:54:05"
"13036","25","20091104025448","Mobile","AAA01","1","10000","2000","8000","2009-11-04 14:54:48"
"13037","47","20091104124220","PC","AAA02","1","15000","2300","12700","2009-11-04 12:42:20"
"13038","81","20091104112036","Mobile","AAA03","2","34000","6000","28000","2009-11-04 11:20:36"
"13039","13","20091104103011","Mobile","AAA03","2","34000","6000","28000","2009-11-04 10:30:11"
"13040","95","20091104070917","PC","AAA03","1","17000","3000","14000","2009-11-04 07:09:17"
"13041","61","20091102040710","Mobile","AAA05","1","60000","20000","40000","2009-11-02 04:07:10"
"13042","68","20091031124726","Mobile","AAA04","1","8000","400","7600","2009-10-31 00:47:26"
"13043","82","20091030094010","PC","AAA03","2","34000","6000","28000","2009-10-30 09:40:10"
"13044","49","20091030082652","PC","AAA04","2","16000","800","15200","2009-10-30 08:26:52"
"13045","62","20091030065208","Shop","AAA02","2","30000","4600","25400","2009-10-30 06:52:08"
"13046","10","20091029032748","Mobile","AAA02","2","30000","4600","25400","2009-10-29 15:27:48"
"13047","11","20091029114020","Shop","AAA02","2","30000","4600","25400","2009-10-29 11:40:20"
"13048","32","20091029084303","Shop","AAA05","3","180000","60000","120000","2009-10-29 08:43:03"
"13049","15","20091029072503","Shop","AAA03","3","51000","9000","42000","2009-10-29 07:25:03"
"13050","72","20091028114053","Mobile","AAA05","1","60000","20000","40000","2009-10-28 11:40:53"
"13051","35","20091028093017","Mobile","AAA02","1","15000","2300","12700","2009-10-28 09:30:17"
"13052","67","20091028082540","Shop","AAA03","3","51000","9000","42000","2009-10-28 08:25:40"
"13053","78","20091028065634","Mobile","AAA02","1","15000","2300","12700","2009-10-28 06:56:34"
"13054","58","20091027075351","Mobile","AAA02","1","15000","2300","12700","2009-10-27 19:53:51"
"13055","59","20091027094625","PC","AAA02","1","15000","2300","12700","2009-10-27 09:46:25"
"13056","78","20091026123515","PC","AAA04","2","16000","800","15200","2009-10-26 12:35:15"
"13057","81","20091026111118","Shop","AAA05","1","60000","20000","40000","2009-10-26 11:11:18"
"13058","74","20091026093040","PC","AAA03","1","17000","3000","14000","2009-10-26 09:30:40"
"13059","59","20091022024225","Mobile","AAA03","1","17000","3000","14000","2009-10-22 14:42:25"
"13060","11","20091022123710","Shop","AAA04","1","8000","400","7600","2009-10-22 12:37:10"
"13061","43","20091022104728","Shop","AAA02","1","15000","2300","12700","2009-10-22 10:47:28"
"13062","70","20091022080315","Mobile","AAA01","1","10000","2000","8000","2009-10-22 08:03:15"
"13063","44","20091021040217","PC","AAA05","4","240000","80000","160000","2009-10-21 16:02:17"
"13064","58","20091021121526","Shop","AAA05","1","60000","20000","40000","2009-10-21 12:15:26"
"13065","57","20091021104932","Mobile","AAA03","2","34000","6000","28000","2009-10-21 10:49:32"
"13066","31","20091020080044","Shop","AAA05","1","60000","20000","40000","2009-10-20 08:00:44"
"13067","96","20091019035846","PC","AAA04","1","8000","400","7600","2009-10-19 15:58:46"
"13068","95","20091019022632","PC","AAA02","1","15000","2300","12700","2009-10-19 14:26:32"
"13069","34","20091019111205","Shop","AAA05","4","240000","80000","160000","2009-10-19 11:12:05"
"13070","56","20091019092159","Shop","AAA01","3","30000","6000","24000","2009-10-19 09:21:59"
"13071","31","20091016071506","PC","AAA05","1","60000","20000","40000","2009-10-16 07:15:06"
"13072","55","20091015015537","Mobile","AAA05","2","120000","40000","80000","2009-10-15 13:55:37"
"13073","37","20091015111556","Mobile","AAA02","2","30000","4600","25400","2009-10-15 11:15:56"
"13074","95","20091015084831","Shop","AAA02","1","15000","2300","12700","2009-10-15 08:48:31"
"13075","16","20091015065106","Mobile","AAA01","3","30000","6000","24000","2009-10-15 06:51:06"
"13076","8","20091014062955","PC","AAA01","3","30000","6000","24000","2009-10-14 18:29:55"
"13077","3","20091014101131","Mobile","AAA04","2","16000","800","15200","2009-10-14 10:11:31"
"13078","80","20091014080737","Mobile","AAA02","2","30000","4600","25400","2009-10-14 08:07:37"
"13079","92","20091014062818","Mobile","AAA04","1","8000","400","7600","2009-10-14 06:28:18"
"13080","72","20091012065110","Mobile","AAA03","3","51000","9000","42000","2009-10-12 18:51:10"
"13081","55","20091012121629","PC","AAA05","2","120000","40000","80000","2009-10-12 12:16:29"
"13082","69","20091012112059","PC","AAA02","1","15000","2300","12700","2009-10-12 11:20:59"
"13083","79","20091008094813","Shop","AAA02","1","15000","2300","12700","2009-10-08 09:48:13"
"13084","86","20091008080654","Mobile","AAA02","1","15000","2300","12700","2009-10-08 08:06:54"
"13085","90","20091007022839","Mobile","AAA04","1","8000","400","7600","2009-10-07 14:28:39"
"13086","9","20091007124008","Shop","AAA04","1","8000","400","7600","2009-10-07 12:40:08"
"13087","8","20091007102048","Shop","AAA05","3","180000","60000","120000","2009-10-07 10:20:48"
"13088","46","20091007082323","Mobile","AAA02","2","30000","4600","25400","2009-10-07 08:23:23"
"13089","27","20091007065010","Shop","AAA03","2","34000","6000","28000","2009-10-07 06:50:10"
"13090","33","20091006091026","PC","AAA03","1","17000","3000","14000","2009-10-06 09:10:26"
"13091","23","20091005032803","Mobile","AAA02","1","15000","2300","12700","2009-10-05 15:28:03"
"13092","80","20091005012418","PC","AAA04","1","8000","400","7600","2009-10-05 13:24:18"
"13093","87","20091005112903","PC","AAA02","3","45000","6900","38100","2009-10-05 11:29:03"
"13094","83","20091005093214","PC","AAA01","2","20000","4000","16000","2009-10-05 09:32:14"
"13095","89","20090928110102","Shop","AAA01","3","30000","6000","24000","2009-09-28 23:01:02"
"13096","63","20090924063453","Shop","AAA01","1","10000","2000","8000","2009-09-24 18:34:53"
"13097","34","20090924093607","Shop","AAA04","3","24000","1200","22800","2009-09-24 09:36:07"
"13098","37","20090924075833","Mobile","AAA01","1","10000","2000","8000","2009-09-24 07:58:33"
"13099","42","20090923043104","Shop","AAA05","1","60000","20000","40000","2009-09-23 16:31:04"
"13100","28","20090923120736","Mobile","AAA01","1","10000","2000","8000","2009-09-23 12:07:36"
"13101","74","20090922082357","Mobile","AAA03","2","34000","6000","28000","2009-09-22 20:23:57"
"13102","35","20090922055143","PC","AAA01","1","10000","2000","8000","2009-09-22 17:51:43"
"13103","24","20090922013646","Shop","AAA05","1","60000","20000","40000","2009-09-22 13:36:46"
"13104","47","20090922111516","Shop","AAA02","3","45000","6900","38100","2009-09-22 11:15:16"
"13105","86","20090922093055","Shop","AAA01","1","10000","2000","8000","2009-09-22 09:30:55"
"13106","71","20090922074534","Mobile","AAA02","1","15000","2300","12700","2009-09-22 07:45:34"
"13107","23","20090921034453","Shop","AAA02","2","30000","4600","25400","2009-09-21 15:44:53"
"13108","49","20090921015741","Shop","AAA02","2","30000","4600","25400","2009-09-21 13:57:41"
"13109","18","20090921120654","Shop","AAA01","1","10000","2000","8000","2009-09-21 12:06:54"
"13110","73","20090921072351","Shop","AAA01","2","20000","4000","16000","2009-09-21 07:23:51"
"13111","15","20090917031521","PC","AAA02","1","15000","2300","12700","2009-09-17 15:15:21"
"13112","88","20090917125809","PC","AAA02","1","15000","2300","12700","2009-09-17 12:58:09"
"13113","8","20090917111126","PC","AAA01","3","30000","6000","24000","2009-09-17 11:11:26"
"13114","33","20090917075743","PC","AAA01","1","10000","2000","8000","2009-09-17 07:57:43"
"13115","78","20090916011059","Shop","AAA05","1","60000","20000","40000","2009-09-16 13:10:59"
"13116","35","20090916100133","Mobile","AAA01","1","10000","2000","8000","2009-09-16 10:01:33"
"13117","1","20090916075014","Mobile","AAA03","2","34000","6000","28000","2009-09-16 07:50:14"
"13118","94","20090915125719","PC","AAA01","1","10000","2000","8000","2009-09-15 12:57:19"
"13119","88","20090915114614","PC","AAA03","1","17000","3000","14000","2009-09-15 11:46:14"
"13120","36","20090915092755","PC","AAA05","3","180000","60000","120000","2009-09-15 09:27:55"
"13121","8","20090915075542","Shop","AAA04","2","16000","800","15200","2009-09-15 07:55:42"
"13122","55","20090914050954","PC","AAA01","1","10000","2000","8000","2009-09-14 17:09:54"
"13123","82","20090914122449","Mobile","AAA02","1","15000","2300","12700","2009-09-14 12:24:49"
"13124","11","20090914095147","PC","AAA05","2","120000","40000","80000","2009-09-14 09:51:47"
"13125","43","20090908110722","Mobile","AAA01","1","10000","2000","8000","2009-09-08 23:07:22"
"13126","80","20090907072742","Shop","AAA05","2","120000","40000","80000","2009-09-07 19:27:42"
"13127","1","20090907013033","Shop","AAA03","2","34000","6000","28000","2009-09-07 13:30:33"
"13128","78","20090907112821","Shop","AAA05","1","60000","20000","40000","2009-09-07 11:28:21"
"13129","71","20090904014054","Mobile","AAA03","1","17000","3000","14000","2009-09-04 01:40:54"
"13130","86","20090903020040","PC","AAA04","1","8000","400","7600","2009-09-03 14:00:40"
"13131","3","20090903124743","Shop","AAA05","3","180000","60000","120000","2009-09-03 12:47:43"
"13132","56","20090903114515","Mobile","AAA02","2","30000","4600","25400","2009-09-03 11:45:15"
"13133","46","20090903111504","Shop","AAA05","1","60000","20000","40000","2009-09-03 11:15:04"
"13134","89","20090903090416","Shop","AAA04","1","8000","400","7600","2009-09-03 09:04:16"
"13135","81","20090903074019","PC","AAA05","1","60000","20000","40000","2009-09-03 07:40:19"
"13136","40","20090902075602","Shop","AAA03","1","17000","3000","14000","2009-09-02 19:56:02"
"13137","97","20090902010818","Shop","AAA03","1","17000","3000","14000","2009-09-02 13:08:18"
"13138","55","20090902092132","Mobile","AAA05","1","60000","20000","40000","2009-09-02 09:21:32"
"13139","37","20090902075615","PC","AAA02","1","15000","2300","12700","2009-09-02 07:56:15"
"13140","27","20090901022558","Shop","AAA02","2","30000","4600","25400","2009-09-01 14:25:58"
"13141","92","20090901120330","Shop","AAA02","1","15000","2300","12700","2009-09-01 12:03:30"
"13142","37","20090901100823","Mobile","AAA01","1","10000","2000","8000","2009-09-01 10:08:23"
"13143","47","20090901061531","Shop","AAA02","3","45000","6900","38100","2009-09-01 06:15:31"
"13144","90","20090831033313","Mobile","AAA03","1","17000","3000","14000","2009-08-31 15:33:13"
"13145","78","20090831012128","PC","AAA04","1","8000","400","7600","2009-08-31 13:21:28"
"13146","100","20090831094426","Shop","AAA04","1","8000","400","7600","2009-08-31 09:44:26"
"13147","98","20090828083931","PC","AAA05","1","60000","20000","40000","2009-08-28 20:39:31"
"13148","55","20090828042752","PC","AAA03","1","17000","3000","14000","2009-08-28 16:27:52"
"13149","78","20090828022125","PC","AAA01","1","10000","2000","8000","2009-08-28 14:21:25"
"13150","27","20090828114713","Shop","AAA03","2","34000","6000","28000","2009-08-28 11:47:13"
"13151","52","20090828071011","Mobile","AAA03","1","17000","3000","14000","2009-08-28 07:10:11"
"13152","7","20090827113516","Mobile","AAA02","1","15000","2300","12700","2009-08-27 11:35:16"
"13153","16","20090827092341","PC","AAA01","4","40000","8000","32000","2009-08-27 09:23:41"
"13154","5","20090826074036","Shop","AAA02","1","15000","2300","12700","2009-08-26 07:40:36"
"13155","19","20090825023943","Mobile","AAA04","1","8000","400","7600","2009-08-25 14:39:43"
"13156","56","20090825110819","PC","AAA03","2","34000","6000","28000","2009-08-25 11:08:19"
"13157","54","20090825073323","Mobile","AAA04","1","8000","400","7600","2009-08-25 07:33:23"
"13158","65","20090824122915","Mobile","AAA03","1","17000","3000","14000","2009-08-24 12:29:15"
"13159","96","20090824105837","PC","AAA03","2","34000","6000","28000","2009-08-24 10:58:37"
"13160","85","20090822082902","Shop","AAA01","1","10000","2000","8000","2009-08-22 20:29:02"
"13161","20","20090821030341","Shop","AAA01","1","10000","2000","8000","2009-08-21 15:03:41"
"13162","39","20090821113218","Shop","AAA05","1","60000","20000","40000","2009-08-21 11:32:18"
"13163","58","20090821100238","Mobile","AAA01","1","10000","2000","8000","2009-08-21 10:02:38"
"13164","74","20090821071850","Shop","AAA03","1","17000","3000","14000","2009-08-21 07:18:50"
"13165","20","20090820105917","Shop","AAA04","1","8000","400","7600","2009-08-20 10:59:17"
"13166","54","20090820094525","PC","AAA02","2","30000","4600","25400","2009-08-20 09:45:25"
"13167","47","20090820085428","Mobile","AAA05","3","180000","60000","120000","2009-08-20 08:54:28"
"13168","69","20090819095135","Mobile","AAA05","2","120000","40000","80000","2009-08-19 09:51:35"
"13169","86","20090819080842","Mobile","AAA04","2","16000","800","15200","2009-08-19 08:08:42"
"13170","29","20090818010249","PC","AAA03","1","17000","3000","14000","2009-08-18 13:02:49"
"13171","74","20090818111526","Shop","AAA03","1","17000","3000","14000","2009-08-18 11:15:26"
"13172","74","20090818103948","Shop","AAA03","1","17000","3000","14000","2009-08-18 10:39:48"
"13173","46","20090818072616","Shop","AAA03","1","17000","3000","14000","2009-08-18 07:26:16"
"13174","83","20090817120350","Mobile","AAA05","4","240000","80000","160000","2009-08-17 12:03:50"
"13175","38","20090817102529","PC","AAA04","1","8000","400","7600","2009-08-17 10:25:29"
"13176","94","20090817091406","Mobile","AAA05","1","60000","20000","40000","2009-08-17 09:14:06"
"13177","19","20090813100519","Shop","AAA01","1","10000","2000","8000","2009-08-13 22:05:19"
"13178","38","20090813040635","PC","AAA02","3","45000","6900","38100","2009-08-13 16:06:35"
"13179","27","20090813012502","PC","AAA04","3","24000","1200","22800","2009-08-13 13:25:02"
"13180","46","20090813091555","Shop","AAA01","3","30000","6000","24000","2009-08-13 09:15:55"
"13181","98","20090813073545","PC","AAA04","1","8000","400","7600","2009-08-13 07:35:45"
"13182","18","20090813040250","PC","AAA04","1","8000","400","7600","2009-08-13 04:02:50"
"13183","14","20090812095943","Mobile","AAA03","1","17000","3000","14000","2009-08-12 09:59:43"
"13184","99","20090812054730","Mobile","AAA01","1","10000","2000","8000","2009-08-12 05:47:30"
"13185","4","20090811095147","Mobile","AAA05","1","60000","20000","40000","2009-08-11 09:51:47"
"13186","15","20090811070808","Mobile","AAA05","1","60000","20000","40000","2009-08-11 07:08:08"
"13187","88","20090810040945","Mobile","AAA01","1","10000","2000","8000","2009-08-10 16:09:45"
"13188","47","20090810015909","PC","AAA02","1","15000","2300","12700","2009-08-10 13:59:09"
"13189","29","20090810123003","Shop","AAA03","3","51000","9000","42000","2009-08-10 12:30:03"
"13190","50","20090810110429","PC","AAA03","4","68000","12000","56000","2009-08-10 11:04:29"
"13191","71","20090810084916","Shop","AAA04","2","16000","800","15200","2009-08-10 08:49:16"
"13192","22","20090806031427","Mobile","AAA03","1","17000","3000","14000","2009-08-06 15:14:27"
"13193","36","20090806121519","Mobile","AAA05","1","60000","20000","40000","2009-08-06 12:15:19"
"13194","83","20090806104340","PC","AAA02","4","60000","9200","50800","2009-08-06 10:43:40"
"13195","13","20090806072602","PC","AAA01","1","10000","2000","8000","2009-08-06 07:26:02"
"13196","54","20090805070947","Mobile","AAA01","1","10000","2000","8000","2009-08-05 19:09:47"
"13197","4","20090805124446","Shop","AAA05","1","60000","20000","40000","2009-08-05 12:44:46"
"13198","100","20090805091449","Mobile","AAA01","2","20000","4000","16000","2009-08-05 09:14:49"
"13199","25","20090805072015","PC","AAA05","2","120000","40000","80000","2009-08-05 07:20:15"
"13200","12","20090804100715","Shop","AAA05","1","60000","20000","40000","2009-08-04 22:07:15"
"13201","90","20090804034827","PC","AAA05","2","120000","40000","80000","2009-08-04 15:48:27"
"13202","42","20090804015226","PC","AAA03","1","17000","3000","14000","2009-08-04 13:52:26"
"13203","30","20090804072952","Mobile","AAA03","1","17000","3000","14000","2009-08-04 07:29:52"
"13204","54","20090803105856","Mobile","AAA03","1","17000","3000","14000","2009-08-03 10:58:56"
"13205","55","20090803085120","Shop","AAA05","1","60000","20000","40000","2009-08-03 08:51:20"
"13206","80","20090728102116","PC","AAA01","1","10000","2000","8000","2009-07-28 22:21:16"
"13207","36","20090728034420","Shop","AAA03","1","17000","3000","14000","2009-07-28 15:44:20"
"13208","85","20090728022715","Shop","AAA03","2","34000","6000","28000","2009-07-28 14:27:15"
"13209","36","20090728124618","Shop","AAA04","2","16000","800","15200","2009-07-28 12:46:18"
"13210","40","20090728105705","Mobile","AAA02","1","15000","2300","12700","2009-07-28 10:57:05"
"13211","88","20090728085237","Shop","AAA04","1","8000","400","7600","2009-07-28 08:52:37"
"13212","56","20090728074736","Mobile","AAA05","3","180000","60000","120000","2009-07-28 07:47:36"
"13213","30","20090727043350","Mobile","AAA05","1","60000","20000","40000","2009-07-27 16:33:50"
"13214","31","20090727031624","Shop","AAA05","2","120000","40000","80000","2009-07-27 15:16:24"
"13215","44","20090727123323","Shop","AAA05","2","120000","40000","80000","2009-07-27 12:33:23"
"13216","27","20090727100456","Shop","AAA05","2","120000","40000","80000","2009-07-27 10:04:56"
"13217","4","20090727074351","Mobile","AAA04","1","8000","400","7600","2009-07-27 07:43:51"
"13218","48","20090723121048","PC","AAA04","2","16000","800","15200","2009-07-23 12:10:48"
"13219","3","20090723102539","PC","AAA01","1","10000","2000","8000","2009-07-23 10:25:39"
"13220","83","20090723090501","Mobile","AAA01","2","20000","4000","16000","2009-07-23 09:05:01"
"13221","39","20090723070155","Shop","AAA04","2","16000","800","15200","2009-07-23 07:01:55"
"13222","29","20090722113712","Shop","AAA01","1","10000","2000","8000","2009-07-22 11:37:12"
"13223","21","20090722095913","Mobile","AAA02","2","30000","4600","25400","2009-07-22 09:59:13"
"13224","2","20090722083836","PC","AAA03","1","17000","3000","14000","2009-07-22 08:38:36"
"13225","29","20090722065832","PC","AAA01","2","20000","4000","16000","2009-07-22 06:58:32"
"13226","62","20090721020231","Shop","AAA01","2","20000","4000","16000","2009-07-21 14:02:31"
"13227","73","20090721121643","Shop","AAA01","1","10000","2000","8000","2009-07-21 12:16:43"
"13228","9","20090721082220","Mobile","AAA03","1","17000","3000","14000","2009-07-21 08:22:20"
"13229","18","20090720100250","PC","AAA04","1","8000","400","7600","2009-07-20 10:02:50"
"13230","79","20090720064936","Mobile","AAA01","1","10000","2000","8000","2009-07-20 06:49:36"
"13231","14","20090713121510","Mobile","AAA01","1","10000","2000","8000","2009-07-13 00:15:10"
"13232","72","20090708061025","PC","AAA03","1","17000","3000","14000","2009-07-08 06:10:25"
"13233","89","20090707051751","Mobile","AAA05","3","180000","60000","120000","2009-07-07 17:17:51"
"13234","45","20090707032414","Mobile","AAA05","1","60000","20000","40000","2009-07-07 15:24:14"
"13235","33","20090707020423","PC","AAA05","1","60000","20000","40000","2009-07-07 14:04:23"
"13236","30","20090707081554","PC","AAA03","2","34000","6000","28000","2009-07-07 08:15:54"
"13237","76","20090707061050","Mobile","AAA03","1","17000","3000","14000","2009-07-07 06:10:50"
"13238","66","20090706124954","Shop","AAA01","2","20000","4000","16000","2009-07-06 12:49:54"
"13239","56","20090706093945","Mobile","AAA02","1","15000","2300","12700","2009-07-06 09:39:45"
"13240","30","20090630072113","PC","AAA03","1","17000","3000","14000","2009-06-30 07:21:13"
"13241","5","20090629053716","PC","AAA04","2","16000","800","15200","2009-06-29 17:37:16"
"13242","84","20090629042751","PC","AAA03","1","17000","3000","14000","2009-06-29 16:27:51"
"13243","69","20090624045448","Mobile","AAA02","1","15000","2300","12700","2009-06-24 04:54:48"
"13244","10","20090623063505","Mobile","AAA02","2","30000","4600","25400","2009-06-23 06:35:05"
"13245","21","20090622062431","Mobile","AAA05","1","60000","20000","40000","2009-06-22 18:24:31"
"13246","76","20090622124548","PC","AAA01","1","10000","2000","8000","2009-06-22 12:45:48"
"13247","80","20090622092510","PC","AAA01","1","10000","2000","8000","2009-06-22 09:25:10"
"13248","71","20090617043842","Mobile","AAA04","2","16000","800","15200","2009-06-17 04:38:42"
"13249","62","20090616054709","Shop","AAA03","2","34000","6000","28000","2009-06-16 05:47:09"
"13250","85","20090615123246","Mobile","AAA02","1","15000","2300","12700","2009-06-15 12:32:46"
"13251","65","20090615100912","PC","AAA03","1","17000","3000","14000","2009-06-15 10:09:12"
"13252","36","20090615084909","Shop","AAA03","4","68000","12000","56000","2009-06-15 08:49:09"
"13253","80","20090609101241","PC","AAA01","3","30000","6000","24000","2009-06-09 22:12:41"
"13254","28","20090609055027","Shop","AAA04","3","24000","1200","22800","2009-06-09 17:50:27"
"13255","57","20090609104115","Mobile","AAA02","1","15000","2300","12700","2009-06-09 10:41:15"
"13256","8","20090609073905","Shop","AAA02","2","30000","4600","25400","2009-06-09 07:39:05"
"13257","94","20090604025507","PC","AAA04","2","16000","800","15200","2009-06-04 14:55:07"
"13258","51","20090604104438","PC","AAA03","1","17000","3000","14000","2009-06-04 10:44:38"
"13259","70","20090604064457","Mobile","AAA04","2","16000","800","15200","2009-06-04 06:44:57"
"13260","30","20090603084812","Mobile","AAA04","1","8000","400","7600","2009-06-03 20:48:12"
"13261","20","20090603024855","Mobile","AAA01","2","20000","4000","16000","2009-06-03 14:48:55"
"13262","80","20090603010601","PC","AAA01","1","10000","2000","8000","2009-06-03 13:06:01"
"13263","60","20090603071359","Mobile","AAA04","1","8000","400","7600","2009-06-03 07:13:59"
"13264","56","20090602051200","PC","AAA04","1","8000","400","7600","2009-06-02 17:12:00"
"13265","100","20090602023647","PC","AAA05","2","120000","40000","80000","2009-06-02 14:36:47"
"13266","21","20090602011037","PC","AAA01","3","30000","6000","24000","2009-06-02 13:10:37"
"13267","55","20090602112414","Mobile","AAA02","2","30000","4600","25400","2009-06-02 11:24:14"
"13268","39","20090602085825","Mobile","AAA04","2","16000","800","15200","2009-06-02 08:58:25"
"13269","74","20090601022735","Mobile","AAA04","2","16000","800","15200","2009-06-01 14:27:35"
"13270","88","20090601121116","Mobile","AAA03","1","17000","3000","14000","2009-06-01 12:11:16"
"13271","58","20090526064616","Shop","AAA04","1","8000","400","7600","2009-05-26 18:46:16"
"13272","3","20090526021419","Shop","AAA02","3","45000","6900","38100","2009-05-26 14:14:19"
"13273","76","20090526081825","PC","AAA02","1","15000","2300","12700","2009-05-26 08:18:25"
"13274","58","20090525123306","Mobile","AAA05","1","60000","20000","40000","2009-05-25 12:33:06"
"13275","42","20090525094028","Shop","AAA05","1","60000","20000","40000","2009-05-25 09:40:28"
"13276","82","20090522065732","PC","AAA01","1","10000","2000","8000","2009-05-22 06:57:32"
"13277","5","20090521021738","PC","AAA04","2","16000","800","15200","2009-05-21 02:17:38"
"13278","2","20090520070956","Mobile","AAA05","1","60000","20000","40000","2009-05-20 07:09:56"
"13279","94","20090519021259","Shop","AAA01","1","10000","2000","8000","2009-05-19 14:12:59"
"13280","10","20090519124601","Shop","AAA03","3","51000","9000","42000","2009-05-19 12:46:01"
"13281","49","20090519114418","Mobile","AAA01","3","30000","6000","24000","2009-05-19 11:44:18"
"13282","89","20090519093933","PC","AAA04","2","16000","800","15200","2009-05-19 09:39:33"
"13283","82","20090518095825","PC","AAA01","1","10000","2000","8000","2009-05-18 09:58:25"
"13284","23","20090514113146","Shop","AAA05","2","120000","40000","80000","2009-05-14 11:31:46"
"13285","9","20090514011629","Shop","AAA03","1","17000","3000","14000","2009-05-14 01:16:29"
"13286","67","20090513031025","Shop","AAA03","3","51000","9000","42000","2009-05-13 15:10:25"
"13287","27","20090513123838","PC","AAA02","2","30000","4600","25400","2009-05-13 12:38:38"
"13288","41","20090513105911","Mobile","AAA05","1","60000","20000","40000","2009-05-13 10:59:11"
"13289","72","20090513055023","Mobile","AAA01","1","10000","2000","8000","2009-05-13 05:50:23"
"13290","37","20090512063124","Mobile","AAA04","3","24000","1200","22800","2009-05-12 18:31:24"
"13291","65","20090512030832","PC","AAA03","2","34000","6000","28000","2009-05-12 15:08:32"
"13292","34","20090512125824","Shop","AAA05","2","120000","40000","80000","2009-05-12 12:58:24"
"13293","97","20090512111155","Shop","AAA01","2","20000","4000","16000","2009-05-12 11:11:55"
"13294","92","20090512092735","Shop","AAA01","1","10000","2000","8000","2009-05-12 09:27:35"
"13295","69","20090511025057","Mobile","AAA05","1","60000","20000","40000","2009-05-11 14:50:57"
"13296","69","20090511013513","Mobile","AAA01","1","10000","2000","8000","2009-05-11 13:35:13"
"13297","15","20090511113104","Shop","AAA01","1","10000","2000","8000","2009-05-11 11:31:04"
"13298","83","20090511090909","PC","AAA01","3","30000","6000","24000","2009-05-11 09:09:09"
"13299","41","20090509125449","Shop","AAA01","3","30000","6000","24000","2009-05-09 12:54:49"
"13300","51","20090507052937","Mobile","AAA02","1","15000","2300","12700","2009-05-07 05:29:37"
"13301","95","20090506120342","Shop","AAA01","1","10000","2000","8000","2009-05-06 12:03:42"
"13302","79","20090506111236","Mobile","AAA05","1","60000","20000","40000","2009-05-06 11:12:36"
"13303","25","20090506094722","PC","AAA05","2","120000","40000","80000","2009-05-06 09:47:22"
"13304","74","20090506074238","Shop","AAA03","2","34000","6000","28000","2009-05-06 07:42:38"
"13305","43","20090505071811","PC","AAA05","3","180000","60000","120000","2009-05-05 19:18:11"
"13306","70","20090505013043","PC","AAA04","5","40000","2000","38000","2009-05-05 13:30:43"
"13307","61","20090505104655","Shop","AAA02","1","15000","2300","12700","2009-05-05 10:46:55"
"13308","80","20090505091019","Shop","AAA03","1","17000","3000","14000","2009-05-05 09:10:19"
"13309","8","20090430105806","PC","AAA02","2","30000","4600","25400","2009-04-30 10:58:06"
"13310","8","20090429053035","Shop","AAA05","4","240000","80000","160000","2009-04-29 17:30:35"
"13311","59","20090429031542","Mobile","AAA02","1","15000","2300","12700","2009-04-29 15:15:42"
"13312","100","20090429112719","Shop","AAA01","1","10000","2000","8000","2009-04-29 11:27:19"
"13313","94","20090429090024","Mobile","AAA04","1","8000","400","7600","2009-04-29 09:00:24"
"13314","25","20090429071235","Shop","AAA04","2","16000","800","15200","2009-04-29 07:12:35"
"13315","29","20090428102123","Shop","AAA05","3","180000","60000","120000","2009-04-28 10:21:23"
"13316","87","20090428071110","PC","AAA02","2","30000","4600","25400","2009-04-28 07:11:10"
"13317","23","20090427030242","Mobile","AAA02","2","30000","4600","25400","2009-04-27 15:02:42"
"13318","26","20090427122726","PC","AAA04","1","8000","400","7600","2009-04-27 12:27:26"
"13319","38","20090427101218","Shop","AAA01","1","10000","2000","8000","2009-04-27 10:12:18"
"13320","83","20090427080215","Mobile","AAA01","1","10000","2000","8000","2009-04-27 08:02:15"
"13321","7","20090423025731","Shop","AAA01","2","20000","4000","16000","2009-04-23 14:57:31"
"13322","56","20090423110000","Mobile","AAA04","1","8000","400","7600","2009-04-23 11:00:00"
"13323","83","20090423085019","Shop","AAA01","1","10000","2000","8000","2009-04-23 08:50:19"
"13324","8","20090423065855","Mobile","AAA02","1","15000","2300","12700","2009-04-23 06:58:55"
"13325","1","20090422092505","Shop","AAA01","3","30000","6000","24000","2009-04-22 09:25:05"
"13326","63","20090422064619","Shop","AAA05","1","60000","20000","40000","2009-04-22 06:46:19"
"13327","5","20090421050712","Shop","AAA01","1","10000","2000","8000","2009-04-21 17:07:12"
"13328","17","20090421030932","PC","AAA02","2","30000","4600","25400","2009-04-21 15:09:32"
"13329","67","20090421014053","Shop","AAA02","2","30000","4600","25400","2009-04-21 13:40:53"
"13330","8","20090421125813","PC","AAA03","2","34000","6000","28000","2009-04-21 12:58:13"
"13331","51","20090421112300","Mobile","AAA03","1","17000","3000","14000","2009-04-21 11:23:00"
"13332","94","20090421102413","PC","AAA03","1","17000","3000","14000","2009-04-21 10:24:13"
"13333","37","20090420110237","Mobile","AAA01","1","10000","2000","8000","2009-04-20 11:02:37"
"13334","44","20090420092842","PC","AAA04","2","16000","800","15200","2009-04-20 09:28:42"
"13335","63","20090417071319","Shop","AAA05","1","60000","20000","40000","2009-04-17 07:13:19"
"13336","55","20090416103753","PC","AAA05","1","60000","20000","40000","2009-04-16 10:37:53"
"13337","89","20090416085941","Shop","AAA04","1","8000","400","7600","2009-04-16 08:59:41"
"13338","37","20090416074658","Shop","AAA02","2","30000","4600","25400","2009-04-16 07:46:58"
"13339","64","20090415044351","Shop","AAA05","3","180000","60000","120000","2009-04-15 16:43:51"
"13340","48","20090415024202","PC","AAA01","3","30000","6000","24000","2009-04-15 14:42:02"
"13341","4","20090415013710","Mobile","AAA05","1","60000","20000","40000","2009-04-15 13:37:10"
"13342","65","20090415074511","Mobile","AAA02","1","15000","2300","12700","2009-04-15 07:45:11"
"13343","47","20090414121201","PC","AAA05","1","60000","20000","40000","2009-04-14 12:12:01"
"13344","54","20090414102053","PC","AAA01","1","10000","2000","8000","2009-04-14 10:20:53"
"13345","39","20090414081822","PC","AAA02","2","30000","4600","25400","2009-04-14 08:18:22"
"13346","43","20090414065033","Shop","AAA04","1","8000","400","7600","2009-04-14 06:50:33"
"13347","29","20090413085352","Shop","AAA01","1","10000","2000","8000","2009-04-13 08:53:52"
"13348","5","20090407085951","Shop","AAA05","2","120000","40000","80000","2009-04-07 08:59:51"
"13349","16","20090407065220","Shop","AAA03","1","17000","3000","14000","2009-04-07 06:52:20"
"13350","88","20090406013848","Mobile","AAA01","1","10000","2000","8000","2009-04-06 13:38:48"
"13351","58","20090406115534","Mobile","AAA03","1","17000","3000","14000","2009-04-06 11:55:34"
"13352","20","20090331104940","Mobile","AAA03","1","17000","3000","14000","2009-03-31 10:49:40"
"13353","34","20090331105904","Shop","AAA05","3","180000","60000","120000","2009-03-31 10:59:04"
"13354","78","20090331092127","Shop","AAA03","1","17000","3000","14000","2009-03-31 09:21:27"
"13355","54","20090331023933","Mobile","AAA01","3","30000","6000","24000","2009-03-31 02:39:33"
"13356","38","20090330033650","Mobile","AAA04","2","16000","800","15200","2009-03-30 15:36:50"
"13357","65","20090330011314","Shop","AAA04","2","16000","800","15200","2009-03-30 13:13:14"
"13358","84","20090330110908","Mobile","AAA01","1","10000","2000","8000","2009-03-30 11:09:08"
"13359","39","20090325074009","PC","AAA01","1","10000","2000","8000","2009-03-25 19:40:09"
"13360","65","20090325060409","PC","AAA05","2","120000","40000","80000","2009-03-25 18:04:09"
"13361","52","20090325104403","Shop","AAA04","1","8000","400","7600","2009-03-25 10:44:03"
"13362","46","20090325083135","PC","AAA03","2","34000","6000","28000","2009-03-25 08:31:35"
"13363","40","20090325071314","Mobile","AAA03","1","17000","3000","14000","2009-03-25 07:13:14"
"13364","67","20090324120511","Shop","AAA05","1","60000","20000","40000","2009-03-24 12:05:11"
"13365","11","20090324093541","Mobile","AAA05","1","60000","20000","40000","2009-03-24 09:35:41"
"13366","94","20090324073928","PC","AAA02","2","30000","4600","25400","2009-03-24 07:39:28"
"13367","83","20090323064930","Shop","AAA04","1","8000","400","7600","2009-03-23 18:49:30"
"13368","99","20090323024246","PC","AAA03","1","17000","3000","14000","2009-03-23 14:42:46"
"13369","99","20090323015316","PC","AAA05","1","60000","20000","40000","2009-03-23 13:53:16"
"13370","17","20090323112939","Shop","AAA05","1","60000","20000","40000","2009-03-23 11:29:39"
"13371","33","20090323094948","Mobile","AAA04","2","16000","800","15200","2009-03-23 09:49:48"
"13372","58","20090320083743","Mobile","AAA05","1","60000","20000","40000","2009-03-20 20:37:43"
"13373","4","20090320051702","Shop","AAA03","1","17000","3000","14000","2009-03-20 17:17:02"
"13374","26","20090320014007","Shop","AAA01","2","20000","4000","16000","2009-03-20 13:40:07"
"13375","30","20090320120336","Shop","AAA01","1","10000","2000","8000","2009-03-20 12:03:36"
"13376","68","20090320102746","Mobile","AAA04","1","8000","400","7600","2009-03-20 10:27:46"
"13377","59","20090320094452","PC","AAA04","1","8000","400","7600","2009-03-20 09:44:52"
"13378","60","20090320082253","Mobile","AAA02","1","15000","2300","12700","2009-03-20 08:22:53"
"13379","3","20090320061804","Mobile","AAA05","1","60000","20000","40000","2009-03-20 06:18:04"
"13380","97","20090318110426","Mobile","AAA03","3","51000","9000","42000","2009-03-18 23:04:26"
"13381","48","20090317073715","Mobile","AAA04","1","8000","400","7600","2009-03-17 19:37:15"
"13382","72","20090317032008","Shop","AAA05","2","120000","40000","80000","2009-03-17 15:20:08"
"13383","12","20090317014505","Shop","AAA05","1","60000","20000","40000","2009-03-17 13:45:05"
"13384","3","20090317114902","Shop","AAA03","1","17000","3000","14000","2009-03-17 11:49:02"
"13385","49","20090317080249","PC","AAA05","2","120000","40000","80000","2009-03-17 08:02:49"
"13386","46","20090317062705","Mobile","AAA04","2","16000","800","15200","2009-03-17 06:27:05"
"13387","44","20090316043755","PC","AAA03","1","17000","3000","14000","2009-03-16 16:37:55"
"13388","5","20090316122332","PC","AAA02","2","30000","4600","25400","2009-03-16 12:23:32"
"13389","36","20090316110256","PC","AAA04","1","8000","400","7600","2009-03-16 11:02:56"
"13390","49","20090316083120","Mobile","AAA01","1","10000","2000","8000","2009-03-16 08:31:20"
"13391","96","20090311035056","Shop","AAA01","1","10000","2000","8000","2009-03-11 15:50:56"
"13392","35","20090311014032","Shop","AAA04","1","8000","400","7600","2009-03-11 13:40:32"
"13393","81","20090311114644","Mobile","AAA02","1","15000","2300","12700","2009-03-11 11:46:44"
"13394","80","20090311095620","PC","AAA02","1","15000","2300","12700","2009-03-11 09:56:20"
"13395","51","20090310102806","PC","AAA04","3","24000","1200","22800","2009-03-10 10:28:06"
"13396","100","20090310084715","Shop","AAA02","1","15000","2300","12700","2009-03-10 08:47:15"
"13397","32","20090310065256","PC","AAA05","1","60000","20000","40000","2009-03-10 06:52:56"
"13398","66","20090309085127","Mobile","AAA01","1","10000","2000","8000","2009-03-09 08:51:27"
"13399","10","20090304090214","PC","AAA05","1","60000","20000","40000","2009-03-04 09:02:14"
"13400","84","20090304061719","Mobile","AAA05","1","60000","20000","40000","2009-03-04 06:17:19"
"13401","60","20090303021407","Mobile","AAA04","1","8000","400","7600","2009-03-03 14:14:07"
"13402","30","20090303125209","PC","AAA05","1","60000","20000","40000","2009-03-03 12:52:09"
"13403","89","20090303103523","Shop","AAA01","1","10000","2000","8000","2009-03-03 10:35:23"
"13404","88","20090303091854","Mobile","AAA04","1","8000","400","7600","2009-03-03 09:18:54"
"13405","28","20090303065428","Shop","AAA02","3","45000","6900","38100","2009-03-03 06:54:28"
"13406","43","20090302030937","Shop","AAA02","1","15000","2300","12700","2009-03-02 15:09:37"
"13407","1","20090302102027","PC","AAA04","4","32000","1600","30400","2009-03-02 10:20:27"
"13408","90","20090302081417","Shop","AAA05","1","60000","20000","40000","2009-03-02 08:14:17"
"13409","81","20090225061315","Shop","AAA03","1","17000","3000","14000","2009-02-25 18:13:15"
"13410","23","20090225012147","Shop","AAA02","1","15000","2300","12700","2009-02-25 13:21:47"
"13411","89","20090225112319","PC","AAA05","2","120000","40000","80000","2009-02-25 11:23:19"
"13412","64","20090225065110","Mobile","AAA01","2","20000","4000","16000","2009-02-25 06:51:10"
"13413","28","20090224084231","PC","AAA05","1","60000","20000","40000","2009-02-24 08:42:31"
"13414","25","20090224065928","Mobile","AAA01","2","20000","4000","16000","2009-02-24 06:59:28"
"13415","57","20090223024635","Mobile","AAA01","1","10000","2000","8000","2009-02-23 14:46:35"
"13416","86","20090223115921","Shop","AAA05","1","60000","20000","40000","2009-02-23 11:59:21"
"13417","42","20090223082321","Shop","AAA04","2","16000","800","15200","2009-02-23 08:23:21"
"13418","80","20090217052818","Shop","AAA02","2","30000","4600","25400","2009-02-17 17:28:18"
"13419","47","20090217023145","PC","AAA05","1","60000","20000","40000","2009-02-17 14:31:45"
"13420","41","20090217121918","Mobile","AAA02","1","15000","2300","12700","2009-02-17 12:19:18"
"13421","33","20090217104431","PC","AAA01","1","10000","2000","8000","2009-02-17 10:44:31"
"13422","100","20090216025327","Mobile","AAA03","1","17000","3000","14000","2009-02-16 14:53:27"
"13423","41","20090216124732","PC","AAA03","2","34000","6000","28000","2009-02-16 12:47:32"
"13424","16","20090216110443","PC","AAA05","3","180000","60000","120000","2009-02-16 11:04:43"
"13425","96","20090216092805","Shop","AAA05","2","120000","40000","80000","2009-02-16 09:28:05"
"13426","96","20090208111125","Mobile","AAA02","2","30000","4600","25400","2009-02-08 23:11:25"
"13427","97","20090205010949","PC","AAA04","1","8000","400","7600","2009-02-05 13:09:49"
"13428","74","20090205112501","Mobile","AAA04","1","8000","400","7600","2009-02-05 11:25:01"
"13429","4","20090205092222","Shop","AAA04","1","8000","400","7600","2009-02-05 09:22:22"
"13430","39","20090205074020","Shop","AAA02","2","30000","4600","25400","2009-02-05 07:40:20"
"13431","68","20090204023501","PC","AAA02","1","15000","2300","12700","2009-02-04 14:35:01"
"13432","28","20090204124423","Shop","AAA01","2","20000","4000","16000","2009-02-04 12:44:23"
"13433","73","20090204095333","PC","AAA05","1","60000","20000","40000","2009-02-04 09:53:33"
"13434","92","20090204073300","Mobile","AAA05","2","120000","40000","80000","2009-02-04 07:33:00"
"13435","61","20090203100059","Shop","AAA04","1","8000","400","7600","2009-02-03 22:00:59"
"13436","41","20090203042110","Shop","AAA05","3","180000","60000","120000","2009-02-03 16:21:10"
"13437","71","20090203020722","Mobile","AAA03","3","51000","9000","42000","2009-02-03 14:07:22"
"13438","73","20090203115621","Shop","AAA03","2","34000","6000","28000","2009-02-03 11:56:21"
"13439","68","20090203094510","Mobile","AAA04","1","8000","400","7600","2009-02-03 09:45:10"
"13440","84","20090202053353","Shop","AAA03","1","17000","3000","14000","2009-02-02 17:33:53"
"13441","83","20090202035325","Shop","AAA01","4","40000","8000","32000","2009-02-02 15:53:25"
"13442","34","20090202020233","PC","AAA04","3","24000","1200","22800","2009-02-02 14:02:33"
"13443","47","20090202122729","PC","AAA02","1","15000","2300","12700","2009-02-02 12:27:29"
"13444","77","20090202101635","Shop","AAA01","1","10000","2000","8000","2009-02-02 10:16:35"
"13445","85","20090128102351","Shop","AAA03","1","17000","3000","14000","2009-01-28 10:23:51"
"13446","22","20090128082650","Mobile","AAA02","1","15000","2300","12700","2009-01-28 08:26:50"
"13447","50","20090128064640","PC","AAA04","1","8000","400","7600","2009-01-28 06:46:40"
"13448","55","20090126111931","Mobile","AAA04","2","16000","800","15200","2009-01-26 11:19:31"
"13449","6","20090126092016","Mobile","AAA02","1","15000","2300","12700","2009-01-26 09:20:16"
"13450","51","20090122092944","PC","AAA05","1","60000","20000","40000","2009-01-22 09:29:44"
"13451","14","20090122070817","Shop","AAA03","1","17000","3000","14000","2009-01-22 07:08:17"
"13452","32","20090121105300","Shop","AAA03","2","34000","6000","28000","2009-01-21 10:53:00"
"13453","54","20090121071519","Shop","AAA03","1","17000","3000","14000","2009-01-21 07:15:19"
"13454","12","20090120102616","PC","AAA02","1","15000","2300","12700","2009-01-20 10:26:16"
"13455","19","20090120082304","PC","AAA03","1","17000","3000","14000","2009-01-20 08:23:04"
"13456","36","20090120062352","Mobile","AAA01","3","30000","6000","24000","2009-01-20 06:23:52"
"13457","89","20090115032944","Shop","AAA05","2","120000","40000","80000","2009-01-15 15:29:44"
"13458","55","20090115014827","PC","AAA02","1","15000","2300","12700","2009-01-15 13:48:27"
"13459","23","20090115114010","PC","AAA02","2","30000","4600","25400","2009-01-15 11:40:10"
"13460","90","20090115093125","Shop","AAA05","1","60000","20000","40000","2009-01-15 09:31:25"
"13461","79","20090115073923","Shop","AAA03","1","17000","3000","14000","2009-01-15 07:39:23"
"13462","27","20090114091801","PC","AAA05","3","180000","60000","120000","2009-01-14 09:18:01"
"13463","82","20090113083911","PC","AAA05","1","60000","20000","40000","2009-01-13 08:39:11"
"13464","64","20090112111007","Shop","AAA02","3","45000","6900","38100","2009-01-12 11:10:07"
"13465","83","20090112104151","Shop","AAA02","4","60000","9200","50800","2009-01-12 10:41:51"
"13466","61","20090112082640","Shop","AAA01","1","10000","2000","8000","2009-01-12 08:26:40"
"13467","9","20090106104446","Mobile","AAA03","1","17000","3000","14000","2009-01-06 22:44:46"
"13468","99","20090106105146","Shop","AAA04","1","8000","400","7600","2009-01-06 22:51:46"
"13469","23","20090106072911","Shop","AAA04","1","8000","400","7600","2009-01-06 19:29:11"
"13470","21","20090106080208","Mobile","AAA01","2","20000","4000","16000","2009-01-06 20:02:08"
"13471","86","20090106032845","PC","AAA01","1","10000","2000","8000","2009-01-06 15:28:45"
"13472","81","20090106022505","Shop","AAA04","1","8000","400","7600","2009-01-06 14:25:05"
"13473","37","20090106012006","Shop","AAA04","1","8000","400","7600","2009-01-06 13:20:06"
"13474","4","20090106120958","PC","AAA01","1","10000","2000","8000","2009-01-06 12:09:58"
"13475","51","20090106083049","Mobile","AAA02","4","60000","9200","50800","2009-01-06 08:30:49"
"13476","27","20090106062956","Shop","AAA01","2","20000","4000","16000","2009-01-06 06:29:56"
"13477","60","20090105051342","Shop","AAA01","2","20000","4000","16000","2009-01-05 17:13:42"
"13478","7","20090105025825","Mobile","AAA04","1","8000","400","7600","2009-01-05 14:58:25"
"13479","64","20090105012213","PC","AAA01","2","20000","4000","16000","2009-01-05 13:22:13"
"13480","19","20090105102407","PC","AAA03","1","17000","3000","14000","2009-01-05 10:24:07"
"13481","52","20081230123523","Mobile","AAA03","1","17000","3000","14000","2008-12-30 00:35:23"
"13482","6","20081229010511","Shop","AAA03","1","17000","3000","14000","2008-12-29 01:05:11"
"13483","25","20081223103543","Shop","AAA02","1","15000","2300","12700","2008-12-23 10:35:43"
"13484","38","20081223094349","PC","AAA05","1","60000","20000","40000","2008-12-23 09:43:49"
"13485","68","20081222033323","Mobile","AAA01","1","10000","2000","8000","2008-12-22 03:33:23"
"13486","14","20081216014310","Shop","AAA03","1","17000","3000","14000","2008-12-16 01:43:10"
"13487","21","20081215105404","Shop","AAA01","1","10000","2000","8000","2008-12-15 10:54:04"
"13488","45","20081215093828","Shop","AAA02","1","15000","2300","12700","2008-12-15 09:38:28"
"13489","63","20081212070248","Shop","AAA02","1","15000","2300","12700","2008-12-12 19:02:48"
"13490","77","20081212013539","PC","AAA04","1","8000","400","7600","2008-12-12 13:35:39"
"13491","50","20081212115806","PC","AAA04","1","8000","400","7600","2008-12-12 11:58:06"
"13492","38","20081212080252","Shop","AAA05","1","60000","20000","40000","2008-12-12 08:02:52"
"13493","41","20081209051136","Shop","AAA03","1","17000","3000","14000","2008-12-09 17:11:36"
"13494","18","20081209040015","PC","AAA03","1","17000","3000","14000","2008-12-09 16:00:15"
"13495","8","20081209032324","Shop","AAA04","1","8000","400","7600","2008-12-09 15:23:24"
"13496","3","20081209115645","Mobile","AAA01","2","20000","4000","16000","2008-12-09 11:56:45"
"13497","69","20081209095832","PC","AAA01","1","10000","2000","8000","2008-12-09 09:58:32"
"13498","88","20081208121745","PC","AAA04","1","8000","400","7600","2008-12-08 12:17:45"
"13499","45","20081208101239","Shop","AAA04","1","8000","400","7600","2008-12-08 10:12:39"
"13500","18","20081208080918","Mobile","AAA05","1","60000","20000","40000","2008-12-08 08:09:18"
"13501","96","20081204030655","PC","AAA05","2","120000","40000","80000","2008-12-04 03:06:55"
"13502","80","20081203062216","PC","AAA02","1","15000","2300","12700","2008-12-03 18:22:16"
"13503","20","20081203022914","PC","AAA01","1","10000","2000","8000","2008-12-03 14:29:14"
"13504","69","20081203082333","Shop","AAA05","1","60000","20000","40000","2008-12-03 08:23:33"
"13505","51","20081203060439","PC","AAA03","2","34000","6000","28000","2008-12-03 06:04:39"
"13506","30","20081202084305","PC","AAA04","1","8000","400","7600","2008-12-02 08:43:05"
"13507","25","20081202072034","Shop","AAA05","1","60000","20000","40000","2008-12-02 07:20:34"
"13508","4","20081201121948","PC","AAA02","1","15000","2300","12700","2008-12-01 12:19:48"
"13509","73","20081127025101","PC","AAA03","1","17000","3000","14000","2008-11-27 14:51:01"
"13510","16","20081127121449","Mobile","AAA05","1","60000","20000","40000","2008-11-27 12:14:49"
"13511","6","20081127072749","PC","AAA03","1","17000","3000","14000","2008-11-27 07:27:49"
"13512","32","20081127040906","PC","AAA04","1","8000","400","7600","2008-11-27 04:09:06"
"13513","100","20081126032046","Shop","AAA02","1","15000","2300","12700","2008-11-26 15:20:46"
"13514","62","20081126103023","PC","AAA02","1","15000","2300","12700","2008-11-26 10:30:23"
"13515","30","20081126083055","PC","AAA01","1","10000","2000","8000","2008-11-26 08:30:55"
"13516","11","20081125101818","Mobile","AAA04","1","8000","400","7600","2008-11-25 10:18:18"
"13517","47","20081125080326","Shop","AAA05","2","120000","40000","80000","2008-11-25 08:03:26"
"13518","82","20081125054119","PC","AAA03","2","34000","6000","28000","2008-11-25 05:41:19"
"13519","65","20081124051854","PC","AAA01","1","10000","2000","8000","2008-11-24 05:18:54"
"13520","62","20081122084936","Shop","AAA03","1","17000","3000","14000","2008-11-22 08:49:36"
"13521","21","20081121013228","Shop","AAA03","1","17000","3000","14000","2008-11-21 13:32:28"
"13522","6","20081121095053","PC","AAA05","1","60000","20000","40000","2008-11-21 09:50:53"
"13523","39","20081120114821","Mobile","AAA05","1","60000","20000","40000","2008-11-20 11:48:21"
"13524","84","20081120101103","Mobile","AAA05","1","60000","20000","40000","2008-11-20 10:11:03"
"13525","66","20081120090446","PC","AAA01","1","10000","2000","8000","2008-11-20 09:04:46"
"13526","23","20081119025742","Mobile","AAA05","1","60000","20000","40000","2008-11-19 14:57:42"
"13527","27","20081119010010","PC","AAA03","1","17000","3000","14000","2008-11-19 13:00:10"
"13528","97","20081119103641","PC","AAA03","2","34000","6000","28000","2008-11-19 10:36:41"
"13529","34","20081119083129","Shop","AAA02","1","15000","2300","12700","2008-11-19 08:31:29"
"13530","83","20081119062107","PC","AAA05","2","120000","40000","80000","2008-11-19 06:21:07"
"13531","45","20081118040119","PC","AAA02","1","15000","2300","12700","2008-11-18 04:01:19"
"13532","51","20081117035833","Shop","AAA05","1","60000","20000","40000","2008-11-17 15:58:33"
"13533","86","20081117013522","Shop","AAA05","1","60000","20000","40000","2008-11-17 13:35:22"
"13534","55","20081117112632","PC","AAA01","1","10000","2000","8000","2008-11-17 11:26:32"
"13535","65","20081113110117","Mobile","AAA04","1","8000","400","7600","2008-11-13 11:01:17"
"13536","37","20081113065015","PC","AAA04","1","8000","400","7600","2008-11-13 06:50:15"
"13537","11","20081111110659","Shop","AAA02","1","15000","2300","12700","2008-11-11 23:06:59"
"13538","26","20081111052435","Shop","AAA05","1","60000","20000","40000","2008-11-11 05:24:35"
"13539","48","20081105073120","Shop","AAA02","2","30000","4600","25400","2008-11-05 07:31:20"
"13540","7","20081104112547","Mobile","AAA02","1","15000","2300","12700","2008-11-04 11:25:47"
"13541","56","20081104090109","Shop","AAA04","1","8000","400","7600","2008-11-04 09:01:09"
"13542","3","20081104064057","Mobile","AAA04","2","16000","800","15200","2008-11-04 06:40:57"
"13543","47","20081103103721","Mobile","AAA05","1","60000","20000","40000","2008-11-03 10:37:21"
"13544","5","20081103085623","Shop","AAA05","1","60000","20000","40000","2008-11-03 08:56:23"
"13545","80","20081029050852","Mobile","AAA05","1","60000","20000","40000","2008-10-29 17:08:52"
"13546","3","20081029032729","Mobile","AAA04","1","8000","400","7600","2008-10-29 15:27:29"
"13547","65","20081029010110","PC","AAA02","1","15000","2300","12700","2008-10-29 13:01:10"
"13548","52","20081029124341","PC","AAA01","1","10000","2000","8000","2008-10-29 12:43:41"
"13549","76","20081029103248","PC","AAA01","1","10000","2000","8000","2008-10-29 10:32:48"
"13550","62","20081027103020","PC","AAA01","1","10000","2000","8000","2008-10-27 10:30:20"
"13551","69","20081027090450","Shop","AAA02","1","15000","2300","12700","2008-10-27 09:04:50"
"13552","18","20081024074625","Shop","AAA04","1","8000","400","7600","2008-10-24 19:46:25"
"13553","46","20081024065348","Shop","AAA01","1","10000","2000","8000","2008-10-24 18:53:48"
"13554","60","20081024094431","PC","AAA02","1","15000","2300","12700","2008-10-24 09:44:31"
"13555","63","20081023013944","Mobile","AAA04","1","8000","400","7600","2008-10-23 13:39:44"
"13556","1","20081023050648","Mobile","AAA03","1","17000","3000","14000","2008-10-23 05:06:48"
"13557","93","20081022103841","Shop","AAA01","1","10000","2000","8000","2008-10-22 10:38:41"
"13558","96","20081022095205","Shop","AAA04","1","8000","400","7600","2008-10-22 09:52:05"
"13559","37","20081021080522","PC","AAA04","1","8000","400","7600","2008-10-21 20:05:22"
"13560","92","20081021025617","Mobile","AAA05","2","120000","40000","80000","2008-10-21 14:56:17"
"13561","17","20081021124622","Shop","AAA05","2","120000","40000","80000","2008-10-21 12:46:22"
"13562","16","20081021070841","Shop","AAA02","1","15000","2300","12700","2008-10-21 07:08:41"
"13563","80","20081020101013","Shop","AAA01","1","10000","2000","8000","2008-10-20 10:10:13"
"13564","39","20081020083431","Shop","AAA01","1","10000","2000","8000","2008-10-20 08:34:31"
"13565","88","20081014013230","Mobile","AAA05","1","60000","20000","40000","2008-10-14 01:32:30"
"13566","98","20081013102849","PC","AAA01","1","10000","2000","8000","2008-10-13 10:28:49"
"13567","97","20081009052445","Mobile","AAA01","1","10000","2000","8000","2008-10-09 05:24:45"
"13568","90","20081008051534","Mobile","AAA02","1","15000","2300","12700","2008-10-08 17:15:34"
"13569","96","20081008111019","PC","AAA04","1","8000","400","7600","2008-10-08 11:10:19"
"13570","73","20081006074911","Shop","AAA05","1","60000","20000","40000","2008-10-06 19:49:11"
"13571","3","20081006023223","PC","AAA04","1","8000","400","7600","2008-10-06 14:32:23"
"13572","47","20081006124633","PC","AAA01","1","10000","2000","8000","2008-10-06 12:46:33"
"13573","95","20081006101806","Shop","AAA01","1","10000","2000","8000","2008-10-06 10:18:06"
"13574","51","20081006084556","Shop","AAA03","1","17000","3000","14000","2008-10-06 08:45:56"
"13575","68","20081001013742","Shop","AAA03","1","17000","3000","14000","2008-10-01 13:37:42"
"13576","14","20081001114706","Shop","AAA05","1","60000","20000","40000","2008-10-01 11:47:06"
"13577","82","20081001070701","Mobile","AAA05","1","60000","20000","40000","2008-10-01 07:07:01"
"13578","25","20080930102746","PC","AAA04","2","16000","800","15200","2008-09-30 10:27:46"
"13579","56","20080930070411","Shop","AAA03","1","17000","3000","14000","2008-09-30 07:04:11"
"13580","19","20080927112325","Mobile","AAA03","1","17000","3000","14000","2008-09-27 11:23:25"
"13581","34","20080926070348","Shop","AAA02","2","30000","4600","25400","2008-09-26 19:03:48"
"13582","80","20080926014111","Mobile","AAA02","1","15000","2300","12700","2008-09-26 13:41:11"
"13583","45","20080926102732","Shop","AAA01","1","10000","2000","8000","2008-09-26 10:27:32"
"13584","58","20080925095002","Shop","AAA02","1","15000","2300","12700","2008-09-25 09:50:02"
"13585","82","20080925074303","Mobile","AAA05","1","60000","20000","40000","2008-09-25 07:43:03"
"13586","80","20080924115403","PC","AAA05","1","60000","20000","40000","2008-09-24 11:54:03"
"13587","64","20080924100241","Mobile","AAA01","1","10000","2000","8000","2008-09-24 10:02:41"
"13588","32","20080924063708","PC","AAA03","1","17000","3000","14000","2008-09-24 06:37:08"
"13589","93","20080923094704","Mobile","AAA05","1","60000","20000","40000","2008-09-23 09:47:04"
"13590","64","20080922124342","PC","AAA05","2","120000","40000","80000","2008-09-22 00:43:42"
"13591","1","20080915013129","PC","AAA03","1","17000","3000","14000","2008-09-15 13:31:29"
"13592","50","20080915113044","Shop","AAA05","1","60000","20000","40000","2008-09-15 11:30:44"
"13593","51","20080915090100","Mobile","AAA04","2","16000","800","15200","2008-09-15 09:01:00"
"13594","97","20080909011422","Shop","AAA02","1","15000","2300","12700","2008-09-09 13:14:22"
"13595","17","20080909111146","Mobile","AAA05","1","60000","20000","40000","2008-09-09 11:11:46"
"13596","13","20080909081407","Shop","AAA04","1","8000","400","7600","2008-09-09 08:14:07"
"13597","64","20080909054430","Shop","AAA03","3","51000","9000","42000","2008-09-09 05:44:30"
"13598","12","20080908111207","PC","AAA05","1","60000","20000","40000","2008-09-08 11:12:07"
"13599","49","20080908094404","Mobile","AAA05","1","60000","20000","40000","2008-09-08 09:44:04"
"13600","15","20080904023902","PC","AAA04","2","16000","800","15200","2008-09-04 02:39:02"
"13601","96","20080903032645","Shop","AAA04","2","16000","800","15200","2008-09-03 15:26:45"
"13602","59","20080903020852","Shop","AAA03","1","17000","3000","14000","2008-09-03 14:08:52"
"13603","43","20080903100333","PC","AAA05","1","60000","20000","40000","2008-09-03 10:03:33"
"13604","47","20080903083149","Mobile","AAA01","1","10000","2000","8000","2008-09-03 08:31:49"
"13605","71","20080902120341","PC","AAA01","1","10000","2000","8000","2008-09-02 12:03:41"
"13606","17","20080902103029","PC","AAA04","1","8000","400","7600","2008-09-02 10:30:29"
"13607","83","20080902070733","Shop","AAA05","1","60000","20000","40000","2008-09-02 07:07:33"
"13608","54","20080901071411","PC","AAA04","1","8000","400","7600","2008-09-01 19:14:11"
"13609","37","20080820044845","Shop","AAA05","1","60000","20000","40000","2008-08-20 04:48:45"
"13610","38","20080819010648","Mobile","AAA02","1","15000","2300","12700","2008-08-19 13:06:48"
"13611","99","20080819111227","Mobile","AAA01","1","10000","2000","8000","2008-08-19 11:12:27"
"13612","17","20080819065836","PC","AAA05","1","60000","20000","40000","2008-08-19 06:58:36"
"13613","83","20080818030306","Shop","AAA05","2","120000","40000","80000","2008-08-18 15:03:06"
"13614","7","20080818124103","PC","AAA02","1","15000","2300","12700","2008-08-18 12:41:03"
"13615","32","20080818095939","Shop","AAA01","1","10000","2000","8000","2008-08-18 09:59:39"
"13616","14","20080814105240","Shop","AAA05","1","60000","20000","40000","2008-08-14 22:52:40"
"13617","24","20080814035218","Mobile","AAA02","1","15000","2300","12700","2008-08-14 15:52:18"
"13618","14","20080814072222","Mobile","AAA05","1","60000","20000","40000","2008-08-14 07:22:22"
"13619","99","20080813115722","Mobile","AAA05","1","60000","20000","40000","2008-08-13 11:57:22"
"13620","37","20080813111044","PC","AAA02","1","15000","2300","12700","2008-08-13 11:10:44"
"13621","70","20080813071318","Shop","AAA02","2","30000","4600","25400","2008-08-13 07:13:18"
"13622","35","20080812032931","PC","AAA02","1","15000","2300","12700","2008-08-12 15:29:31"
"13623","13","20080812015450","Shop","AAA01","1","10000","2000","8000","2008-08-12 13:54:50"
"13624","49","20080812010851","Shop","AAA03","2","34000","6000","28000","2008-08-12 13:08:51"
"13625","46","20080812091414","Shop","AAA02","1","15000","2300","12700","2008-08-12 09:14:14"
"13626","10","20080812073235","PC","AAA05","2","120000","40000","80000","2008-08-12 07:32:35"
"13627","1","20080811043044","Shop","AAA03","1","17000","3000","14000","2008-08-11 16:30:44"
"13628","49","20080811025333","Shop","AAA05","1","60000","20000","40000","2008-08-11 14:53:33"
"13629","40","20080811010431","PC","AAA02","1","15000","2300","12700","2008-08-11 13:04:31"
"13630","32","20080811113407","PC","AAA02","1","15000","2300","12700","2008-08-11 11:34:07"
"13631","96","20080811091419","Mobile","AAA03","1","17000","3000","14000","2008-08-11 09:14:19"
"13632","96","20080807064050","PC","AAA02","1","15000","2300","12700","2008-08-07 18:40:50"
"13633","25","20080807110725","Shop","AAA05","1","60000","20000","40000","2008-08-07 11:07:25"
"13634","82","20080807090308","PC","AAA02","1","15000","2300","12700","2008-08-07 09:03:08"
"13635","44","20080807053437","Mobile","AAA03","1","17000","3000","14000","2008-08-07 05:34:37"
"13636","94","20080806015649","PC","AAA04","1","8000","400","7600","2008-08-06 13:56:49"
"13637","92","20080806121342","PC","AAA02","1","15000","2300","12700","2008-08-06 12:13:42"
"13638","28","20080806101310","PC","AAA03","1","17000","3000","14000","2008-08-06 10:13:10"
"13639","59","20080806074957","Mobile","AAA01","1","10000","2000","8000","2008-08-06 07:49:57"
"13640","85","20080805085125","Shop","AAA03","2","34000","6000","28000","2008-08-05 20:51:25"
"13641","85","20080805061530","Mobile","AAA05","1","60000","20000","40000","2008-08-05 18:15:30"
"13642","78","20080805022755","Shop","AAA05","1","60000","20000","40000","2008-08-05 14:27:55"
"13643","16","20080805081627","Mobile","AAA03","1","17000","3000","14000","2008-08-05 08:16:27"
"13644","58","20080805063348","Mobile","AAA04","1","8000","400","7600","2008-08-05 06:33:48"
"13645","54","20080804105542","Shop","AAA02","1","15000","2300","12700","2008-08-04 22:55:42"
"13646","8","20080804023156","Mobile","AAA01","1","10000","2000","8000","2008-08-04 14:31:56"
"13647","63","20080804100724","Shop","AAA03","1","17000","3000","14000","2008-08-04 10:07:24"
"13648","53","20080804072532","PC","AAA03","1","17000","3000","14000","2008-08-04 07:25:32"
"13649","22","20080729051544","Shop","AAA02","1","15000","2300","12700","2008-07-29 05:15:44"
"13650","25","20080728124038","PC","AAA05","1","60000","20000","40000","2008-07-28 12:40:38"
"13651","98","20080728102913","Mobile","AAA02","1","15000","2300","12700","2008-07-28 10:29:13"
"13652","56","20080722115959","PC","AAA02","1","15000","2300","12700","2008-07-22 23:59:59"
"13653","16","20080722042524","Shop","AAA02","1","15000","2300","12700","2008-07-22 16:25:24"
"13654","62","20080722011455","PC","AAA04","1","8000","400","7600","2008-07-22 13:14:55"
"13655","87","20080722101101","Shop","AAA03","1","17000","3000","14000","2008-07-22 10:11:01"
"13656","53","20080722072224","Shop","AAA05","1","60000","20000","40000","2008-07-22 07:22:24"
"13657","65","20080717115809","PC","AAA04","1","8000","400","7600","2008-07-17 11:58:09"
"13658","58","20080717094429","Mobile","AAA04","1","8000","400","7600","2008-07-17 09:44:29"
"13659","97","20080717080301","PC","AAA04","1","8000","400","7600","2008-07-17 08:03:01"
"13660","96","20080716013726","Mobile","AAA03","1","17000","3000","14000","2008-07-16 01:37:26"
"13661","81","20080715052643","Shop","AAA03","1","17000","3000","14000","2008-07-15 17:26:43"
"13662","20","20080715040309","Mobile","AAA02","1","15000","2300","12700","2008-07-15 16:03:09"
"13663","2","20080715122553","Shop","AAA02","2","30000","4600","25400","2008-07-15 12:25:53"
"13664","98","20080715104807","PC","AAA01","1","10000","2000","8000","2008-07-15 10:48:07"
"13665","25","20080714122744","Mobile","AAA03","1","17000","3000","14000","2008-07-14 12:27:44"
"13666","41","20080714105625","Mobile","AAA05","1","60000","20000","40000","2008-07-14 10:56:25"
"13667","28","20080709125048","Shop","AAA02","1","15000","2300","12700","2008-07-09 12:50:48"
"13668","94","20080709110750","PC","AAA03","1","17000","3000","14000","2008-07-09 11:07:50"
"13669","18","20080709092953","Mobile","AAA04","1","8000","400","7600","2008-07-09 09:29:53"
"13670","62","20080707084347","PC","AAA04","1","8000","400","7600","2008-07-07 20:43:47"
"13671","85","20080707094222","Mobile","AAA04","1","8000","400","7600","2008-07-07 09:42:22"
"13672","10","20080704071423","Shop","AAA04","1","8000","400","7600","2008-07-04 19:14:23"
"13673","16","20080704020311","Shop","AAA02","1","15000","2300","12700","2008-07-04 14:03:11"
"13674","26","20080704114851","Mobile","AAA03","1","17000","3000","14000","2008-07-04 11:48:51"
"13675","94","20080704095806","PC","AAA05","2","120000","40000","80000","2008-07-04 09:58:06"
"13676","44","20080703033138","PC","AAA04","1","8000","400","7600","2008-07-03 15:31:38"
"13677","7","20080703010420","PC","AAA03","1","17000","3000","14000","2008-07-03 13:04:20"
"13678","57","20080703071600","Shop","AAA02","1","15000","2300","12700","2008-07-03 07:16:00"
"13679","1","20080702122425","Mobile","AAA04","1","8000","400","7600","2008-07-02 12:24:25"
"13680","92","20080702104432","Shop","AAA01","1","10000","2000","8000","2008-07-02 10:44:32"
"13681","62","20080701022431","Mobile","AAA04","1","8000","400","7600","2008-07-01 02:24:31"
"13682","89","20080630020134","Mobile","AAA02","1","15000","2300","12700","2008-06-30 14:01:34"
"13683","5","20080630013355","PC","AAA01","1","10000","2000","8000","2008-06-30 13:33:55"
"13684","28","20080630095803","PC","AAA05","1","60000","20000","40000","2008-06-30 09:58:03"
"13685","51","20080624071307","Shop","AAA04","1","8000","400","7600","2008-06-24 19:13:07"
"13686","8","20080624124936","Mobile","AAA04","1","8000","400","7600","2008-06-24 12:49:36"
"13687","39","20080623121844","PC","AAA02","1","15000","2300","12700","2008-06-23 12:18:44"
"13688","11","20080623095410","PC","AAA04","1","8000","400","7600","2008-06-23 09:54:10"
"13689","24","20080619115846","Mobile","AAA05","1","60000","20000","40000","2008-06-19 11:58:46"
"13690","84","20080619101031","Shop","AAA01","1","10000","2000","8000","2008-06-19 10:10:31"
"13691","47","20080619072813","Shop","AAA04","1","8000","400","7600","2008-06-19 07:28:13"
"13692","71","20080618043823","PC","AAA02","1","15000","2300","12700","2008-06-18 16:38:23"
"13693","48","20080618023311","Shop","AAA04","1","8000","400","7600","2008-06-18 14:33:11"
"13694","36","20080618121711","Mobile","AAA01","1","10000","2000","8000","2008-06-18 12:17:11"
"13695","94","20080618104603","Mobile","AAA01","1","10000","2000","8000","2008-06-18 10:46:03"
"13696","14","20080618100040","Shop","AAA05","1","60000","20000","40000","2008-06-18 10:00:40"
"13697","67","20080618090314","Shop","AAA02","1","15000","2300","12700","2008-06-18 09:03:14"
"13698","89","20080618072606","Shop","AAA05","2","120000","40000","80000","2008-06-18 07:26:06"
"13699","17","20080617011815","Shop","AAA03","1","17000","3000","14000","2008-06-17 01:18:15"
"13700","71","20080612084104","Shop","AAA02","1","15000","2300","12700","2008-06-12 20:41:04"
"13701","22","20080612013303","Mobile","AAA04","1","8000","400","7600","2008-06-12 13:33:03"
"13702","80","20080612114544","Mobile","AAA02","1","15000","2300","12700","2008-06-12 11:45:44"
"13703","96","20080612103306","Mobile","AAA02","1","15000","2300","12700","2008-06-12 10:33:06"
"13704","26","20080612091047","Shop","AAA02","1","15000","2300","12700","2008-06-12 09:10:47"
"13705","72","20080612065824","Mobile","AAA04","1","8000","400","7600","2008-06-12 06:58:24"
"13706","60","20080611060417","Mobile","AAA02","1","15000","2300","12700","2008-06-11 06:04:17"
"13707","95","20080610033656","Mobile","AAA04","1","8000","400","7600","2008-06-10 15:36:56"
"13708","57","20080610022216","PC","AAA05","1","60000","20000","40000","2008-06-10 14:22:16"
"13709","67","20080610113755","Shop","AAA02","1","15000","2300","12700","2008-06-10 11:37:55"
"13710","7","20080610095412","PC","AAA03","1","17000","3000","14000","2008-06-10 09:54:12"
"13711","80","20080610090518","PC","AAA04","1","8000","400","7600","2008-06-10 09:05:18"
"13712","24","20080610065526","PC","AAA01","1","10000","2000","8000","2008-06-10 06:55:26"
"13713","2","20080604055308","Shop","AAA03","1","17000","3000","14000","2008-06-04 17:53:08"
"13714","24","20080604115339","Mobile","AAA01","1","10000","2000","8000","2008-06-04 11:53:39"
"13715","72","20080604111417","Mobile","AAA04","1","8000","400","7600","2008-06-04 11:14:17"
"13716","34","20080604094724","PC","AAA02","1","15000","2300","12700","2008-06-04 09:47:24"
"13717","73","20080603060255","Shop","AAA05","1","60000","20000","40000","2008-06-03 06:02:55"
"13718","38","20080601115916","Mobile","AAA01","2","20000","4000","16000","2008-06-01 23:59:16"
"13719","71","20080527080305","Shop","AAA01","1","10000","2000","8000","2008-05-27 20:03:05"
"13720","15","20080527031211","Shop","AAA03","3","51000","9000","42000","2008-05-27 15:12:11"
"13721","37","20080527072249","Mobile","AAA05","2","120000","40000","80000","2008-05-27 07:22:49"
"13722","28","20080526070520","Shop","AAA05","1","60000","20000","40000","2008-05-26 07:05:20"
"13723","31","20080521095317","PC","AAA02","1","15000","2300","12700","2008-05-21 09:53:17"
"13724","29","20080521080934","PC","AAA02","1","15000","2300","12700","2008-05-21 08:09:34"
"13725","2","20080521061257","Shop","AAA03","1","17000","3000","14000","2008-05-21 06:12:57"
"13726","56","20080520035702","Shop","AAA01","2","20000","4000","16000","2008-05-20 15:57:02"
"13727","10","20080520100944","Mobile","AAA01","2","20000","4000","16000","2008-05-20 10:09:44"
"13728","65","20080519080135","Shop","AAA04","1","8000","400","7600","2008-05-19 08:01:35"
"13729","41","20080515024435","PC","AAA03","1","17000","3000","14000","2008-05-15 14:44:35"
"13730","63","20080515090329","PC","AAA05","1","60000","20000","40000","2008-05-15 09:03:29"
"13731","79","20080515071139","PC","AAA05","1","60000","20000","40000","2008-05-15 07:11:39"
"13732","68","20080513090157","Shop","AAA04","1","8000","400","7600","2008-05-13 21:01:57"
"13733","66","20080513010131","Mobile","AAA03","1","17000","3000","14000","2008-05-13 13:01:31"
"13734","80","20080513120134","Shop","AAA03","1","17000","3000","14000","2008-05-13 12:01:34"
"13735","32","20080513101945","PC","AAA02","1","15000","2300","12700","2008-05-13 10:19:45"
"13736","54","20080513075747","Shop","AAA03","1","17000","3000","14000","2008-05-13 07:57:47"
"13737","16","20080512055527","PC","AAA01","1","10000","2000","8000","2008-05-12 17:55:27"
"13738","86","20080512023314","PC","AAA04","1","8000","400","7600","2008-05-12 14:33:14"
"13739","7","20080512124536","Mobile","AAA04","1","8000","400","7600","2008-05-12 12:45:36"
"13740","76","20080512120737","Shop","AAA05","1","60000","20000","40000","2008-05-12 12:07:37"
"13741","62","20080512101742","Shop","AAA05","1","60000","20000","40000","2008-05-12 10:17:42"
"13742","89","20080510123821","Mobile","AAA04","1","8000","400","7600","2008-05-10 12:38:21"
"13743","21","20080508113651","Mobile","AAA02","1","15000","2300","12700","2008-05-08 11:36:51"
"13744","49","20080508093732","Shop","AAA05","1","60000","20000","40000","2008-05-08 09:37:32"
"13745","97","20080508075301","Mobile","AAA04","1","8000","400","7600","2008-05-08 07:53:01"
"13746","44","20080507101340","Shop","AAA01","1","10000","2000","8000","2008-05-07 10:13:40"
"13747","85","20080506103750","Mobile","AAA05","1","60000","20000","40000","2008-05-06 10:37:50"
"13748","7","20080505053942","Shop","AAA02","1","15000","2300","12700","2008-05-05 17:39:42"
"13749","58","20080505034341","Mobile","AAA03","1","17000","3000","14000","2008-05-05 15:43:41"
"13750","49","20080505014053","Mobile","AAA02","2","30000","4600","25400","2008-05-05 13:40:53"
"13751","65","20080501101600","Shop","AAA03","1","17000","3000","14000","2008-05-01 10:16:00"
"13752","18","20080501084533","Shop","AAA04","1","8000","400","7600","2008-05-01 08:45:33"
"13753","49","20080501124054","Mobile","AAA04","1","8000","400","7600","2008-05-01 00:40:54"
"13754","37","20080430031200","Shop","AAA02","1","15000","2300","12700","2008-04-30 03:12:00"
"13755","54","20080428110257","Mobile","AAA03","1","17000","3000","14000","2008-04-28 11:02:57"
"13756","72","20080420111513","Shop","AAA01","1","10000","2000","8000","2008-04-20 23:15:13"
"13757","56","20080418023347","Mobile","AAA02","1","15000","2300","12700","2008-04-18 14:33:47"
"13758","20","20080418093107","Shop","AAA01","1","10000","2000","8000","2008-04-18 09:31:07"
"13759","55","20080418074635","Mobile","AAA02","1","15000","2300","12700","2008-04-18 07:46:35"
"13760","55","20080417013526","Shop","AAA04","1","8000","400","7600","2008-04-17 13:35:26"
"13761","80","20080417102440","Shop","AAA04","1","8000","400","7600","2008-04-17 10:24:40"
"13762","6","20080417095509","PC","AAA01","1","10000","2000","8000","2008-04-17 09:55:09"
"13763","69","20080417073509","PC","AAA01","1","10000","2000","8000","2008-04-17 07:35:09"
"13764","90","20080416082401","Mobile","AAA01","1","10000","2000","8000","2008-04-16 08:24:01"
"13765","56","20080415112343","Shop","AAA03","1","17000","3000","14000","2008-04-15 11:23:43"
"13766","41","20080415075941","Shop","AAA04","1","8000","400","7600","2008-04-15 07:59:41"
"13767","22","20080414094705","Shop","AAA02","1","15000","2300","12700","2008-04-14 09:47:05"
"13768","15","20080408083419","Mobile","AAA01","1","10000","2000","8000","2008-04-08 20:34:19"
"13769","85","20080408060400","Mobile","AAA05","1","60000","20000","40000","2008-04-08 18:04:00"
"13770","71","20080408123312","PC","AAA03","1","17000","3000","14000","2008-04-08 12:33:12"
"13771","95","20080408095038","PC","AAA05","1","60000","20000","40000","2008-04-08 09:50:38"
"13772","56","20080408080619","Mobile","AAA01","1","10000","2000","8000","2008-04-08 08:06:19"
"13773","85","20080407024647","Mobile","AAA05","1","60000","20000","40000","2008-04-07 14:46:47"
"13774","47","20080407123035","Mobile","AAA03","1","17000","3000","14000","2008-04-07 12:30:35"
"13775","34","20080407094057","Mobile","AAA05","2","120000","40000","80000","2008-04-07 09:40:57"
"13776","42","20080401083000","Shop","AAA03","2","34000","6000","28000","2008-04-01 08:30:00"
"13777","63","20080401074048","PC","AAA02","1","15000","2300","12700","2008-04-01 07:40:48"
"13778","13","20080331125006","PC","AAA04","1","8000","400","7600","2008-03-31 12:50:06"
"13779","32","20080331112656","PC","AAA05","1","60000","20000","40000","2008-03-31 11:26:56"
"13780","44","20080331083622","Mobile","AAA04","1","8000","400","7600","2008-03-31 08:36:22"
"13781","85","20080327024523","Shop","AAA01","1","10000","2000","8000","2008-03-27 02:45:23"
"13782","100","20080325041329","Mobile","AAA04","1","8000","400","7600","2008-03-25 16:13:29"
"13783","79","20080325020839","PC","AAA03","1","17000","3000","14000","2008-03-25 14:08:39"
"13784","5","20080325064726","Mobile","AAA01","2","20000","4000","16000","2008-03-25 06:47:26"
"13785","83","20080317023317","Shop","AAA03","2","34000","6000","28000","2008-03-17 14:33:17"
"13786","18","20080317120829","PC","AAA03","1","17000","3000","14000","2008-03-17 12:08:29"
"13787","87","20080317092548","PC","AAA04","1","8000","400","7600","2008-03-17 09:25:48"
"13788","39","20080310012941","PC","AAA05","1","60000","20000","40000","2008-03-10 13:29:41"
"13789","5","20080310112951","Mobile","AAA04","1","8000","400","7600","2008-03-10 11:29:51"
"13790","42","20080310104655","PC","AAA03","1","17000","3000","14000","2008-03-10 10:46:55"
"13791","60","20080310083020","Mobile","AAA02","1","15000","2300","12700","2008-03-10 08:30:20"
"13792","14","20080307100418","PC","AAA01","1","10000","2000","8000","2008-03-07 10:04:18"
"13793","43","20080307053859","Mobile","AAA03","1","17000","3000","14000","2008-03-07 05:38:59"
"13794","68","20080307035526","PC","AAA01","1","10000","2000","8000","2008-03-07 03:55:26"
"13795","16","20080306021850","Shop","AAA03","3","51000","9000","42000","2008-03-06 14:18:50"
"13796","23","20080306012134","PC","AAA02","2","30000","4600","25400","2008-03-06 13:21:34"
"13797","90","20080306104445","Shop","AAA02","1","15000","2300","12700","2008-03-06 10:44:45"
"13798","85","20080306081536","Mobile","AAA02","1","15000","2300","12700","2008-03-06 08:15:36"
"13799","5","20080306051922","Shop","AAA05","1","60000","20000","40000","2008-03-06 05:19:22"
"13800","82","20080305043135","Shop","AAA01","1","10000","2000","8000","2008-03-05 04:31:35"
"13801","76","20080304051557","Shop","AAA01","1","10000","2000","8000","2008-03-04 17:15:57"
"13802","50","20080304032937","PC","AAA04","1","8000","400","7600","2008-03-04 15:29:37"
"13803","64","20080304065724","Mobile","AAA05","2","120000","40000","80000","2008-03-04 06:57:24"
"13804","8","20080303052835","Mobile","AAA03","1","17000","3000","14000","2008-03-03 17:28:35"
"13805","48","20080303032537","PC","AAA02","1","15000","2300","12700","2008-03-03 15:25:37"
"13806","65","20080303113106","Mobile","AAA03","1","17000","3000","14000","2008-03-03 11:31:06"
"13807","55","20080226093324","Shop","AAA05","2","120000","40000","80000","2008-02-26 21:33:24"
"13808","56","20080226032318","PC","AAA05","1","60000","20000","40000","2008-02-26 15:23:18"
"13809","83","20080226014355","Mobile","AAA01","2","20000","4000","16000","2008-02-26 13:43:55"
"13810","89","20080226075857","Mobile","AAA02","1","15000","2300","12700","2008-02-26 07:58:57"
"13811","56","20080225070226","Shop","AAA05","1","60000","20000","40000","2008-02-25 19:02:26"
"13812","94","20080225121034","Shop","AAA03","1","17000","3000","14000","2008-02-25 12:10:34"
"13813","36","20080224035915","PC","AAA05","1","60000","20000","40000","2008-02-24 15:59:15"
"13814","87","20080219074701","Mobile","AAA01","1","10000","2000","8000","2008-02-19 07:47:01"
"13815","46","20080218113702","Mobile","AAA04","1","8000","400","7600","2008-02-18 11:37:02"
"13816","80","20080218104602","Mobile","AAA04","1","8000","400","7600","2008-02-18 10:46:02"
"13817","88","20080218091300","Shop","AAA02","2","30000","4600","25400","2008-02-18 09:13:00"
"13818","25","20080211063621","Mobile","AAA02","1","15000","2300","12700","2008-02-11 18:36:21"
"13819","5","20080211115039","Mobile","AAA01","1","10000","2000","8000","2008-02-11 11:50:39"
"13820","18","20080210043415","Shop","AAA01","1","10000","2000","8000","2008-02-10 16:34:15"
"13821","60","20080208122433","PC","AAA03","1","17000","3000","14000","2008-02-08 00:24:33"
"13822","27","20080207012726","Shop","AAA05","1","60000","20000","40000","2008-02-07 01:27:26"
"13823","35","20080206063904","Mobile","AAA02","1","15000","2300","12700","2008-02-06 06:39:04"
"13824","56","20080205061219","Shop","AAA03","1","17000","3000","14000","2008-02-05 06:12:19"
"13825","70","20080204021339","Shop","AAA04","1","8000","400","7600","2008-02-04 02:13:39"
"13826","36","20080131070052","PC","AAA04","1","8000","400","7600","2008-01-31 07:00:52"
"13827","10","20080130035914","Shop","AAA03","1","17000","3000","14000","2008-01-30 15:59:14"
"13828","9","20080130105246","Mobile","AAA04","1","8000","400","7600","2008-01-30 10:52:46"
"13829","13","20080130092342","Mobile","AAA03","1","17000","3000","14000","2008-01-30 09:23:42"
"13830","42","20080130030712","Shop","AAA03","1","17000","3000","14000","2008-01-30 03:07:12"
"13831","43","20080129103754","PC","AAA05","1","60000","20000","40000","2008-01-29 10:37:54"
"13832","23","20080129093147","Mobile","AAA02","1","15000","2300","12700","2008-01-29 09:31:47"
"13833","70","20080129071154","PC","AAA03","1","17000","3000","14000","2008-01-29 07:11:54"
"13834","64","20080128025655","Mobile","AAA02","1","15000","2300","12700","2008-01-28 02:56:55"
"13835","51","20080124032855","Mobile","AAA05","1","60000","20000","40000","2008-01-24 15:28:55"
"13836","64","20080124121339","Mobile","AAA04","1","8000","400","7600","2008-01-24 12:13:39"
"13837","23","20080124092350","Mobile","AAA05","1","60000","20000","40000","2008-01-24 09:23:50"
"13838","9","20080124070347","PC","AAA01","1","10000","2000","8000","2008-01-24 07:03:47"
"13839","13","20080123022732","Mobile","AAA02","1","15000","2300","12700","2008-01-23 14:27:32"
"13840","54","20080123125821","Mobile","AAA03","1","17000","3000","14000","2008-01-23 12:58:21"
"13841","69","20080123101221","PC","AAA04","1","8000","400","7600","2008-01-23 10:12:21"
"13842","59","20080123072158","Mobile","AAA03","1","17000","3000","14000","2008-01-23 07:21:58"
"13843","25","20080122020744","Mobile","AAA03","1","17000","3000","14000","2008-01-22 14:07:44"
"13844","6","20080122124804","PC","AAA04","1","8000","400","7600","2008-01-22 12:48:04"
"13845","4","20080122110850","PC","AAA01","1","10000","2000","8000","2008-01-22 11:08:50"
"13846","17","20080122093123","PC","AAA04","1","8000","400","7600","2008-01-22 09:31:23"
"13847","38","20080122071603","PC","AAA02","1","15000","2300","12700","2008-01-22 07:16:03"
"13848","31","20080121115910","Mobile","AAA03","1","17000","3000","14000","2008-01-21 11:59:10"
"13849","44","20080121094828","Mobile","AAA04","2","16000","800","15200","2008-01-21 09:48:28"
"13850","96","20080117091249","Shop","AAA02","1","15000","2300","12700","2008-01-17 21:12:49"
"13851","71","20080117035806","Mobile","AAA01","1","10000","2000","8000","2008-01-17 15:58:06"
"13852","38","20080117024932","Mobile","AAA05","1","60000","20000","40000","2008-01-17 14:49:32"
"13853","64","20080117124720","Mobile","AAA03","1","17000","3000","14000","2008-01-17 12:47:20"
"13854","49","20080117055830","Shop","AAA02","2","30000","4600","25400","2008-01-17 05:58:30"
"13855","24","20080115091719","Mobile","AAA05","1","60000","20000","40000","2008-01-15 09:17:19"
"13856","58","20080114014632","PC","AAA05","1","60000","20000","40000","2008-01-14 13:46:32"
"13857","53","20080114091908","PC","AAA05","1","60000","20000","40000","2008-01-14 09:19:08"
"13858","60","20080107115108","PC","AAA02","1","15000","2300","12700","2008-01-07 11:51:08"
"13859","41","20080107090319","Shop","AAA04","1","8000","400","7600","2008-01-07 09:03:19"
"13860","39","20071228025524","Shop","AAA04","1","8000","400","7600","2007-12-28 02:55:24"
"13861","14","20071227084332","Shop","AAA04","1","8000","400","7600","2007-12-27 08:43:32"
"13862","78","20071227052049","Mobile","AAA05","1","60000","20000","40000","2007-12-27 05:20:49"
"13863","12","20071225081022","PC","AAA04","1","8000","400","7600","2007-12-25 20:10:22"
"13864","37","20071225022151","Shop","AAA01","1","10000","2000","8000","2007-12-25 14:21:51"
"13865","8","20071225112513","PC","AAA05","1","60000","20000","40000","2007-12-25 11:25:13"
"13866","29","20071217074757","Mobile","AAA03","1","17000","3000","14000","2007-12-17 19:47:57"
"13867","94","20071217085147","Shop","AAA01","1","10000","2000","8000","2007-12-17 08:51:47"
"13868","51","20071205043540","Mobile","AAA03","1","17000","3000","14000","2007-12-05 16:35:40"
"13869","80","20071205115952","Shop","AAA04","1","8000","400","7600","2007-12-05 11:59:52"
"13870","57","20071203025220","PC","AAA01","1","10000","2000","8000","2007-12-03 14:52:20"
"13871","26","20071203101139","PC","AAA01","1","10000","2000","8000","2007-12-03 10:11:39"
"13872","22","20071119125410","Mobile","AAA04","1","8000","400","7600","2007-11-19 12:54:10"
"13873","45","20071119085932","Mobile","AAA02","1","15000","2300","12700","2007-11-19 08:59:32"
"13874","16","20071115020216","Mobile","AAA02","1","15000","2300","12700","2007-11-15 14:02:16"
"13875","37","20071115115411","Shop","AAA02","1","15000","2300","12700","2007-11-15 11:54:11"
"13876","94","20071114101514","Shop","AAA05","1","60000","20000","40000","2007-11-14 10:15:14"
"13877","11","20071114061819","Mobile","AAA01","1","10000","2000","8000","2007-11-14 06:18:19"
"13878","76","20071113104551","Mobile","AAA03","1","17000","3000","14000","2007-11-13 10:45:51"
"13879","13","20071101093851","Shop","AAA04","1","8000","400","7600","2007-11-01 09:38:51"
"13880","14","20071101075429","PC","AAA03","1","17000","3000","14000","2007-11-01 07:54:29"
"13881","36","20071031084842","PC","AAA05","1","60000","20000","40000","2007-10-31 08:48:42"
"13882","95","20071030055959","Mobile","AAA03","1","17000","3000","14000","2007-10-30 17:59:59"
"13883","64","20071030064813","Mobile","AAA05","1","60000","20000","40000","2007-10-30 06:48:13"
"13884","74","20071019082556","Mobile","AAA05","1","60000","20000","40000","2007-10-19 08:25:56"
"13885","16","20071017075356","Mobile","AAA04","1","8000","400","7600","2007-10-17 07:53:56"
"13886","15","20071011040000","Shop","AAA02","1","15000","2300","12700","2007-10-11 16:00:00"
"13887","64","20071011075149","PC","AAA01","1","10000","2000","8000","2007-10-11 07:51:49"
"13888","11","20071011035105","PC","AAA05","1","60000","20000","40000","2007-10-11 03:51:05"
"13889","74","20071010115058","PC","AAA05","1","60000","20000","40000","2007-10-10 11:50:58"
"13890","25","20071010092428","Shop","AAA02","1","15000","2300","12700","2007-10-10 09:24:28"
"13891","87","20071010081200","PC","AAA02","1","15000","2300","12700","2007-10-10 08:12:00"
"13892","70","20071004115836","PC","AAA05","1","60000","20000","40000","2007-10-04 11:58:36"
"13893","16","20071004072605","Shop","AAA01","1","10000","2000","8000","2007-10-04 07:26:05"
"13894","80","20071003101310","Shop","AAA04","1","8000","400","7600","2007-10-03 10:13:10"
"13895","50","20071003071315","Shop","AAA01","1","10000","2000","8000","2007-10-03 07:13:15"
"13896","2","20071002120609","Shop","AAA03","1","17000","3000","14000","2007-10-02 12:06:09"
"13897","65","20071002072113","Shop","AAA01","1","10000","2000","8000","2007-10-02 07:21:13"
"13898","41","20070926045329","PC","AAA01","1","10000","2000","8000","2007-09-26 16:53:29"
"13899","86","20070926023715","Mobile","AAA04","1","8000","400","7600","2007-09-26 14:37:15"
"13900","69","20070926101312","Mobile","AAA04","1","8000","400","7600","2007-09-26 10:13:12"
"13901","70","20070926083609","PC","AAA02","1","15000","2300","12700","2007-09-26 08:36:09"
"13902","43","20070925123739","PC","AAA03","1","17000","3000","14000","2007-09-25 12:37:39"
"13903","23","20070924081538","Mobile","AAA03","1","17000","3000","14000","2007-09-24 20:15:38"
"13904","41","20070924093511","Mobile","AAA04","1","8000","400","7600","2007-09-24 09:35:11"
"13905","36","20070920064156","Shop","AAA05","1","60000","20000","40000","2007-09-20 06:41:56"
"13906","74","20070919025122","PC","AAA04","1","8000","400","7600","2007-09-19 14:51:22"
"13907","30","20070919012224","Shop","AAA05","1","60000","20000","40000","2007-09-19 13:22:24"
"13908","72","20070919104059","Mobile","AAA04","1","8000","400","7600","2007-09-19 10:40:59"
"13909","70","20070918015350","Shop","AAA04","1","8000","400","7600","2007-09-18 13:53:50"
"13910","56","20070918104846","PC","AAA02","1","15000","2300","12700","2007-09-18 10:48:46"
"13911","62","20070918072250","Mobile","AAA03","1","17000","3000","14000","2007-09-18 07:22:50"
"13912","64","20070917100220","Shop","AAA04","1","8000","400","7600","2007-09-17 10:02:20"
"13913","83","20070911092011","Shop","AAA05","1","60000","20000","40000","2007-09-11 09:20:11"
"13914","66","20070906081305","Mobile","AAA05","1","60000","20000","40000","2007-09-06 20:13:05"
"13915","44","20070906021507","Mobile","AAA02","1","15000","2300","12700","2007-09-06 14:15:07"
"13916","3","20070906124234","Mobile","AAA05","1","60000","20000","40000","2007-09-06 12:42:34"
"13917","27","20070906064221","Mobile","AAA01","1","10000","2000","8000","2007-09-06 06:42:21"
"13918","7","20070904091218","Shop","AAA01","1","10000","2000","8000","2007-09-04 09:12:18"
"13919","21","20070903075316","Mobile","AAA02","1","15000","2300","12700","2007-09-03 07:53:16"
"13920","6","20070831042133","Mobile","AAA02","1","15000","2300","12700","2007-08-31 04:21:33"
"13921","34","20070829084800","Mobile","AAA03","1","17000","3000","14000","2007-08-29 08:48:00"
"13922","97","20070828124421","PC","AAA02","1","15000","2300","12700","2007-08-28 12:44:21"
"13923","44","20070828085350","Shop","AAA05","1","60000","20000","40000","2007-08-28 08:53:50"
"13924","44","20070828074126","Shop","AAA04","1","8000","400","7600","2007-08-28 07:41:26"
"13925","55","20070827121447","Mobile","AAA01","1","10000","2000","8000","2007-08-27 12:14:47"
"13926","69","20070821011519","Mobile","AAA01","1","10000","2000","8000","2007-08-21 01:15:19"
"13927","21","20070820120037","Mobile","AAA05","1","60000","20000","40000","2007-08-20 12:00:37"
"13928","42","20070816114728","Mobile","AAA03","1","17000","3000","14000","2007-08-16 11:47:28"
"13929","74","20070816080228","Mobile","AAA04","1","8000","400","7600","2007-08-16 08:02:28"
"13930","21","20070815052530","Mobile","AAA03","1","17000","3000","14000","2007-08-15 05:25:30"
"13931","67","20070814051856","Mobile","AAA02","1","15000","2300","12700","2007-08-14 05:18:56"
"13932","21","20070813061625","PC","AAA01","1","10000","2000","8000","2007-08-13 06:16:25"
"13933","22","20070807083142","Shop","AAA05","1","60000","20000","40000","2007-08-07 08:31:42"
"13934","93","20070806071311","Mobile","AAA02","1","15000","2300","12700","2007-08-06 19:13:11"
"13935","25","20070806021528","Mobile","AAA04","1","8000","400","7600","2007-08-06 14:15:28"
"13936","92","20070806123920","PC","AAA03","1","17000","3000","14000","2007-08-06 12:39:20"
"13937","36","20070806102504","PC","AAA04","1","8000","400","7600","2007-08-06 10:25:04"
"13938","7","20070806072936","Mobile","AAA05","1","60000","20000","40000","2007-08-06 07:29:36"
"13939","38","20070801021219","Shop","AAA01","1","10000","2000","8000","2007-08-01 14:12:19"
"13940","24","20070731124605","PC","AAA04","1","8000","400","7600","2007-07-31 12:46:05"
"13941","22","20070731102117","Shop","AAA01","1","10000","2000","8000","2007-07-31 10:21:17"
"13942","64","20070730035252","Shop","AAA01","1","10000","2000","8000","2007-07-30 15:52:52"
"13943","89","20070730010156","PC","AAA05","1","60000","20000","40000","2007-07-30 13:01:56"
"13944","34","20070730100830","Mobile","AAA01","1","10000","2000","8000","2007-07-30 10:08:30"
"13945","54","20070730082631","PC","AAA03","1","17000","3000","14000","2007-07-30 08:26:31"
"13946","71","20070724043400","PC","AAA05","1","60000","20000","40000","2007-07-24 16:34:00"
"13947","94","20070723094956","PC","AAA01","1","10000","2000","8000","2007-07-23 09:49:56"
"13948","47","20070717011416","Mobile","AAA05","1","60000","20000","40000","2007-07-17 01:14:16"
"13949","64","20070709113845","PC","AAA01","1","10000","2000","8000","2007-07-09 11:38:45"
"13950","46","20070704111344","Mobile","AAA02","1","15000","2300","12700","2007-07-04 11:13:44"
"13951","81","20070704091219","Shop","AAA01","1","10000","2000","8000","2007-07-04 09:12:19"
"13952","79","20070703031907","PC","AAA05","1","60000","20000","40000","2007-07-03 15:19:07"
"13953","84","20070703102645","Shop","AAA04","1","8000","400","7600","2007-07-03 10:26:45"
"13954","10","20070702090958","Mobile","AAA05","1","60000","20000","40000","2007-07-02 09:09:58"
"13955","70","20070625021047","PC","AAA02","1","15000","2300","12700","2007-06-25 14:10:47"
"13956","69","20070625102508","PC","AAA01","1","10000","2000","8000","2007-06-25 10:25:08"
"13957","16","20070625075020","PC","AAA03","1","17000","3000","14000","2007-06-25 07:50:20"
"13958","98","20070618051918","Shop","AAA02","1","15000","2300","12700","2007-06-18 05:19:18"
"13959","23","20070611111341","Mobile","AAA04","1","8000","400","7600","2007-06-11 11:13:41"
"13960","28","20070608022911","Shop","AAA04","1","8000","400","7600","2007-06-08 14:29:11"
"13961","21","20070608114840","PC","AAA01","1","10000","2000","8000","2007-06-08 11:48:40"
"13962","56","20070607055422","Shop","AAA02","1","15000","2300","12700","2007-06-07 05:54:22"
"13963","99","20070605022449","Mobile","AAA01","1","10000","2000","8000","2007-06-05 14:24:49"
"13964","33","20070605095833","PC","AAA02","1","15000","2300","12700","2007-06-05 09:58:33"
"13965","36","20070605063137","Shop","AAA02","1","15000","2300","12700","2007-06-05 06:31:37"
"13966","16","20070528082914","Shop","AAA04","1","8000","400","7600","2007-05-28 08:29:14"
"13967","15","20070523030642","PC","AAA05","2","120000","40000","80000","2007-05-23 03:06:42"
"13968","25","20070522094636","Mobile","AAA01","1","10000","2000","8000","2007-05-22 21:46:36"
"13969","66","20070522013223","PC","AAA02","1","15000","2300","12700","2007-05-22 13:32:23"
"13970","33","20070513052118","Shop","AAA03","1","17000","3000","14000","2007-05-13 17:21:18"
"13971","41","20070510022245","Shop","AAA04","1","8000","400","7600","2007-05-10 02:22:45"
"13972","15","20070509080015","PC","AAA02","1","15000","2300","12700","2007-05-09 08:00:15"
"13973","45","20070509052549","Mobile","AAA01","1","10000","2000","8000","2007-05-09 05:25:49"
"13974","56","20070508112421","Shop","AAA02","1","15000","2300","12700","2007-05-08 11:24:21"
"13975","15","20070508054942","Mobile","AAA03","1","17000","3000","14000","2007-05-08 05:49:42"
"13976","32","20070507073800","Mobile","AAA01","1","10000","2000","8000","2007-05-07 07:38:00"
"13977","83","20070503025700","Mobile","AAA03","1","17000","3000","14000","2007-05-03 14:57:00"
"13978","72","20070503113742","Mobile","AAA01","1","10000","2000","8000","2007-05-03 11:37:42"
"13979","25","20070503075306","Shop","AAA04","1","8000","400","7600","2007-05-03 07:53:06"
"13980","89","20070501072059","Shop","AAA04","1","8000","400","7600","2007-05-01 19:20:59"
"13981","17","20070430015747","Shop","AAA01","1","10000","2000","8000","2007-04-30 13:57:47"
"13982","24","20070430100036","Shop","AAA01","1","10000","2000","8000","2007-04-30 10:00:36"
"13983","29","20070425062400","Mobile","AAA02","1","15000","2300","12700","2007-04-25 06:24:00"
"13984","73","20070423083932","Shop","AAA01","1","10000","2000","8000","2007-04-23 08:39:32"
"13985","85","20070418014629","PC","AAA02","1","15000","2300","12700","2007-04-18 01:46:29"
"13986","70","20070417120346","Shop","AAA03","1","17000","3000","14000","2007-04-17 12:03:46"
"13987","82","20070416080930","Shop","AAA01","1","10000","2000","8000","2007-04-16 08:09:30"
"13988","10","20070411033856","Shop","AAA01","1","10000","2000","8000","2007-04-11 15:38:56"
"13989","27","20070410083440","Shop","AAA05","1","60000","20000","40000","2007-04-10 08:34:40"
"13990","88","20070328121313","Mobile","AAA05","1","60000","20000","40000","2007-03-28 12:13:13"
"13991","55","20070328084128","Mobile","AAA05","1","60000","20000","40000","2007-03-28 08:41:28"
"13992","49","20070326112601","PC","AAA04","1","8000","400","7600","2007-03-26 11:26:01"
"13993","4","20070326091041","Shop","AAA04","1","8000","400","7600","2007-03-26 09:10:41"
"13994","62","20070323015000","Shop","AAA05","1","60000","20000","40000","2007-03-23 01:50:00"
"13995","15","20070322100526","PC","AAA05","2","120000","40000","80000","2007-03-22 10:05:26"
"13996","42","20070322084530","Shop","AAA02","1","15000","2300","12700","2007-03-22 08:45:30"
"13997","8","20070322051540","Shop","AAA04","1","8000","400","7600","2007-03-22 05:15:40"
"13998","91","20070320100345","Mobile","AAA02","1","15000","2300","12700","2007-03-20 10:03:45"
"13999","41","20070319024027","Shop","AAA01","1","10000","2000","8000","2007-03-19 14:40:27"
"14000","60","20070319103014","Shop","AAA04","1","8000","400","7600","2007-03-19 10:30:14"
"14001","8","20070314065350","Shop","AAA05","1","60000","20000","40000","2007-03-14 18:53:50"
"14002","55","20070314034036","Mobile","AAA05","1","60000","20000","40000","2007-03-14 15:40:36"
"14003","43","20070314080205","Shop","AAA02","1","15000","2300","12700","2007-03-14 08:02:05"
"14004","34","20070314063122","Shop","AAA04","1","8000","400","7600","2007-03-14 06:31:22"
"14005","92","20070313101355","PC","AAA01","1","10000","2000","8000","2007-03-13 10:13:55"
"14006","14","20070312102225","Shop","AAA03","1","17000","3000","14000","2007-03-12 10:22:25"
"14007","65","20070312081335","Shop","AAA01","1","10000","2000","8000","2007-03-12 08:13:35"
"14008","43","20070307072856","PC","AAA01","1","10000","2000","8000","2007-03-07 19:28:56"
"14009","71","20070307124730","Shop","AAA05","1","60000","20000","40000","2007-03-07 12:47:30"
"14010","48","20070307105956","PC","AAA04","1","8000","400","7600","2007-03-07 10:59:56"
"14011","95","20070307074413","Shop","AAA05","1","60000","20000","40000","2007-03-07 07:44:13"
"14012","49","20070306023005","Mobile","AAA01","1","10000","2000","8000","2007-03-06 14:30:05"
"14013","49","20070306123543","Mobile","AAA04","1","8000","400","7600","2007-03-06 12:35:43"
"14014","93","20070305083638","Mobile","AAA02","1","15000","2300","12700","2007-03-05 08:36:38"
"14015","64","20070227032527","PC","AAA04","1","8000","400","7600","2007-02-27 15:25:27"
"14016","32","20070227012809","Shop","AAA04","1","8000","400","7600","2007-02-27 13:28:09"
"14017","33","20070227110703","Mobile","AAA04","1","8000","400","7600","2007-02-27 11:07:03"
"14018","17","20070226041828","PC","AAA02","1","15000","2300","12700","2007-02-26 16:18:28"
"14019","83","20070226120416","PC","AAA02","1","15000","2300","12700","2007-02-26 12:04:16"
"14020","50","20070226103523","PC","AAA04","1","8000","400","7600","2007-02-26 10:35:23"
"14021","56","20070226085137","Shop","AAA03","1","17000","3000","14000","2007-02-26 08:51:37"
"14022","55","20070222090223","PC","AAA01","1","10000","2000","8000","2007-02-22 09:02:23"
"14023","2","20070221043254","PC","AAA03","1","17000","3000","14000","2007-02-21 16:32:54"
"14024","29","20070221022407","PC","AAA04","1","8000","400","7600","2007-02-21 14:24:07"
"14025","87","20070221122745","Mobile","AAA04","1","8000","400","7600","2007-02-21 12:27:45"
"14026","8","20070220071909","Shop","AAA01","1","10000","2000","8000","2007-02-20 19:19:09"
"14027","16","20070220103922","Mobile","AAA05","1","60000","20000","40000","2007-02-20 10:39:22"
"14028","74","20070220100803","PC","AAA02","1","15000","2300","12700","2007-02-20 10:08:03"
"14029","42","20070220064911","Shop","AAA04","1","8000","400","7600","2007-02-20 06:49:11"
"14030","97","20070219074419","PC","AAA02","1","15000","2300","12700","2007-02-19 07:44:19"
"14031","54","20070214031905","Mobile","AAA01","1","10000","2000","8000","2007-02-14 03:19:05"
"14032","31","20070212041619","Mobile","AAA01","1","10000","2000","8000","2007-02-12 16:16:19"
"14033","33","20070212124456","Shop","AAA02","1","15000","2300","12700","2007-02-12 12:44:56"
"14034","82","20070207081437","PC","AAA05","1","60000","20000","40000","2007-02-07 20:14:37"
"14035","97","20070207084704","Mobile","AAA05","1","60000","20000","40000","2007-02-07 08:47:04"
"14036","83","20070206083039","Mobile","AAA01","1","10000","2000","8000","2007-02-06 08:30:39"
"14037","94","20070206062002","Mobile","AAA01","1","10000","2000","8000","2007-02-06 06:20:02"
"14038","48","20070205104508","Shop","AAA01","1","10000","2000","8000","2007-02-05 10:45:08"
"14039","80","20070201104252","PC","AAA01","1","10000","2000","8000","2007-02-01 10:42:52"
"14040","96","20070201085639","PC","AAA04","1","8000","400","7600","2007-02-01 08:56:39"
"14041","5","20070131015925","Mobile","AAA01","1","10000","2000","8000","2007-01-31 13:59:25"
"14042","29","20070131022848","Mobile","AAA01","1","10000","2000","8000","2007-01-31 02:28:48"
"14043","30","20070129111710","Shop","AAA04","1","8000","400","7600","2007-01-29 11:17:10"
"14044","89","20070122110114","Mobile","AAA03","1","17000","3000","14000","2007-01-22 23:01:14"
"14045","3","20070122120514","Mobile","AAA04","1","8000","400","7600","2007-01-22 00:05:14"
"14046","51","20070117060610","PC","AAA05","1","60000","20000","40000","2007-01-17 06:06:10"
"14047","57","20070116075117","Mobile","AAA02","1","15000","2300","12700","2007-01-16 07:51:17"
"14048","73","20070115040201","Mobile","AAA04","1","8000","400","7600","2007-01-15 16:02:01"
"14049","79","20070115100409","Mobile","AAA04","1","8000","400","7600","2007-01-15 10:04:09"
"14050","50","20070106074657","Shop","AAA01","1","10000","2000","8000","2007-01-06 19:46:57"
"14051","54","20070105095848","Mobile","AAA02","1","15000","2300","12700","2007-01-05 09:58:48"
"14052","91","20070105064609","Mobile","AAA02","1","15000","2300","12700","2007-01-05 06:46:09"
"14053","61","20070104021300","Shop","AAA03","1","17000","3000","14000","2007-01-04 14:13:00"
"14054","55","20070104120741","Shop","AAA05","1","60000","20000","40000","2007-01-04 12:07:41"
"14055","3","20070104104309","Shop","AAA05","1","60000","20000","40000","2007-01-04 10:43:09"
"14056","22","20070104075631","Mobile","AAA02","1","15000","2300","12700","2007-01-04 07:56:31"
"14057","26","20070103080757","Mobile","AAA04","1","8000","400","7600","2007-01-03 08:07:57"
"14058","37","20070101090359","Mobile","AAA03","1","17000","3000","14000","2007-01-01 09:03:59"
